Finnish	﻿English
jokainen	everybody
kaikki	everything
hän	he
hänen	her
häntä	him
hänen	his
se	it
minua	me
minun	my
meidän	our
hän	she
tuo	that
heidän	their
heitä	them
he	they
tämä	this
me	we
mikä, mitä	what
milloin, koska	when
mikä	which
mikä	which
kuka	who
kenen	whose
sinä, sinä	you
