English	Indonesian
black	tanpa susu
blue	biru
brown	warna coklat
gray	abu-abu
green	mentah
orange	jingga
pink	merah muda
red	merah
violet	warna ungu
white	putih
yellow	kuning
couple	sepasang
eight	delapan
eighteen	delapan belas
eighty	delapan puluh
eleven	sebelas
fifteen	lima belas
fifty	lima puluh
five	lima
forty	empat puluh
four	empat
fourteen	empat belas
million	satu juta
nine	sembilan
nineteen	sembilan belas
ninety	sembilan puluh
nothing	nol
one	satu
seventeen	tujuh belas
seventy	tujuh puluh
six	enam
sixty	enam puluh
ten	sepuluh
third	ketiga
thirteen	tiga belas
thirty	tiga puluh
thousand	seribu
thousand	seribu
three	tiga
arm	lengan
back	punggung
beak	paruh
blood	darah
body	tubuh
bone	tulang
brain	otak
breath	napas
cell	sel
chest	dada
chest	dada
chin	dagu
ear	telinga
eye	mata
face	wajah
finger	jari
foot	kaki
forehead	dahi
gene	gen
hair	rambut
hair	bulu
hand	tangan
head	kepala
heart	jantung
knee	lutut
leg	kaki
lip	bibir
mouth	mulut
muscle	otot
nail	kuku
neck	leher
nerve	saraf
nose	hidung
skin	kulit
stomach	lambung
tail	ekor
throat	tenggorokan
thumb	ibu jari
toe	jari kaki
tongue	lidah
tooth	gigi
wing	sayap
ant	semut
bear	beruang
bee	lebah
bird	burung
cat	kucing
cow	sapi
dog	anjing
elephant	gajah
fish	ikan
fly	lalat
goat	kambing
horse	kuda
insect	serangga
lion	singa
monkey	monyet
pig	babi
sheep	domba
snake	ular
afternoon	petang
age	usia
April	April
August	Agustus
autumn	musim gugur
beginning	awal
century	abad
date	tanggal
day	hari
December	Desember
end	akhir
evening	sore
February	Februari
Friday	Jumat
future	masa depan
hour	jam
January	Januari
July	Juli
June	Juni
May	mei
midnight	tengah malam
minute	menit
moment	sekejap
Monday	Senin
month	bulan
morning	pagi
night	malam
November	November
now	sekarang
October	Oktober
past	masa lalu
pause	saat sela
period	masa
Saturday	Sabtu
season	musim
second	detik
September	September
spring	musim semi
summer	musim panas
Sunday	Minggu
Thursday	Kamis
tomorrow	masa depan
Tuesday	Selasa
Wednesday	Rabu
week	minggu
weekend	akhir pekan
winter	musim dingin
year	tahun
bread	roti
breakfast	sarapan
butter	mentega susu
cake	kue
cheese	keju
chocolate	coklat
egg	telur
food	makanan
fruit	buah
lunch	makan siang
meal	makanan
meat	daging
oil	minyak
rice	padi
salad	selada
salt	garam
sandwich	roti lapis
sauce	saus
soup	sup
sugar	gula
sweet	kemanisan
beer	bir
coffee	kopi
drink	minuman
milk	susu
milkshake	susu kocok
tea	teh
water	air
wine	anggur
apple	buah apel
apricot	aberikos
banana	pisang
blackberry	beri hitam
cherry	ceri
lemon	jeruk
nut	biji-bijian
orange	jeruk
peach	buah persik
pear	buah pir
pineapple	nenas
plum	buah zabib
raspberry	nama buah-buahan
strawberry	buah arbei
bean	kacang-kacangan
cabbage	kol
carrot	wortel
cucumber	mentimun
garlic	bawang putih
olive	zaitun
onion	bawang
parsnip	semacam wortel
potato	kentang
radish	lobak
tomato	tanaman tomat
baby	bayi
birth	kelahiran
birthday	hari ulang tahun
boy	anak laki-laki
brother	saudara laki-laki
child	anak
daughter	anak perempuan
death	kematian
family	keluarga
father	ayah
friend	teman
girl	anak perempuan
grandfather	kakek
human	orang
husband	suami
life	masa hidup
man	pria
marriage	perkawinan
mother	ibu
neighbor	tetangga
parent	orangtua
person	orang
relationship	hubungan
sister	saudara perempuan
son	anak laki-laki
wedding	perkawinan
wife	istri
woman	wanita
address	alamat
bathroom	kamar mandi
bedroom	kamar tidur
brick	bata
door	pintu
floor	lantai
floor	tingkat
garage	garasi
garden	kebun
gate	gerbang
hall	lobi
home	tempat tinggal
house	rumah
kitchen	dapur
roof	atap
room	kamar
shower	mandi dengan pancaran
step	anak tangga
toilet	kamar kecil
wall	tembok
well	sumur
window	jendela
bed	tempat tidur
carpet	permadani
chair	kursi
cupboard	lemari
curtain	tirai
desk	meja tulis
furniture	perabotan
seat	kursi
shelf	rak
sink	tempat cuci piring
table	meja
bag	tas
boot	sepatu bot
cloth	kain
clothing	pakaian
coat	mantel
collar	kerah
hat	topi
jacket	jaket
jewel	batu mulia
ring	cincin
shirt	kemeja
shoe	sepatu
skirt	rok
sock	kaus kaki
suitcase	kopor
tie	dasi
air	hawa
animal	hewan
branch	cabang
evolution	evolusi
field	ladang
fire	nyala
flower	bunga
forest	hutan
grass	rumput
leaf	daun
life	kehidupan
lightning	kilat
moisture	kelembaban
nature	alam
plant	tumbuhan
root	akar
sex	jenis kelamin
sky	langit
sleep	tidur
smell	bau
smoke	uap
spring	sumber
stem	batang
stream	arus
tree	pohon
wave	ombak
weather	cuaca
world	dunia
airport	lapangan terbang
bank	bank
bridge	jembatan
building	gedung
capital	ibu kota
castle	puri
church	gereja
cinema	bioskop
city	kota
factory	pabrik
flat	apartemen
hospital	rumah sakit
hotel	hotel
library	perpustakaan
park	taman
prison	penjara
restaurant	rumah makan
road	jalan
school	sekolah
station	pos
street	jalan
structure	pembangunan
subway	kereta api bawah tanah
supermarket	toko swalayan
theater	teater
town	kota kecil
university	universitas
village	desa
accident	kecelakaan
boat	perahu
bus	bis
car	mobil
curve	lengkungan
express	kereta api ekspres
flight	penerbangan
journey	perjalanan
passenger	penumpang
plane	pesawat terbang
ship	kapal
track	rel
train	kereta api
transport	angkutan
actor	pemain
businessman	usahawan
expert	pakar
general	jenderal
journalist	wartawan
judge	hakim
leader	pemimpin
minister	menteri
musician	musikus
photographer	fotografer
pilot	penerbang
policeman	polisi
politician	politikus
president	presiden
professional	profesional
representative	perwakilan
sailor	kelasi
scientist	ilmuwan
secretary	sekretaris
servant	pelayan
soldier	prajurit
writer	penulis
bank	tanggul
beach	pantai
current	arus
direction	arah
Earth	Bumi
east	timur
height	ketinggian
hill	bukit
island	pulau
lake	danau
land	daratan
map	peta
Moon	bulan
north	utara
plain	dataran
river	sungai
sea	laut
south	selatan
star	bintang
sun	matahari
west	barat
cloud	awan
dew	embun
fog	kabut
frost	embun beku
rain	hujan
rainbow	pelangi
snow	salju
storm	badai
thunder	guntur
wind	angin
acid	asam
chemical	zat kimia
chemical element	unsur
coal	batu bara
cotton	kapas
dust	debu
earth	bumi
fat	lemak
glass	kaca
glue	lem
grain	butir
ice	es
iron	besi
leather	kulit
liquid	cairan
matter	materi
metallic element	logam
oil	minyak tanah
poison	racun
powder	bubuk
sand	pasir
silk	benang sutera
soap	sabun
steel	baja
wood	kayu
wool	wol
bag	kantong
basket	keranjang
bottle	botol
box	kotak
can	kaleng
cup	cangkir
drawer	laci
envelope	amplop
glass	gelas
plate	piring
bell	lonceng
button	kancing
gun	senjata api
hammer	pemukul
hook	gantungan
key	kunci
lock	kunci
match	korek api
nail	paku
needle	jarum
pump	pompa
rope	tambang
scissors	gunting
spring	per
stamp	stempel
whip	cambuk
addition	penjumlahan
angle	sudut
area	luas
circle	lingkaran
curve	lengkung
degree	derajat
degree	ketinggian
difference	perbedaan
distance	jarak
division	pembagian
edge	tepi
element	unsur
function	fungsi
half	setengah
limit	batas
line	garis
net	jaringan
outside	bagian luar
percent	persentase
point	titik
purpose	tujuan
result	hasil
rule	peraturan
set	himpunan
side	sisi
square	bujur sangkar
square	pangkat
substitution	tukaran
surface	permukaan
total	banyaknya
ability	kemampuan
act	perbuatan
action	tindakan
activity	aktivitas
addition	tambahan
amount	jumlah
attack	serangan
attempt	usaha
attitude	sikap
back	bagian belakang
behavior	peri laku
bit	sepotong
blow	pukulan
break	istirahat
campaign	perang
case	perkara
chance	kesempatan
change	perubahan
choice	pilihan
condition	keadaan
crack	retakan
cut	pemotongan
damage	kerusakan
danger	bahaya
death	mati
decoration	dekorasi
defense	pertahanan
destruction	penghancuran
dominance	wewenang
drop	tetesan
duty	tugas
effort	upaya
fall	keruntuhan
feature	ciri khas
fight	pertarungan
front	depan
hit	pukulan
hole	lubang
increase	perkembangan
increase	peningkatan
internet	dunia maya
jolt	sentakan
kick	tendangan
kind	jenis
knot	simpul
list	daftar
majority	mayoritas
matter	persoalan
mind	pikiran
operation	pelaksanaan
opposite	lawan
outburst	ledakan
part	bagian
part	bagian
piece	satu
place	tempat kejadian
position	tempat
power	tenaga
practice	praktek
project	tugas
property	sifat
quality	mutu
quiet	ketenangan
responsibility	tanggung jawab
rest	tenang
return	pulang
rise	pendakian
risk	bahaya
seat	bangunan
set	serangkaian
silence	ketenangan
situation	keadaan
slice	sepotong
state	keadaan
step	langkah
stop	perhentian
taste	selera
thing	benda
top	puncak
touch	sentuhan
treatment	perlakuan
tremble	getaran
trick	tipuan
type	jenis
way	cara
wear	keausan
whole	satu kesatuan
will	kemauan
wish	keinginan
art	seni
artist	seniman
band	orkes
brush	sikat
color	cat
concert	konser
design	rancangan
diversity	perbedaan
entertainment	kesenangan
hit	populer
image	citra
ink	tinta
manner	gaya
movie	lapisan
museum	museum
music	musik
note	nada
orchestra	orkestra
paint	cat
painting	lukisan
paper	kertas
pen	fulpen
pencil	pensil
picture	bayangan
poem	puisi
poetry	puisi
rhythm	irama
singer	penyanyi
song	lagu
stage	pentas
style	gaya
vogue	mode
account	tagihan
advantage	keuntungan
advertisement	iklan
advice	nasihat
agreement	perjanjian
attention	perhatian
authority	wewenang
banknote	uang kertas
bargain	perjanjian
brand	merek dagang
business	perusahaan
capital	modal
change	uang kecil
cheque	cek
committee	komite
company	perusahaan
competition	peminat
complaint	tuduhan
contract	kontrak
cost	biaya
council	dewan
course	kursus
customer	pembeli
demand	kebutuhan
department	bagian
difficulty	kesulitan
director	manajer
economy	ekonomi
environment	lingkungan
experience	pengalaman
firm	perusahaan
form	formulir
group	kelompok
help	bantuan
holiday	liburan
income	penghasilan
industry	industri
insurance	asuransi
interest	bunga
invoice	laporan
job	pekerjaan
law	hukum
leave	liburan
loss	kehilangan
management	bimbingan
mark	tanda
market	pasaran
material	bahan
mean	pertengahan
meeting	pertemuan
money	uang
occupation	pekerjaan
offer	tawaran
office	kantor
officer	petugas
operation	operasi
owner	pemilik
package	bingkisan
payment	pembayaran
plan	rencana
price	harga
problem	masalah
product	produk
profit	laba
property	milik
rate	tingkat
rest	sisa
reward	imbalan
right	hak
sale	penjualan
section	divisi
service	pelayanan
share	saham
shop	toko
skill	keahlian
staff	staf
structure	struktur
success	sukses
support	dukungan
table	tabel
tax	pajak
team	regu
trade	perdagangan
value	nilai
work	pekerjaan
worker	pekerja kasar
announcement	pengumuman
answer	jawaban
approval	persetujuan
argument	argumentasi
book	buku
call	panggilan
character	huruf
controversy	pertikaian
cry	seruan
data	data
decision	keputusan
dictionary	kamus
discussion	pembicaraan
doubt	keraguan
experience	peristiwa
feeling	perasaan
humor	kemampuan menyenangkan
idea	gagasan
information	informasi
interest	minat
interview	wawancara
language	bahasa
language	bahasa suatu negara
letter	huruf
letter	surat
lie	dusta
look	penglihatan
magazine	majalah
mail	surat pos
memory	ingatan
memory	kenangan
mistake	kesalahan
name	nama
newspaper	surat kabar
number	nomor
opinion	pendapat
page	halaman
pronunciation	ucapan
proposal	usul
protest	protes
question	pertanyaan
reaction	reaksi
reason	penyebab
relation	komunikasi
request	permintaan
secret	rahasia
sentence	kalimat
sign	lambang
speech	bahasa
spelling	ejaan
standard	kriteria
statement	pernyataan
subject	bahan percakapan
suggestion	saran
voice	suara
word	kata
writing	tulisan
good day	selamat sore, selamat siang
good morning	selamat pagi
how are you	apa kabar
many thanks	terima kasih banyak, banyak terima kasih
no	tidak
thank you very much	terimakasih banyak, terima kasih banyak
yes	ya
Britain	Britania Raya
China	China
Czech Republic	Republik Ceko
France	Perancis
Germany	Jerman
India	India
Italy	Italia
Japan	Jepang
Spain	Spanyol
United States of America	Amerika Serikat
camera	kamera
camera	kamera
cellular phone	telepon selular
clock	jam
computer	komputer
elevator	lift
engine	mesin
instrument	alat
machine	mesin
oven	pemanggangan
television	pesawat televisi
watch	arloji
class	golongan
education	pendidikan
education	pendidikan
education	pendidikan
examination	ujian
grade	nilai
knowledge	pengetahuan
student	mahasiswa
teacher	guru
training	latihan
fear	ketakutan
hate	kebencian
love	sayang
pleasure	kesenangan
promise	harapan
shock	shock
care	penjagaan
cold	selesma
cough	batuk
disease	penyakit
doctor	dokter
health	kesehatan
menstruation	menstruasi
nurse	perawat
operation	operasi
pain	nyeri
patient	pasien
stitch	setik
blade	mata pisau
board	papan
card	kartu
chain	rantai
club	gada
feather	bulu
flag	bendera
frame	bingkai
handle	pegangan
menu	daftar makanan
nut	mur
pin	jarum
pipe	pipa
postage	tarif pos
present	hadiah
sail	layar
scroll	gulungan
seed	biji
stick	tongkat
stone	batu
ticket	karcis
wheel	roda
wire	kawat
balance	keseimbangan pikiran
bulk	ukuran besar
charge	arus
energy	tenaga
light	sinar
mass	kumpulan
measurement	pengukuran
mirror	cermin
movement	gerakan
pressure	tekanan
process	proses
size	ukuran
sound	bunyi
steam	uap
strength	daya
time	waktu
weight	bobot
boyfriend	pacar
date	kencan
girlfriend	pacar
guest	tamu
honey	sayang
kiss	ciuman
party	pesta
sex	seks
smile	senyuman
surprise	kejutan
visit	kunjungan
alternative	alternatif
biology	biologi
cause	penyebab
chemistry	kimia
comparison	perbandingan
consequence	akibat
control	pengendalian
discipline	disiplin
discovery	penemuan
event	peristiwa
evidence	bukti
example	contoh
fact	kenyataan
issue	persoalan
kernel	inti
method	metode
model	model
phase	tahap
procedure	prosedur
production	produksi
program	program
project	proyek
range	jangkauan
research	penelitian
science	ilmu
society	umat manusia
system	jaringan
technology	teknologi
theory	teori
trend	kecenderungan
trouble	kesulitan
army	angkatan perang
base	ramuan utama
club	klub
company	persahabatan
contest	kompetisi
country	negara
court	pengadilan
crime	pelanggaran
culture	kebudayaan
democracy	republik
dominion	kekuasaan
election	pemilihan
existence	keberadaan
government	pemerintah
history	riwayat
individual	individu
institution	lembaga
king	raja
member	anggota
nation	bangsa
news	berita
noise	kebisingan
order	perintah
organization	organisasi
pass	pas
passport	paspor
peace	damai
people	orang
police	kepolisian
policy	kebijaksanaan
population	penduduk
public	rakyat
punishment	hukuman
religion	iman
religion	agama
state	negara
title	judul
union	union
will	kemauan
will	wasiat
award	penghargaan
ball	bola
baseball	baseball
bike	sepeda
championship	kejuaraan
competitor	peserta
cup	piala
football	sepakbola
game	permainan
goal	gol
goal	tujuan
gold	emas
golf	golf
jump	lompatan
match	pertandingan
player	pemain
record	rekor
silver	perak
tennis	tenis
throw	lemparan
win	kemenangan