English	Swahili
AIDS	UKIMWI
Abidjan	Abidjan
Afghan	Mwafugani
Afghanistan	Afghanistan; Afuganistani
Africa	afrika
African	mwafrika
Afrikaans	Kiafrikaans
Algeria	Aljeria; Ualjeri
Algerian	Kialjeria; Kialjeri
America	marekiana; Marekani
Amharic	Kiamhara
Anglo	Kiingereza cha Kale
Angola	Angola
Antigua and Barbuda	Antigua na Barbuda
Arabic	kiarabu
Ares	Aresi
Argentina	Ajentina
Argentinian	Kiajentina
Armenia	Armenia
Armenian	Mwarmenia
Asia	Asia
Athena	Athena
Athens	Athene
Australia	Australia
Australian	waustralia
Austria	Austria
Azerbaijan	Azabajani; Uazeri
Azeri	Mwazabaijani; Mwazeri
Bahamas	Bahama
Bahrain	Bahareni
Baku	Baku
Bambara	Kibambara
Bangladesh	Bangladeshi
Barbados	Babadosi
Belarus	Belarusi
Belarusian	Kibelarus; Kibelorusia 
Belgium	Ubelgiji; Ubelgiji
Belize	Belize
Belorussian	Kibelorusia '(noun 7)'
Bengali	Kibungala
Benin	Benini
Berlin	Berlin
Bhutan	Butani
Bible	Biblia
Black Sea	Bahari Nyeusi
Bolivia	Bolivia
Bosnia and Herzegovina	Bosnia na Herzegovina
Bosphorus	Bosporus
Botswana	Botswana
Brazil	Brazili
Brazilian	Kibrazili
Brunei	Brunei
Brussels	Brussels
Buddhism	Ubudha
Buddhist	Kibudha
Bulgaria	Bulgaria
Bulgarian	Kibulgaria
Burkina Faso	Bukinafaso
Burma	Bama; Myama
Burundi	Burundi
Byzantine Empire	Ufalme wa Byzantini
Caaba	Kaaba
Cambodia	Kamboja
Cameroon	Kameruni
Canada	Kanada
Canadian	Kikanada
Cape Verde	Kepuvede
Carthage	Karthago
Catalan	Kikatalan
Central African Republic	Jamhuri ya Afrika ya Kati
Chad	Chadi
Chicago	chichago
Chile	Chile
China	Uchina
Chinese	chakula cha kichina
Christian	Kikristo
Christianity	Ukristo
Christmas	Krismasi
Cinderella	Bibi Majivu
Colombia	Kolombia
Comoros	Visiwa vya Ngazija; Visiwa vya Komoro
Congo	Jamhuri ya Kidemokrasia ya Kongo
Costa Rica	Kostarika
Croatia	Korasia
Croatian	Kikroashia
Cuba	Kuba
Czech	Mcheki
Czech Republic	Jamhuri ya Ucheki
Czechia	Ucheki
Czechoslovakia	Chekoslovakia; Uchekoslovaki
Dane	Mdeni; Wadeni
Danish	Kideni; Kidenmaki
Denmark	Denmaki; Udeni
Djibouti	Jibuti
Dominica	Dominika
Dominican Republic	Jamhuri ya Dominika
Dutch	Kiholanzi
Earth	dunia
Eastern Europe	Ulaya ya Mashariki
Ecuador	Ekwado
Edmonton	Edmonton
Egypt	Misri
Egyptian	Kimisri
El Salvador	Elsavado
English	Mwingereza (s), Waingereza (p) ('noun 1/2')
Equatorial Guinea	Ginekweta
Eritrea	Eritrea
Eros	Erosi
Estonia	Estonia
Ethiopia	Uhabeshi
Eurasia	Urasia
Europe	Bara Uropa
European Union	Umoja wa Ulaya
Excellency	Mheshimiwa
Faroe Islands	Visiwa vya Faroe
Father	baba
February	februari
Fiji	Fiji
Finland	Ufini
Finn	Mfini; Mfinlendi
Finnish	Kifini; Kifinlandia; Kifinlandi; Kifinishi
France	Ufaransa
French	Kifaransa
Friday	ijumaa
Gabon	Gaboni
Gambia	Gambia
Gaza Strip	Ukanda wa Gaza
Gemini	Mapacha
Georgia	Jojia
German	kijerumani
Ghana	Ghana; Ghana
Gibraltar	Gibraltar
God	Jalali
Greece	Ugiriki
Greek	mgriki
Greenland	Grinlandi
Greenlandic	Kigrinlandi
Grenada	Grenada
Guatemala	Gwatemala
Guinea	Ginebisau
Gujarati	Kigujarati
Guyana	Guyana
Haiti	Haiti
Happy New Year	Heri Za Mwaka Mpya
Hezbollah	Hezbollah
Hindi	Kihindi
Honduras	Hondurasi
Hong Kong	Hong Kong
I	mimi
I love you	t-
Iceland	Aisilandi
Icelander	Mwaisilandi; Waaisilandi; Mwisilandi
Icelandic	Kiaisilandi
Icelandish	Kiaisilandi
India	India; Bara Hindi; Uhindi
Indian Ocean	Bahari ya Uhindi
Indonesia	Indonesia
Iran	Uajemi
Iranian	Kiajemi
Iraq	Iraki
Iraqi	Kiiraki
Irishman	Mweire; Mwayalandi
Israel	Israeli
Israeli	wayahudi
Italian	Mwitalia; Mwitali
Italy	Italia; Uitali
Jamaica	Jamaika
January	januari
Japan	Japani
Japanese	Mjapani
Jehovah	Yehova
Jesus	Yesu
Jew	wayahudi
Jewish	kiyahudi
John	Yohana
Jordan	Yordani
Judges	Waamuzi
Jupiter	Jupita
Kazakh	Kikazaki
Kazakhstan	Kazakistani; Ukazaki
Kenya	kenya
Khartoum	Khartoum
Khrushchev	Krushchov
Korea	Korea
Korean	wakorea
Kuwait	Kuwait
Kyrgyz	Kikirigizi
Kyrgyzstan	Kirigizistani; Kirigizia; Ukirigizi
Latin	Mhispaniki
Lebanon	Lebanon
Lesotho	Lesoto
Liberia	Liberia; Uliberi
Libya	Libya
Lutheran	Mlutheri
Luxembourg	Lasembagi
Lyons	Lyon
Madagascar	Bukini; Madagaska
Malawi	Malawi
Malaysia	Malesia
Maldives	Maldova
Mali	mali
Malta	Malta
Manchuria	Manchuria
Mars	Maazi
Mauritania	Moritania; Umoritani
Mauritius	Morisi
Mediterranean Sea	Bahari ya Mediteranea
Mercury	Merkyuri
Mexican	Mmeksiko
Mexico	mji wa Meksiko
Moldova	Moldova
Mongolia	Mongolia
Mongolian	kimongolia
Morocco	Moroko
Moscow	Misko; Moscow
Mount Everest	mlima Evarest
Mozambique	Msumbiji
Mr	Mhesimiwa
Mr.	Mhesimiwa
Mrs	Bi
Muhammad	Muhammad
Muse	Muza
Muslim	mwiislamu
Nahuatl	Kiazteki
Namibia	Namibia; Unamibi
Nauru	Nauru
Navajo	Kinavaho
Nepal	Nepal
Neptune	Neptuni
Netherlands	Uholanzi
New Guinea	Guinea Mpya
New World	Mpya wa Dunia
New Zealand	Nyuzilandi
Nicaragua	Nikaragwa
Nicholas	Nikolau
Niger	Nijeri
Nigeria	Nijeria
Northern Europe	Ulaya ya Kazkazini
Norway	Norwe
Occitan	Kiositani
Olympic Games	Michezo ya Olimpiki
Oman	Omani
Orinoco	Orinoco
Ouagadougou	Wagadugu
Pacific Ocean	Pasifiki
Pakistan	Pakistani
Palestine	Palestina
Panama	Panama
Papua New Guinea	Papua
Paraguay	Paragwai
Paul	Paulo
Persian	Kiajemi
Peru	Peruu
Pleiades	Kilimia
Pluto	Puluto
Poland	Polandi; Upoli
Pole	Mpoli; Wapoli
Polish	Kipolandi; Kipoli
Portuguese	Kireno
Pythagoras	Pithagoras
Qatar	Katari
Quebec	Kwebeki
Ramadan	Ramadhani
Red Sea	Bahari ya Shamu
Republic of Ireland	Ueire; Ayalandi
Romania	Romania
Russia	Urusi
Russian	mrashia
Rwanda	Rwanda
Sagittarius	Mshale
Saint Lucia	Santalusia
Saint Vincent and the Grenadines	Santavisenti na Grenadini
Sanskrit	Kisanskrit
Saturday	Jumamosi
Saturn	Sarateni
Saudi Arabia	saudi arabia
Scotch tape	adhesive mkanda
Senegal	Senegali
Serbian	kiserbia
Seychelles	Shelisheli
Sierra Leone	Siera Leoni
Slovak	Mslovakia; Mslovaki
Slovakia	Slovakia; Uslovaki
Slovenia	Slovenia
Solomon Islands	Solomoni
Somali	Kisomali
Somalia	Somalia; Usomali
South Africa	Afrika Kusini
South Asia	Asia ya Kusini
South Sudan	Sudan Kusini
Southeast Asia	Asia ya Kusini-Mashariki
Soviet	Kisovyeti
Spain	Uhispani; Uspanya
Spaniard	Mhispania; Mspanya
Spanish	Kihispania; Kispanya
Sri Jayawardenepura Kotte	Sri Jayawardenapura
Sri Lanka	Sirilanka
Statue of Liberty	sanamu ya Uhuru
Stephen	Stefano
Sudan	Sudani
Suez Canal	Mfereji wa Suez
Suriname	Surinamu
Swahili	Kiswahili
Swati	Kiswazi
Swaziland	Uswazi
Swede	Mswidi
Sweden	Uswidi
Swedish	Kiswidi
Switzerland	Uswisi
Syria	Siria
Taiwan	Taiwani
Taiwanese	Mtaiwani
Tajik	Kitajiki
Tallinn	Tallinn
Tanganyika	Tanganyika
Tanzania	Tanzania
Tbilisi	Tbilisi
Thai	Mthai; Wathai
Thailand	Uthai
The Hague	Den Haag
Thursday	ljuma
Togo	Togo
Tonga	Tonga
Trinidad and Tobago	Trinidadi na Tobago
Trinity	utatu
Tuesday	jumaane
Tunisia	Tunisia; Utunisi
Turkey	Uturuki 
Turkmenistan	Turukimenistani; Uturukimeni
Tuvalu	Tuvalu
Uganda	Uganda
Ukraine	Ukraini
Ukrainian	Mkraini
United States of America	Muungano wa Madola ya Amerika
Uranus	Urano; Yurenasi
Uruguay	Urugwai
Uzbek	Mzibeki
Uzbekistan	Uzibekistani; Uzibeki
Vanuatu	Vanuatu
Venezuela	Venezuela
Venus	Venusi
Vietnam	Vietinamu; Uvieti
Vietnamese	Mvietinamu; Mvieti
Viking	Mvikingi
Wednesday	jumatano
Western Sahara	Sahara Magharibi
Wiktionary	Wikamusi
Wiktionary:Usability/flag	bendera
Yangtze	Yangtze
Yaound√©	Yaounde
Yerevan	Yerevan
Zambia	Zambia
Zeus	Zeu
Zimbabwe	bepari; Zimbabwe
aardvark	mhanga '(nc 1/2)'
ability	uwezo
absorb	kufyonza
acacia	mshita
accept	kiri
accident	ajali
accordion	kodiani; harimuni
account	hazina; akaunti
accurate	sanifu
ace	ree
act	tenda
address	anwani
adjective	tashbihi
admiration	abos
adult	mtu mzima
adverb	kielezi; kisifa
advice	ushauri
aeroplane	ndege
agate	kalkedoni
age	umri
agent	wakala
agreement	maagano
agriculture	kilimo
air	hawa
airline	kampuni ya ndege
alcohol	pombe kali
alligator	aligatori; aligeita
aluminium	alumini
always	mara kwa mara
ambassador	balozi
ambulance	ambyulensi
amethyst	amethisto
ampersand	ampasendi
anal sex	kufira
analogue	Mfano
anchor	nanga
and	na
angel	malaika
animal	mnyama
anno Domini	baada ya Kristo
another	nyingine
answer	jibu
ant	sisimizi 
anteater	kiharara; loma
anthill	kishugu
antler	pembe-tawi
anus	kundu
anvil	fuawe
apple	tofaa '(nc 5/6)'
apple tree	mtofaa '(nc 3/4)'
appropriate	mwafaka
apron	aproni
archaic	dinari
architecture	majenzi
arm	mkono
armadillo	kakakuona
army	jeshi
arrest	nasa
arrow	mshale
article	makala
artist	msanii
ash	majivu
ask	kuomba
asshole	m'kundu
assistant	naibu
astrology	ramli
astronomy	falaki
athlete	mwanariadha
atmosphere	angahewa
auction	mnada
aunt	shangazi
authority	mamlaka
autumn	vuli; majira ya pukutiko; kipindi cha bubujiko
aviation	elimu ya rubani
avocado	parachichi '(noun 9/10)'
axe	shoka
baboon	nyani; sokwe
baby	mtoto; mwana
babysitter	mlezi wa#Swahili'wa muda; mlei; yaya#Swahili'yaya
back	mgongo
badger	melesi
bag	mfuko
bagpipes	bagpipes; gaida
balalaika	balalaika
bald	kipara
ball	mpira, mipira (p) '(noun 3/4)'
balloon	puto
banana	ndizi
band	bendi
bandage	bendeji; plasta
banjo	banjo; zeze la kizungu
bank	benki
banknote	noti
barber	kinyozi
bark	chamba (s), vyamba (p), gome (s), magome (p) (noun 5/6)'
barley	shayiri
barn owl	bundi
baseball	besiboli
basin	beseni
basket	kikapu
bassoon	basuni
bathe	kuoga
battery	betri
battle	vita
be	kuwa
beach	pwani '(nc 9/10)'
bean	haragwe (s), maharagwe (p) ('noun 5/6')
bear	dubu (nc 5/6)
beard	ndevu
beat	chapa
beautiful	zuri
beauty	urembo; uzuri
beaver	panyabuku-maji; biva; fondosi
bed	kitanda
bedbug	kunguni
bee	nyuki '(nc 9/10)'
beef	nyama ya ng'ombe
beer	pombe
beetle	mende
behaviour	tabia
behind	nyuma
bell	kengele
bend	pinda; kunja
benefit	manufaa
beryl	zabarajadi
beryllium	berili
better	bora
beverage	kinywaji
bicycle	baisikeli; baiskili
big	mkubwa
bill	mwsada
billion	bilioni
biology	biolojia
birch	mbetula
bird	ndege 
birth	zaliw
biscuit	biskuti
bit	charaza
bite	mdundo
black	eusi
black hole	shimo jeusi
blackcurrant	tunda bukini jeusi
blanket	blanketi
blasphemy	kufuru
blessing	baraka
blood	damu
blue	bluu
blueberry	buluuberi; beri ya buluu
board	bao
body	kiwiliwili
boil	uvimbe; jipu
bomb	bomu
bon voyage	safari njema
bone	mfupa
book	kitabu
bookshop	duka la vitabu '(nc 5/6)'
boron	boroni
botany	botania; elimumime
bottle	chupa
boundary	mpaka
bow	upinde '(nc 11/10)', uta '(nc 11/10)'
bowl	bakuli
boxing	ndondi
boy	mvulana
bra	sindiria
brain	bongo
branch	tanzu
bread	mkate '(noun 3/4)'
break	kuvunja
breakfast	chakula cha asubuhi
bribe	hongo; rushwa; mlungula; chai
bridge	daraja
broom	ufagio
brother	ndugu; kaka
brown	kahawia
bruise	chubuko
bucket	ndoo
buffalo	mbogo; nyati
bugle	buruji
build	kujenga
building	jenga
bulb	glopu
bull	fahali
buoy	boya
burn	choma
bus	basi
bush	kichaka
business	biashara
busy	bizi
butcher	mchinjaji
butt	matako
butter	siagi
butterfly	kipepeo
buttock	tako
button	kitufe
buy	kununua
cactus	cactus
cafeteria	mikahawa
cake	keki
calendar	kalenda
calf	ndama
call	mwito
camel	ngamia
camera	kamera
camouflage	kamaflaji; majificho
camp	kambi
canary	chiriku
cancer	saratani
candle	mshumaa, mishumaa 'pl (noun 3/4)'
cap	kofia
captain	nahodha
car	gari
caramel	karmeli
carbon	kaboni
carcass	mzoga; jifu
card	kadi
cardinal	kadinoli
carnivore	mla-nyama
carpenter	seremala
carpet	zulia
carrot	karoti '(noun 9/10)'
case	kesi
cashew	korosho
cassava	muhogo
cat	paka (nc 9/10)
caterpillar	kiwavi '(nc 7/8)'
catfish	kabare
cauliflower	koliflawa
cedar	mwerezi
ceiling	dari
celebration	sherehe
cell	seli
cell phone	simu ya mkononi
cello	chelo
cement	simiti
cent	senti
centimetre	sentimeta
centipede	tandu
central	katikati
chaff	wishwa
chain	ushanga
chair	kiti
chalcedony	kalkedoni
chalk	chaki
chameleon	kinyonga
champion	bingwa
chance	nafasi
change	badilisha
chaos	kesheshe
chapter	sura
character	sifa
charcoal	kaa
cheers	maisha marefu, afya, vifijo
cheese	jibini; chizi
cheetah	duma
chemical	kemikali
cheque	cheki
cherry	mcheri
chest	kifua
chicken	kuku
chickenpox	surua
chief	chifu
child	mtoto
children	watoto
chin	tawa; kidevu
choir	kwaya
cholera	kipindupindu
church	kanisa
citizen	mwananchi
citizenship	uraia
city	mji
clarinet	nzumari
class	darasa
classroom	darasa
clean	nadhifu; safi
clerk	karani
clever	erevu
clinic	kliniki
clitoris	kinembe 
close	fungu
cloth	nguo
cloud	wingu
clown	mcheshi
club	pau
coach	mkufunzi; kocha
coast	pwani; ufuko; mapwa; mapwaji
coat	koti
coffee	mbuni
coffee pot	dele
coin	sarafu
cold	baridi
colon	alama ya mkato
colonialism	ukoloni
color	michezo
come	kuja
commander	kamanda
committee	kamitii
communication	mawasiliano
communist	ukomunisti
community	jamii
company	kampuni
compare	linganisha
compass	bikari
compete	wania
complain	lalamika
complaint	lawama
computer	tarakilishi
comrade	ndugu
condom	kondomu; ndomu
conductor	utingo; kondakta
congratulate	heko
congratulation	hongera
constellation	kundinyota
constipation	vimbizi
constitution	katiba
contest	shindano
continent	bara
continue	endelea
contract	kandarasi
cook	kupika
cookie	biskuti
copper	shaba
copra	nguta
corn	muhindi; hindi
corner	kona
corpse	maiti; mfu
correct	timamu
cost	gharama
cough	kohozi
council	kikao
country	-a kimashamba
court	korti
cow	ngombe
cranberry	kranberi
crane	jeki
creditor	mdai
cricket	kriketi
criminal	mhalifu
crocodile	mamba
cross	misalaba
crow	kunguru
crown	kirauni
cruel	dhalimu
cry	kiliyo
crystal	fuwele
cuckoo	kekeo
cumin	jira (noun 9/10)
cup	kikombe
cupboard	kabati
currency	fulusi
current	kisasa
curse	laani
curtain	pazia
custom	forodha; desturi
customer	mteja, wateja 'pl (noun 1/2)'
cyan	cyan
cycling	baiskeli
cyclone	saikloni (m)
cypress	mvinje
daffodil	nasisa
dagger	jambia
dairy	shajara
daisy	jaja
dance	densi
danger	hatari
dark	giza
daughter	binti '(nc 5/6)'
day	siku
dear	gali
death	kifo
debate	mdahalo
decade	muungo
deer	kulungu
democracy	demokrasia
demon	pepo
deodorant	kuondoa harufu
depth	kina; kiini
desire	ari
desk	dawati; jarari
development	khuendelea; maendeleo
diameter	kipenyo
diamond	almasi
diamonds	uru
diarrhea	harisha
diary	tarihi
dictator	dikteta
dictionary	kamusi 
die	kufa
diocese	jimbo
diploma	diploma
diplomacy	diplomasia
direction	mwelekeo
director	mkurugenzi
dirt	takataka; uchafu
disappear	kutoweka
disaster	janga; afa
discussion	maneno; mazungumzo
disease	magonjwa
divide	gawa
division	farakano
divorce	talaka
do you speak English	unasema Kiingereza
doctor	daktari; dokta
doctrine	maadili
dodo	doda
dog	mbwa
dollar	dola
dolphin	pomboo
donation	mchango
donkey	punda
door	mlango
dough	mahamri
doughnut	andazi
down	chini; chini
dozen	dazani
draft	mpepea
dragon	joka
drama	sarakasi
drawing	mchoro
dream	-ota
dress	rinda
drink	kinywaji
drive	kuendesha
driver	dereva
drought	kiangazi; ukame
drum	ngoma
drunk	mlevi
drunkard	mlevi
dry	-kavu
duck	bata
dulcimer	santuri
dung	kinyezi
duty	zamu
dwarf	kijeba
dynamite	baruti
each	kila
eagle	tai
eagle owl	kungwi
ear	sikio
early	mapema
earth	udongo
earthquake	tetemeko '(noun 5/6)'
earthworm	choo
east	mashariki
easy	rahisi
eat	kula
ebony	abunusi
echidna	mhanganungu
echo	mwangwi
economics	uchumi
edition	toleo
editor	mhariri
education	elimu
eel	mkunga
effect	madhara
effort	juhudi
egg	yai
eight	nane
eighty	themanini
elbow	kisigino
elder	wazee
election	uchaguzi
electricity	umeme
electronic	ektroniki
electronics	elektroniki
element	elementi
elephant	ndovu; tembo
elevator	eleveta
emerald	zumaridi
emperor	kaisari
employee	mwajiriwa
employer	mwajiri
empty	utupu
end	mwisho; dali
enemy	maadui
energy	kani
enjoy	kujivinjari
enough	basi!
enter	kuingia
entertainment	burudani
envelope	bahasha
error	kasoro
escape	kwepa
eucalyptus	mkalitusi
evening	jioni
event	kisa; tukio
every	kila
example	mifano
exchange	ubadilishaji
exclamation mark	alama ya mshangao
executioner	mchinja, mchinjaji, mnyongaji
exercise	mazoezi
expensive	gali
experience	tajriba; uzoefu
expert	mtaalam
explosion	mlipuko
eye	jicho; jicho
eyeball	mboni
eyelid	kope '(noun 5/6)'
face	uso
faeces	mavi 'pl (nc 6)'
faith	imani
fame	fora; umaarufu
fan	shabiki
fang	chonge
fare	abiria
farm	shamba
farmer	mkulima 
fart	-shuta, -jamba
fast	funga
fast food	chakula cha kununua
fat	mafuta
fate	majaliwa
father	babamkwe
fax	faksi
fear	woga
feast	karamu
feather	nyoya
feces	mavi 'pl (nc 6)'
female	kike; jike
fence	ua
fennel	mshamari
ferry	feri
fertilizer	mbolea
festival	tamasha
fever	homa '(class 9/10)'
fifty	hamsini
fight	vita
fine	faini
finger	kidole; dole
fingernail	kucha
fir	mberoshi
fire	kupiga risasi; moto
fish	samaki
fisherman	mvuvi
fist	ngumi
flag	bendera
flamingo	heroe
flea	kiroboto '(nc 7/8)'
flesh	chembechembe
flood	mafuriko; gharika
floor	sakafu
flow	mkondo
flower	sitawi; bariki; chanua
fluorine	florini
flute	digali
fly	nzi
foam	povu
fog	ukungu '(nc 11/10)'
food	chakula
fool	fala; mjinga
foot	futi
force	mabavu
foreigner	ajinabi
forest	msitu; porini
forever	milele
fork	uma
forty	arobaini
foundation	msingi
four	nne
fox	mbweha mwekundu; thalabu
frame	fremu
francium	fransi
free	bure
freedom	uhuru; uhuru
fridge	jokofu; friji
friend	rafiki
friendship	urafiki
frighten	ogofia
frog	chura '(nc 7/8)'
fruit	tunda
fuck	kutomba
fun	fani
fur	unyoya
furniture	fanicha
game	mchezo
garden	shamba
garlic	kitunguu saumu; somu; thumu
gay	msenge; basha; shoga
gazelle	swala; swara; paa; impala
gender	jinsia
general	majenerali
generous	ukarimu
geography	jiografia
geology	jiologia
geometry	jiometri
get	wahi; pata
geyser	gaiza
giant	njemba
gift	zawadi '(noun 9/10)', nala
gin	jini
giraffe	twiga
girl	msichana; mwari
give	kupa
glass	glasi
glue	gundi
glutton	mlafi
gnu	nyumbu; mbogo
go	gura
goal	bao
goat	mbuzi '(noun 9/10)'
god	bwana 
gold	dhahabu
golden eagle	tai-mfalme; tai wa dhahabu
good	uzuri 
good morning	habari za asubuhi
goodbye	kwaheri; tuonane tena; majaliwea
goose	bata bukini
gooseberry	tunda bukini
gorilla	ngagi '(9/10)'
gossip	tetesi; fitina
government	serikali
grace	neema
grain	nafaka
grandchild	mjukuu
grandfather	babu
grapefruit	balungi
grapevine	mzabibu
graph	jedwali
grass	unyasi
grasshopper	panzi
gravity	graviti
grease	girisi
greed	tamaa
greeting	salamu
griffin	grifoni
group	kundi
grow	kukuza
growth	ukuaji
guard	askari; mlinzi; walinzi
guava	pera
guest	mgeni '(nc 1/2)'
guide	mwelekezi
guilt	hatia
guinea fowl	kanga; kororo
guitar	gitaa
gun	bunduki '(nc 9/10)'
hair	nywele
half	nusu
ham	hemu
hammer	nyundo
hand	mkono
handball	mpira
happen	tukiyo
happy birthday	Pongezi kwa siku ya kuzaliwa
hard	ngumu
hard drive	kiendeshi diski kuu
hare	sungura
harp	kinubi
hate	kuchukia
hatred	chuki
hawk	kipanga
hay	majani makavu, ukoko mkwavu
he	yeye (both male and female)
head	mkuu '(nc 1/2)'
health	afya
heart	kopa
heaven	mbingu
heavy	-zito
heel	kisigino
heir	mrithi
helium	heli
hello	jambo
helmet	helmeti; kofia ya chuma
help	msaidizi
hen	tembe; kuku
herbivore	mla-mimea
here	hapa
hero	shujaa
hi	jambo
hill	kilima
hinder	kinga; kinza
hippopotamus	kiboko
history	historia
hoe	jembe
holiday	likizo
honest	halali
honey	asali
hope	tumaini
horn	baragumu
horny	nyege
horse	farasi
hospital	hospitali
hotel	hoteli
hour	saa
house	nyumba 
how	namna; jinsi
how are you	habari gani?
how many	nukuu
human being	jamiana
human rights	haki za kibinadamu
hundred	mia
hunger	njaa; unenge
hunter	msasi
hurricane	kimbunga
hurt	kilemba
husband	mume
hydrogen	hidrojeni
hyena	fisi 'sg & pl (noun 9/10)'
hypocrite	kabwela
ice	barafu
idiot	mjinga; kichwamaji
ignore	puuza
illness	chirwa
immigration	uhamisho
immortality	hali ya kutokufa
impala	swala; pala
implement	tekeleza
important	maarufu
improve	boresha
incense	ubani
inch	inchi
income	mapato
industry	kiwanda
infant	watoto wachanga
inflation	mfumuko wa bei
injury	afa; jiraha; jeraha
ink	wino
insect	mdudu
inshallah	Mungu akipenda
inside	ndani
instant	sasa
insurance	bima '(noun 9/10)' (1)
intention	nia; azma; gharadhi
interfere	kinga; kinza
international	kimataifa
investment	uwekezaji
investor	mwekezaji
invisible	-si-onekana
iris	airisi
iron	chuma
island	kisiwa
ivy	mwefeu; lablabu
jack	ghulamu
jacket	jaketi
jade	yakuti kijani
jaguar	jagwa
jam	jemu
jarbua terapon	ngagu
jasper	yaspa
joke	mzaha; kasheshe
journey	safiri
joy	furaha
judge	jaji
judo	judo
jug	jagi
juice	jusi
jungle	mwituni
juniper	mreteni
just	adili
kangaroo	kangaroo
kanji	kanji
key	ufungu
kidnap	teka nyara
kill	kuua
king	shehe
kingdom	ufalme
kitchen	jiko; jikoni
knee	goti
kneel	kupiga magoti
knife	kisu
knot	funda
laboratory	maabara
ladder	ngazi
lake	jito; majito 
lamp	taa
land	ardhi
language	lugha 'sg/pl (noun 9/10)', ki-#Swahili'ki- '(noun prefix 7)'
lantern	koroboi
large	kikubwa
last year	mwaka jana
laurel	mbei 
lava	lava
lavender	mrujuani
law	sheria
lawn	ua
lawyer	wakili
laziness	uzembe
lazy	mlegevu
lead	ongoza
leader	kiongozi
leaf	gombo, magombo 'pl (noun 5/6)', ukurasa, kurasa 'pl (noun 11/10)'
leave	toka
left	kushoto
lemon	mdimu
lemonade	maji ya limau
length	urefu
leopard	chui
leprosy	ukoma
lesbian	shoga
lesson	funzo
letter	barua
lettuce	saladi
liar	mwongo
library	maktaba
lid	kifuniko
life	uhai
light	wepesi
light bulb	balbu
light year	mwaka wa nuru
lightning	radi
like	kupenda
limp	chopi
line	mstari
linguistics	isimu
lion	simba
liquid	majimaji
listen	sikiza
lithium	lithi
live	ishi
liver	maini
living room	sebule
loan	mkopo
locust	nzige
look	angalia
loss	hasara
lotus	yungiyungi la kimisri; lotasi
louse	chawa
love	kupenda
lover	mpenzi
luck	bahati
luggage	mzigo
lung	pafu '(nc 5/6)'
lute	gambusi
lynx	linksi
lyre	lira; kinubi kidogo
machete	panga
machine	mashine
magazine	jarida
magma	magma
magnesium	magnesi
magnet	sumaku 
maid	wafanyikazi
mainland	bara
maintain	dumisha
maize	hindi
male	kiume
manage	mudu
manager	meneja
mandolin	gambusi ndogo
mango	embe
manufacture	unda
manure	mboleya
many	wengi
map	ramani
maple	mwaramoni
march	machi
marijuana	bangi
mark	maki
market	soko
marriage	ndoa
marry	kuoa
mass	mshikano
masturbation	punyeto
match	mechi
mathematics	hisabati
mattress	godoro; mto
mayor	diwani
meaning	maana
meat	nyama '(noun 9/10)'
medicine	dawa
meet	kukutana
meeting	mkutano
member	mshiriki
mercenary	mamluki
mercury	zebaki
metal	chuma
metamorphosis	metamofosi
microphone	kipaza sauti; mikrofoni
microscope	hadubini; darubini ya vidudu
milk	maziwa
milkshake	sharubati
millennium	mwongo
millipede	jongoo
minister	waziri
mink	minki
mint	mnanaa
minute	dakika
mirror	kioo, vioo 'pl (noun 7/8)'
mistake	kosa
mobile phone	rununu
mole	fuko
molecule	molekuli
moment	kitambo '(nc 7/8)', nukta '(nc 9/10)'
monastery	monasteri
money	pesa
mongoose	nguchiro
monkey	tumbili 
month	mwezi '(nc 3/4)'
moon	mwezi '(nc 3/4)'
moose	elki (m)
mop	deki
morgue	mochari
morning	asubuhi '(noun 9/10)'
mosque	msikiti
mosquito	mbu '(nc 9/10)'
mother	mzazi; mama
motorcycle	pikipiki
mountain	mlima
mouse	kipanya
mouth	mdomo
move	peleka
mulberry	mforsadi
municipality	manispaa
muscle	msuli
mushroom	uyoga '(nc 11/10)'
music	mziki
musician	mwimbaji
mutton	nyama ya kondoo
my name is	jina langu ni 
myrrh	manemane
mysterious	kidube
mystery	siri
mythology	mitholojia
nail	kucha
name	jina
nation	taifa
nationality	uraya; utaifa
nausea	kichefuchefu
navel	kitovu '(noun 7/8)'
neck	shingo
necklace	kidani '(nc 7/8)'
necktie	tai
needle	sindano
neighborhood	mtaa
neighbourhood	mtaa
neon	neoni
nest	kiota
net	kiandarua
network	mtandao
new	kipya
news	habari
newspaper	gazeti
next	kando
nice	nzuri
nickname	msimbo
nicotine	nikotin
niece	mpwa
night	usiku
nightmare	jinamizi '(noun 5/6)'
nine	tisa
ninety	tisini
nitrogen	nitrojeni
no	hakuna ('followed by a ku-class infinitive')
no problem	hakuna matata
no smoking	hakuna kuvuta sigara
noise	sura
non	Shirika Lisilo la Kiserikali
noon	adhuhuri
north	kaskazi; hanali
nose	pua '(nc 9/10)'
noun	nomino
novel	riwaya
nucleus	nyukliasi 
number	nambari
nurse	muuguzi
nut	njugu
oak tree	mwaloni 
oath	kiapo
obedience	taa
oboe	nzumari ndogo
occurrence	jambo
ocean	bahari
octopus	pweza, pweza mkubwa
office	ofisi
ogre	jitu; dubwana
okra	kisamvu
old	mkongwe; ukale
olive tree	mzeituni
once upon a time	hapo zamani za kale
one	moja
onion	kitunguu
onyx	sardoniki
open	fungua
operation	operesheni
opinion	oni
opossum	oposumu
opponent	mpinzani
opportunity	fursa
or	au
orange	mchungwa
order	oda
organization	shirika
original	halisi
orphan	mfiwa; mtoto yatima
ostrich	mbuni
outside	nje
owl	bundi
owner	mwenyewe
ox	ng ºombe
oxygen	oksijeni
padlock	kufuli
page	ukurasa
pain	umwa
paint	rangi
pair of eyeglasses	miwani 'pl (noun 4)'
pair of glasses	miwani 'pl (noun 4)'
pair of specs	miwani 'pl (noun 4)'
pair of spectacles	miwani 'pl (noun 4)'
palace	kasri; jum
palate	kaakaa
palm	kikofi; kiganja
palm tree	mnazi
pancreas	kongosho
pants	chupi '(noun 9/10)'
papaya	papai, papayu
paper	karatasi; karatasi
parent	mzazi
park	mbuga
parliament	bunge
parrot	kasuku
part	sehemu
participate	shiriki
particle	chembechembe; punje
party	chama
passenger	abiria
passport	paspoti
password	nywila
path	ujia
patience	subra; uvumilivu
peace	amani
peacock	tausi
peanut	njugu
pear	pea
pearl	lulu
pelican	mwari
pen	kalamu
penis	mboo; mshiriki
pepper	pilipili
perfect	makini
perfection	ukamilifu
perhaps	huenda, pingine
period	majira; vipindi; mda
permission	idhini
person	mtu
petrol	petroli
pharaoh	firauni
philosopher	wasomi
phone	simu
photographer	mpigapicha
physicist	wanafizikia
physics	fizikia
piano	kinanda; piano
pig	nguruwe; nguruwe
pigeon	hua; njiwa
pillar	majabali
pillow	mto '(nc 3/4)'
pilot	rubani
pimp	buzi
pine	msonobari 
pineapple	mnanasi
pipe	digali
pirate	haramia
pistol	bastola
place	mahail
plan	mkakati
plane	ndege
planet	sayari
plant	mmea; mimea
plate	sahani
platypus	kinyamadege
play	tamthilia
player	mchezaji
pleasure	anasa '(nc 9/10)'
plug	plagi
plum	mzambarau
plural	wingi; akthari
poem	ushairi
poet	malenga
point	pointi
poison	sumu 
polar bear	dubu barafu
pole	mlingoti
police	polisi
police officer	afisa wa usalama
policy	sera
polygon	pembenyingi
pomegranate	mkomamanga
poor	maskini
pope	papa
poplar	mlibua
poppy	mpopi
popular	maarufu
porcupine	nungunungu '(nc 9/10)'
porpoise	poposi
porridge	uji
port	bandari
postcard	postkadi
pot	chungu
potato	batata; kiazi ulaya
pound	ratili '(noun 9/10)'
pour	mwaga
poverty	ufukara
power	nguvu
praise	shangilia
pray	sali
prayer	swali
preacher	mhubiri
predict	bashiri
pregnancy	mimba (italbrac'nc 9/10)
pregnant	wajamzito
preparation	tayari; mapema; utayarishi
prepare	andaa
president	rais
price	bei
pride	daha
priest	kasisi
prison	jela
prisoner	mabusu
problem	masaibu
professor	mwalimu
profit	dahili
project	mradi
promise	ahadi
pronoun	dhamiri; kijina; kiwakilishi; kitenzi jina
prophet	nabii
prostitute	malaya; changudoa; kiberenge; kiberenge
prostitution	umalaya 
protect	kukinga
protection	kingo '(noun 5)'
prove	hakiki
proverb	methali
province	mkoa; jimbo; jimbo
pubic hair	vinyuzi
pull	kuvuta
pumpkin	malenge
push	kusukuma
python	chatu
quail	tombo
quarter	robo
quartz	kwatsi
queen	malkia
question	swali
quiver	podo; ziaka; pongono
quiz	chemsha bongo
rabbit	sungura
race	mbio
radio	redio
railway station	stesheni ya treni
rain	mvua
rainbow	upinde wa mvua
ransom	fidia
raspberry	mrasiberi
rat	panya
reaction	mmenyuko
read	soma
reason	sababu
receive	pokea
recent	karibuni
recently	majuzi
record	rekodi
rectangle	mstatili
red	nyekundu
refrigerator	jokofu; friji
refugee	mkimbizi
refuse	gairi; dinda; kanusha
regret	sikitiko
reindeer	kulungu aktiki (m); mbawala aktiki (f)
relationship	husiano
relative	akraba
relief	faraja
religion	dini
repair	rekebisha
report	ripoti
representative	wajumbe
request	maombi
research	utafiti
residence	makao
resident	makao; mwenyeji; makaazi
respect	adabu; heshimu; taadhima
responsibility	jukumu; majukumu; madaraka
result	tokeo
reveal	dhihirisha
revelation	ufunuo
revenge	kisasi
revolution	mapinduzi; mageuzi
rhinoceros	kifaru '(noun 7/8)'
rice	mchele
rich	tajiri
riddle	fumbo
right	haki
ring	pete
river	mto
robber	mnyang'anyi
roof	paa 
room	chumba
rooster	jogoo
root	mzizi
rope	kamba
rose	rangi ya waridi
row	safu
rowboat	mtumbwi
rubber	kifutio
rubble	fusi
rude	jeuri
rug	kitamba
rugby	raga
rule	sharti
run	kukimbia
sabotage	susia
sack	gunia
sacrament	komunyo
sacrifice	muchanga; muchanga
sadness	huzuni
safe	uganda
saffron	zafarani
sail	shira
sailboat	dhau
sailor	baharia
salary	mshahara
saliva	mate
salt	chumvi
same	sawa
sand	mchanga '(class 3/4)'
sandalwood	msanduku
sapphire	yakuti samawi
saw	msumeno
saxophone	harimuni; saksofoni
saying	misemo; msemo
scale	mzani
scales	mizani
scandal	kashfa
scarce	nadra
scarlet	nyekundu
school	shule
scientist	mwana sayansi
scimitar	kitara
scissors	mkasi, mikasi ('pl, noun 3/4')
score	funga
scorpion	nge '(noun 9/10)'
screw	parafujo ('noun 9/10')
sculpture	kinyagu
scythe	fyekeo
sea	bahari 'sg/pl (noun 9/10)'
sea horse	mbuzi-bahari
sea turtle	kasa
seal	sili
season	msimu
seaweed	mwani
second	sekunde
secret	siri
secretary	karani
seed	mbegu
semicolon	alama ya nuktamkato
sentence	kifungo; kifungo
series	msururu
serpent	joka
service	huduma
seven	saba
seventy	sabini
sex	ngono
shame	aibu; soni; fedheha
shape	umbo
share	hisa
shareholder	mweyehisa
shark	papa
shawl	kikoi
she	yeye ('both male and female')
sheep	kondoo
shepherd	mchungaji
shield	ngao '(noun 9/10)'
ship	meli
shirt	shati
shoe	kiatu
shoot	kupiga risasi
shop	duka
shore	ukingo wa bahari
short	fupi
shot	kaptula
shout	kupiga kilele
show	shoo
sickle	mundu
sieve	kichujio
signature	saini
silver	fedha '(nc 9/10)'
similar	lingana
simile	kibadala
sin	madhambi
sing	imba
sink	-zamisha
sister	dada
sit down	kukaa kitako
six	sita
sixty	sitini
skeleton	kiunzi cha mifupa
skill	uhodari
skin	ngozi 
skirt	skati '( nc 9/10)'
skull	fuvu la kichwa
sky	anga
slap	kibare; kibao
slave	falahi
slavery	utwana
sleep	usingizi
slope	mteremko
sloth	mvivu-miti; slothu
slow	pole; aste
small	mdogo
smell	harufu
smile	tabasamu
smoke	moshi
smooth	laini
snail	konokono '(nc 5/6)'
snake	tnyoka 
sneeze	chichimua
snow	theluji '(noun 9/10)'
soap	sabuni
soccer	soka; kandanda
sodium	natiri
soil	mchanga
solution	suluhu
solve	utatuzi
sorcerer	mshirikina
sound	sauti
south	kusini
space	nafasi
spade	shupaza
spaghetti	spageti
sparrow	shomoro
speak	ongea
speaker	spika
spear	mkuki
spectacles	miwani 'pl (noun 4)'
speed	kasi
sperm whale	nyangumi-shahawa
sphere	mviringo
spice	kiungo
spider	buibui
spirit	roho
spleen	wengu 
spoon	kijiko
sport	spoti
spread	enea
spring	masika; majira ya chipuko; kipindi cha demani
spy	majasusi
squirrel	kindi '(nc 9/10)'
stable	imarika; ustawi
stage	ukumbi
stand	msimamo
star	nyota '(nc 9/10)'
state	hali
station	kituo
steak	steki
steel	feleji; chuma cha pua
steering wheel	usukani
step	hatua
stick	kijiti
stink	nuka
stir up	chochea
stomach	tumbo
stone	jiwe
stool	kiroto; jarari
stork	kongoti
storm	dhoruba
story	hadithi
stove	jiko
strawberry	mstrouberi
strength	nguvu
strike	migomo
string	uzi
strong	imara
stubborn	mkaidi
student	mwanafunzi; mwanachuo
subject	somo
submarine	nyambizi; sabmarini
sudden	ghafla
suddenly	kwa ghafula
suffer	teseka
sugar	sukari
sugar cane	miwa
sum	jumla
summer	kiangazi; majira ya joto; kipindi cha kiangazi
sun	jua
sunflower	alizeti
surname	Obama
sushi	sushi
suspect	mshukiwa
swallow	meza
swamp	bwawa
swan	bata-maji
swarm	jana
swear	yamini
sweat	jasho
sweater	sweta
sweet	peremende; pipi
swell	fura; vimba
swim	kuogelea
switch	swichi
sword	upanga
symbolically	mfano
synonym	kisawe
system	kawaida; utaratibu; mfumo
table	meza
table of contents	yaliyomo
tail	mkia '(nc 3/4)'
talent	kipaji; talanta
tank	tangi
tap	mfereji
target	lengwa
taste	kionjo
tax	ushuru
taxi	teksi
tea	chai 
teacher	mwalimu; maalim
team	timu
tear	machozi
teaspoon	kijiko cha chai
technology	teknologia
teenager	kijana
telepathy	telepathia
telephone	piga simu
telescope	darubini
television	runinga; televisheni
temple	hekalu
ten	kumi
tent	hema
territory	wilaya; eneo
terror	kikuli (s), vikuli 'pl (noun 7/8)'
terrorist	adui (s), maadui 'pl (noun 5/6)'
test	jaribio
text	Nakala
thanks	asante
the	ya
theater	ukumbi; thiata
theft	wizi
there is	pana
thermometer	vikipimajoto
they	yeye
thief	mwizi
thigh	mapaja
thing	kitu, vitu 'pl (noun 7/8)'
thirty	thelathini
thorn	mwiba
though	ijapokuwa, hata hivyo
thought	dhana; fikira; gezo
thousand	elfu
threat	tisho
throw	kutupa
thumb	kidole gumba
thunder	radi '(nc 9/10)'
tick	kupe
tiger	chui-milia
timber	mbao
tin	mkebe
tip	kiinua mgongo
titanium	titani
title	mada
toad	chura; chula
tobacco	tumbako; tobaccos
toe	kidole 
toilet	choo; kibakuli cha choo
tomato	mnyanya
tone	kitone
tongs	koleo; makoleo
tongue	ulimi
tool	vifaa (p) '(noun 7,8)'
tooth	jino (s), meno 'pl (noun 5/6)'
topaz	topazi; yakuti manjano
torch	tochi
tornado	tufani (m)
tortoise	kobe
total	jumla
tourist	mtalii
towel	taulo
town	mji
toy	leksak
tradition	tamaduni; itikadi; utamaduni; tabia
traditional	kienyeji
train	gari moshi; treni
translate	tafsiri
translation	fasiri
translator	mfasiri '(nc 1/2)', mfumbua '(nc 1/2)', mtapta '(nc 1/2)'
transport	safirisha
trap	mtego
travel	Safari
traveller	msafiri; wasafiri
tray	uteo
trench	mtaro; handaki
triangle	pembe tatu
tribe	kabila
trident	tridenti
trombone	tromboni
trumpet	tarumbeta
trust	muamana
truth	ukweli
tsar	czar
tsunami	tsunami
tuba	tuba
tube	mrija
turkey	bata mzinga
turmeric	manjano
turquoise	rangi ya feruzi
turtle	kobe
turtle dove	hua
tusk	pembe-jino; pembe-meno
twenty	ishirini
twin	pacha
typhoon	taifuni
tyre	gurudumu
umbrella	mwavuli
understand	elewa
underwear	chupi
unicorn	yunikoni
uniform	sare
universe	ulimwengu
university	chuo kikuu
up	juu
uranium	urani
urine	mkojo 
use	matumizi
useful	faida
user	mtumiaji
vaccine	chanjo
vagina	kuma
valley	bonde
value	thamani
value added tax	kodi ya#Swahili'ya nyongeza
vampire	mumiani; vampiri
vegetable	mmea
vein	mshipa
verb	kielezi
victory	ushidi
village	kijiji
vine	sabibu
violin	fidla
virgin	bikira
virus	virusi
vision	taswira
vitamin	vitamini
vocabulary	misamiati
vodka	vodka
volcano	volkano; volkeno
volleyball	voliboli
vomit	kutapika
wake	kuamsha
walk	kutembea
walking stick	mkwaju; mkongojo
wall	kiambaza
wallet	kipochi
walnut	mjozi
walrus	nguva aktiki; walrosi
war	vita
warn	ashiria
warship	manowari
warthog	ngiri
watch	kutazama
water	maji
water buffalo	nyati '(nc 9/10 or 1/2)'
watermelon	tikiti 
wave	wimbi
wavelength	safa
way	mamna
we	sisi
weapon	silaha
wear	kuvaa
weather	hali ya hewa
web site	tovuti
wedding	harusi
weed	kwekwe
week	wiki
weekend	wikendi
welcome	karibu!
well	kisima
west	magiribi
whale	nyangumi
what time is it	ni saa ngapi
wheat	ngano '(class 9/10)'
wheel	gurudumu '(noun 5/6)'
wheelbarrow	ngolofimo
where is the toilet	choo kiko wapi
whiskey	wiski
whistle	kipenga
white	weupe
why	kwaje
wick	utambi; ukope
widow	mjane
wild boar	jivi
wild turkey	kalkon
will	wasia
willow	msafsafi; misafsafi
wind	upepo
window	dirisha
wine	divai
wing	bawa
winner	mshindi
winter	kipupwe; majira ya baridi; kipindi cha baridi
wire	waya
wisdom	mwanafalsafa
wise	staarabu
witch	mchawi
witchcraft	uganga; urogi; ndumba
with	na
witness	shahidi
wolf	mbwa mwitu 'sg/pl (noun 9/10)'
wolverine	fisi-milima; wolverini
woman	mwanamke
wombat	wombati
wonder	maajabu
woodpecker	kigong'ota
word	neno
work	kufanya kazi
worry	dukuduku
wound	vimbe
wreath	taji la maua
write	kuandika
writing	andiko
xylophone	zilofoni; marimba ya kizungu
yam	nduma
year	mwaka
yellow	manjano
yes	ndiyo
yesterday	jana
yoghurt	maziwa ya mgando
you	ninyi
young	dogo
yours	wako
youth	vijana
zebra	punda milia 
zero	ziro
