English	Greek
AIDS	σύνδρομο επίκτητης ανοσολογικής ανεπάρκειας (n) (síndromo epíktitis anosologikís anepárkias); AIDS (n)
Abidjan	Αμπιντζάν (m) (Abidzán)
Abkhaz	αβχαζιανά (avkhazianá)
Abkhazia	Αμπχαζία (f) (Abchazía)
Abraham	Αβραάμ (m) (Avraám)
Adam	Αδάμ (m) (Aðám)
Afghanistan	Αφγανιστάν (n) (Afganistán)
Africa	Αφρική (f) (Afrikí)
Afrikaans	αφρικάανς (n) (afrikáans)
Al Jazeera	Αλ Τζαζίρα (f) (Al Tzazíra)
Albania	Αλβανία (f) (Alvanía)
Alberta	Αλμπέρτα (f) (Albérta)
Alexander	Αλέξανδρος (m) (Aléksandros)
Algeria	Αλγερία (f) (Algería)
Algiers	Αλγέρι (n) (alʝéri)
Allah	Αλλάχ (m) (Allách)
Alps	Άλπεις (f); Άλπαι (Álpai)
America	Αμερική (f) (Amerikí)
American bison	βόνασος
Amsterdam	Άμστερνταμ (Ámsterdam); Αμστελόδαμο (Αμστελόδαμο)
Amur	Αμούρ (Amoúr)
Andorra	Ανδόρρα (Andórra) (f) or Ανδόρα (Andóra) (f)
Andrew	Ανδρέας (m) (Andréas)
Anglo	αρχαία αγγλική γλώσσα (f)
Angola	Ανγκόλα (f) (Angóla)
Ankara	Άγκυρα (f) (Ánkyra)
Antarctica	Ανταρκτική (f) (Antarktikí)
Antigua and Barbuda	Αντίγκουα και Μπαρμπούντα (Antígoua kai Barboúda)
April	Απρίλιος (m) (Aprílios); Απρίλης (m) (Aprílis)
Arab Republic of Egypt	Αραβική Δημοκρατία της Αιγύπτου (f) (Araviki Dimokratia tis Aigyptu)
Argentina	Αργεντινή (Argentiní)
Argonaut	Αργοναύτες
Arkhangelsk	Αρχάγγελσκ (Arkhángelsk)
Armenia	Αρμενία (f) (Armenía)
Armenian	Αρμένιος (m) (Arménios); Αρμένια (f) (Arménia); Αρμένης (m) (Arménis); Αρμένισσα (f) (Arménissa)
Asclepius	Ασκληπιός
Asia	Ασία (f) (Asía)
Athena	Αθηνά (f) (Athiná)
Athens	Αθήνα (f) (Athína)
August	Αύγουστος (m) (Ávgoustos)
Australia	Αυστραλία (f) (Afstralía)
Austria	Αυστρία (f) (Afstría)
Azerbaijan	Αζερμπαϊτζάν (n) (Azerbaïtzán)
Azeri	αζερικά (n)
Bahamas	Μπαχάμες (Bahámes)
Bahrain	Μπαχρέιν (n) (Bachréin)
Baku	Μπακού (Bakú)
Balearic Islands	Βαλεαρίδες Νήσοι (Valearídes Nísi) (p)
Baltic Sea	Βαλτική Θάλασσα (Baltikí Thálassa)
Bambara	μπαμπάρα
Bangkok	Μπανκόκ (f) (Ban'kók); Μπαγκόκ (f) (Ban'kók); Μπανγκόκ (f) (Ban'gók); Μπαγγόκ (f) (Ban'gók)
Bangladesh	Μπαγγλαντές (n) (Baŋgladés)
Barbados	Μπαρμπάντος
Beijing	Πεκίνο (n) (Pecíno)
Beirut	Βηρυττός '(Bēryttós)'
Belarus	Λευκορωσία (f) (Lefkorosía)
Belarusian	λευκορωσικά (n)
Belgium	Βέλγιο (n) (Vélgio)
Belgrade	Βελιγράδι (n) (Veligraði)
Belize	Μπελίζε (Belíze), Μπελίζ (Belíz)
Belorussian	λευκορωσικά (n)
Benin	Μπενίν (Benín) (n)
Berlin	Βερολίνο (n) (Verolíno)
Bermuda	Βερμούδες (Vermúdes)
Bhutan	Μπουτάν (n) (Boután)
Bible	Αγία Γραφή (f) (Agía Grafí); Βίβλος (f) (Vívlos)
Black Sea	Μαύρη Θάλασσα (f) (Mávri Thálassa)
Bolivia	Βολιβία (f) 
Bosnia	Βοσνία (Vosnía)
Bosnia and Herzegovina	Βοσνία-Ερζεγοβίνη (f) (Vosnía-Erzegovíni); Βοσνία και Ερζεγοβίνη (f) (Vosnía kai Erzegovíni)
Bosphorus	Βόσπορος (m) (Vósporos)
Botswana	Μποτσουάνα (Botsouána) (f)
Brazil	Βραζιλία (f) (Vrazilía)
Breton	βρετονικά (n)
Brunei	Μπρουνέι (n) (Brounéi)
Brussels	Βρυξέλλες (f) (Vrikséles)
Bucharest	Βουκουρέστι (f) (Voukourésti)
Buddha	Βούδας (m) (Voúdhas)
Buddhism	βουδισμός (m) (voudismós)
Bulgaria	Βουλγαρία (f) (Voulgaría)
Bulgarian	βουλγαρικά (n)
Burkina Faso	Μπουρκίνα Φάσο (f) (Bourkína Fáso)
Burma	Βιρμανία (f) (virmanía); Μυανμάρ (n) (mianmár); Μπούρμα (f) (búrma)
Byzantine Empire	Βασιλεία Ῥωμαίων (Vasilía Romaíon)
California	Καλιφόρνια (Kalifórnia)
Cambodia	Καμπότζη (f) (Kambótzi)
Cameroon	Καμερούν (n) (Kameroún)
Canada	Καναδάς (m) (Kanadás)
Cape Verde	Πράσινο Ακρωτήριο (n) (Prásino Akrotírio)
Carthage	Καρχηδόνα (f)
Caspian Sea	Κασπία Θάλασσα (Kaspía Thálassa) (f)
Catalan	καταλανικά (n)
Caucasus	Καύκασος (m) (Káfkasos)
Central African Republic	Κεντροαφρικανική Δημοκρατία (f) (Kentroafrikanikí Dimokratía)
Chad	Τσαντ
Chicago	Σικάγο (n) (sikáɣo)
Chile	Χιλή (Chilí) (f)
China	Κίνα (f) (Kína)
Chinese	Κινέζος (m) (Kinézos); Κινέζα (f) (Kinéza)
Chisinau	Κισινάου (Kisináou)
Christ	Χριστός (m) (Christós)
Christian	χριστιανός (m) (christianós); χριστιανή (f) (christianí)
Christianity	χριστιανισμός (m) (christianismós)
Christmas	Χριστούγεννα (n)
Christmas tree	δένδρο των Χριστουγέννων (n) (dhendron ton Khristuyénnon)
Christopher	Χριστόφορος (Christóphoros), Χρήστος (Hrḗstos)
Cinderella	Σταχτοπούτα (f) (Stahtopoúta)
Coca	Κόκα-κόλα (Kóka-kóla)
Colombia	Κολομβία (f) (Kolomvía)
Commonwealth of Independent States	Κοινοπολιτεία Ανεξαρτήτων Κρατών (f) (Koinopoliteía Anexartíton Kratón); ΚΑΚ (f)
Congo	Δημοκρατία του Κογγό or Δημοκρατία του Κονγκό (Dimokratía tou Kongó) (f)
Constantinople	Κωνσταντινούπολη (f) (Konstantinoúpoli)
Copenhagen	Κοπεγχάγη (f) (Kopenchági)
Costa Rica	Κόστα Ρίκα 
Crimea	Κριμαία (f)
Croatia	Κροατία (f) (Kroatía)
Croatian	Κροατικά (kroatiká) (p)
Cuba	Κούβα (f) (Koúva)
Cyprus	Κύπρος (f) (Kýpros)
Cyrillic	κυριλλιακόν (n) (cyrilliakón); κυριλλικό αλφάβητο (n) (cyrillikó alfávito)
Cyrillic alphabet	κυριλλικό αλφάβητο (n) (cyrillikó alfávito)
Czech	Τσέχος (m); Τσέχα (f)
Czech Republic	Δημοκρατία της Τσεχίας (f) (Dimokratía tis Tsechías); Τσεχία (f) (Tsechía)
Czechia	Τσεχία (f) (Tsechía)
Czechoslovakia	Τσεχοσλοβακία (f) (Tsechoslovakía)
Damascus	Δαμασκός (f) (Damaskós)
Danish	δανέζικα (n); (n)
Danube	Δούναβης (doúnavis)
David	Δαβίδ
Dead Sea	Νεκρά θάλασσα (f) (Nekrá thálassa)
December	Δεκέμβριος (m) (Dekémvrios); Δεκέμβρης (m) (Dekémvris)
Denmark	Δανία (f) (Danía); Δανιμαρκία (f) (Danimarkía)
Djibouti	Τζιμπουτί (n) (Tzimpoutí)
Dominican Republic	Δομινικανή Δημοκρατία (f) (Dominikaní Dimokratía)
Donald Duck	Ντόναλντ Ντακ (m) (Dónald Dak)
Dutch	Ολλανδοί (m)
East Timor	Ανατολικό Τιμόρ (n) (Anatolikó Timór)
Easter	Πάσχα (f) (Paskha); Ανάσταση (Anástasi); Λαμπρή (f) (Labrí)
Eastern Europe	Ανατολική Ευρώπη (f) (Anatolikí Evrópi)
Edmonton	Έντμοντον
Egypt	Αίγυπτος (f) (Aígyptos)
England	Αγγλία (f) (Anglía)
English	Άγγλος (Ánglos) (m), Εγγλέζος (Englézos, 'common') (m)
Equatorial Guinea	Ισημερινή Γουινέα (f) (Isimeriní Gouinéa)
Eritrea	Ερυθραία (f) (Erythréa)
Esperanto	Εσπεράντο (Esperánto)
Estonia	Εσθονία (f) (Esthonía)
Ethiopia	Αιθιοπία (f) (Aithiopía)
Eurasia	Ευρασία (f) (Evrasía)
Europe	Ευρώπη (f) (Evrópi)
European Union	Ευρωπαϊκή Ένωση (f) (Evropaïkí Énosi)
European bison	βόνασος Ευρωπαϊκώς
Far East	Άπω Ανατολή (f) (Ápo Anatolí)
Faroe Islands	Νήσοι Φερόες (n'p)
February	Φεβρουάριος (m) (Fevrouários); Φλεβάρης (m) (Fleváris)
Fiji	Φίτζι (n) (Fítzi)
Finland	Φινλανδία (f) (Finlandía); Φιλλανδία (f) (Fillandía)
Finnish	φινλανδικά (n)
France	Γαλλία (f) (Gallía)
French	Γάλλοι (m) 
Friday	Παρασκευή (f) (Paraskeví)
GDP	ΑΕΠ
Gambia	Γκάμπια (f) (Gámbia)
Gaza Strip	Λωρίδα της Γάζας (f) (Lorída tis gázas)
Geneva	Γενεύη (f) (Genévi)
George	Γεώργιος (m) (Geórgios); Γιώργος (m) (Giórgos)
Georgia	Γεωργία (f) (Georgía)
Georgian	Γεωργιανά (Georgianá)
German	γερμανικός (germanikós)
German Shepherd	Γερμανικός Ποιμενικός (m)
Germany	Γερμανία (f) (Germanía)
Ghana	Γκάνα (f) (Gána)
Ghent	Γάνδη (f)
Gibraltar	Γιβραλτάρ (Yivraltár)
Gnosticism	γνωστικισμός (m) (gnostikismós)
Goa	Γκόα (Góa)
God	Θεός (m) (Theós)
Great Britain	Μεγάλη Βρετανία (Megáli Vretanía)
Great Pyramid of Giza	πυραμίδα του Χέοπα (f) (pyramída tou Chéopa)
Greece	Ελλάδα (f) (Elláda); Ελλάς (f) (Ellás)
Greek	Έλληνας (m) (Éllinas); Ελληνίδα (f) (Ellinída)
Greenland	Γροιλανδία (f)
Guatemala	Γουατεμάλα (f) (Gouatemála)
Guinea	Γουινέα-Μπισσάου (Gouinéa-Bissáou)
Gujarati	Γκουτζαρατικά (n)
Gulf of Finland	Φινλανδικός κόλπος (Finlandikós kólpos)
Guyana	Γουιάνα (f) 
Haiti	Αϊτή (n) (Aïtí)
Happy Easter	Καλό Πάσχα (Kaló Páscha)
Happy New Year	καλή χρονιά (kalí chroniá); ευτυχισμένος ο καινούριος χρόνος (eftychisménos o kainoúrios chrónos)
Hebrew	εβραϊκά (n)
Hindi	χίντι (chíndi)
Hitler	Χίτλερ (m) (Chítler)
Holland	Ολλανδία (f) (Ollandía); Κάτω Χώρες (f)
Holocaust	Ολοκαύτωμα
Holy Spirit	Άγιο Πνεύμα (n) (Ágio Pnévma)
Honduras	Ονδούρα (f) (Ondoúra)
Hong Kong	Χονγκ Κονγκ (Hóng Kóng)
Hungarian	Ούγγρος (m) (Oúngros); Μαγυάρος (m) (Magyáros); Ουγγαρέζα (f) (Oungaréza)
Hungary	Ουγγαρία (f) 
I	εγώ (egó)
I am English	είμαι Άγγλος (m) (íme Ánglos); είμαι Αγγλίδα (f) (íme Anglída)
I have a question	έχω μια ερώτηση (écho mia erótisi)
I love you	σ' αγαπώ (s' agapó); σε αγαπώ (se agapó)
I need an interpreter	χρειάζομαι ένα διερμηνέα (khriázome éna dierminéa)
Iceland	Ισλανδία (f) 
Indonesia	Ινδονησία (f) (Indonisía)
International Phonetic Alphabet	Διεθνές Φωνητικό Αλφάβητο (n)
Internet	Διαδίκτυο (n) (Diadíktyo); ίντερνετ (n) (ínternet); διαδίκτυο (n) (δiaδíktyo)
Iran	Ιράν (n) (Irán)
Iraq	Ιράκ (Irák) (n)
Ireland	Ιρλανδία (f) (Irlandía)
Irish	ιρλανδικά (n)
Islam	Ισλάμ (n) (Islám)
Islamophobia	ισλαμοφοβία (f) (islamofovía)
Israel	Ισραήλ (n) (ísra'íl)
Italian	ιταλικός (italikós)
Italy	Ιταλία (f) (Italía)
Jamaica	Τζαμάικα (f) (Tzamáika)
January	Ιανουάριος (m) (ianouários); Γενάρης (m) (yenáris)
Japan	Ιαπωνία (f) (Iaponía)
Japanese	ιαπωνικός (iaponikós)
Jerusalem	Ιεροσόλυμα (n)
Jesus	Ιησούς (m) (Iisoús)
Jesus Christ	Ιησούς Χριστός (m) (Iesús Xristós)
Jew	Εβραίος (m) (Evraíos); Εβραία (f) (Evraía); Ισραηλίτης (m) (Israilítis); Ισραηλίτισσα (f) (Israilítissa)
Jewish	ιουδαϊκός (iudhaïκόs)
John	Ιωάννης (Ioánnis)
Jordan	Ιορδανία (f) (Iordanía)
Joseph	Ιώσηπος; Ιωσήφ
Judaism	Ιουδαϊσμός (Ioudaïsmós)
July	Ιούλιος (m) (Ioúlios); Ιούλης (m) (Ioúlis); Αλωνάρης (m) (Alonáris)
June	Ιούνιος (m) (Ioúnios); Ιούνης (m) (Ioúnis); Θεριστής (m) (Theristís)
Kazakhstan	Καζαχστάν (n) (Kazachstán); Καζακστάν (n) (Kazakstán)
Kenya	Κένυα (f) (Kénya)
Khartoum	Χαρτούμ (Khartoúm)
Khmer	Χμερ (n)
Khrushchev	Χρουστσόφ
Kiev	Κίεβο (n) (Kíevo)
Korea	Κορέα (f) (Koréa)
Korean	κορεατικά (n)
Kosovo	Κοσσυφοπέδιο (n) (Kosifopedio)
Kurdish	κουρδικά (kourdiká)
Kuwait	Κουβέιτ (Kouvéit)
Kyrgyzstan	Κιργιζία (f) (Kirgizía); Κιργιζιστάν (n) (Kirgizistán)
Laos	Λάος (n) (Láos)
Latin	λατινικά (n)
Latin alphabet	λατινικό αλφάβητο (latinikó alfávito) (n) (:el:λατινικό αλφάβητο'el)
Latvia	Λεττονία (f) (Lettonía)
Latvian	λεττονικά (n)
Lebanon	Λίβανος (m) (Lívanos)
Leo	Λέων
Lesotho	Λεσόθο (n) 
Liberia	Λιβερία (f) (Livería)
Libya	Λιβύη (f) (Livýi)
Liechtenstein	Λιχτενστάιν (n) (Lichtenstáin)
Lisbon	Λισσαβώνα (f) (Lissabóna)
Lithuania	Λιθουανία (f) (Lithouanía)
London	Λονδίνο (n) (londíno)
Luxembourg	Λουξεμβούργο (n) (Louksemvoúrgo)
Lyons	Λυών; Λυόν
Macedonia	Σκόπια (f) (Skópia); Πρώην Γιουγκοσλαβική Δημοκρατία της Μακεδονίας (f) (Próin Yiougkoslavikí Dimokratía tis Makedonías); ΠΓΔΜ (f); Δημοκρατία της Μακεδονίας (f) (Dimokratía tis Makedonías); Μακεδονία (f) (Makedonía)
Madrid	Μαδρίτη (f) (Madhriti)
Magna Carta	Μάγκνα Κάρτα (f)
Malayalam	μαλαγιαλαμικά (n)
Malaysia	Μαλαισία (f) (Malesía)
Maldives	Μαλδίβες (f)
Malta	Μάλτα (f) (Málta)
Man	άνθρωπος (m) (ánthropos)
Manchuria	Μαντζουρία (f) (Mandžuría)
Maoism	μαοϊσμός (m) (maoïsmós)
March	Μάρτιος (m) (Mártios); Μάρτης (m) (Mártis)
Mars	Άρης (m) (Áris)
Marshall Islands	Νήσοι Μάρσαλ (m) 
Mary	Μαρία (María)
Matthew	Ματθαίος
Mauritania	Μαυριτανία (f)
Mauritius	Μαυρίκιος (m) (Mauríkios)
May	Μάιος (m) (Máios); Μάης (m) (Máis)
Mediterranean Sea	Μεσόγειος Θάλασσα (f) (Mesógeios Thálassa); Μεσόγειος (f) (Mesógeios)
Mercury	Ερμής (m)
Merry Christmas	Καλά Χριστούγεννα (Kalá Christoúgenna)
Merry Christmas and a Happy New Year	Καλά Χριστούγεννα και Καλή Χρονιά (Kalá Christoúgenna kai Kalí Chroniá)
Mexico	Μεξικό (n) (Mexikó)
Michael	Μιχαήλ (m) (Michaíl); Μιχάλης (m) (Michális)
Middle East	Μέση Ανατολή (f) (Mési Anatolí)
Minsk	Μίνσκ (Mínsk)
Miss	δεσποινίδα (f) (dhespinídha); δεσποινίς (f) (despinís)
Moldova	Μολδαβία (f) 
Monaco	Μονακό (n) (Monakó)
Monday	Δευτέρα (f) (Ðeftéra)
Mongolia	Μογγολία (f) (Mongolía)
Mongolian	Μόγγολος (m) (Móngolos); Μογγόλα (f) (Mongóla)
Montenegro	Μαυροβούνιο (n) (Mavrovoúnio)
Moon	σελήνη (f) (selíni); φεγγάρι (n) (fe[n]gári)
Morocco	Μαρόκο (n) (Maróko)
Moscow	Μόσχα (f) (Móscha)
Moses	Μωυσής (m) (Moisís)
Mount Everest	Έβερεστ
Mozambique	Μοζαμβίκη (f) (Mozamvíki)
Mr	κος
Mrs	κα (f) (ka)
Muhammad	Μωάμεθ (m) (Moámeth)
Mumbai	Βομβάη (Vomvái)
Munich	Μόναχο (n) (mónaxo)
Muslim	Μουσουλμάνος (m) (Mousoulmános)
Myanmar	Βιρμανία (f) (Virmanía); Μυανμάρ (n) (Mianmár)
NATO	ΝΑΤΟ; ΟΒΣ
Nagorno	Ναγκόρνο-Καραμπάχ (m) (Nagórno-Karabách)
Namibia	Ναμίμπια
Naypyidaw	Νάι Πι Τάου (f) (Nái Pi Táou)
Nepal	Νεπάλ (Nepál)
Netherlands	Κάτω Χώρες (Káto Khóres); Ολλανδία (f) (Ollandía)
New Delhi	Νέο Δελχί (n) (Néo Delhí)
New York City	Νέα Υόρκη (néa iórci); Πόλη Νέας Υόρκης (f) (póli néas iórcis)
New Zealand	Νέα Ζηλανδία (f) (Néa Zilandía)
Nicaragua	Νικαράγουα (f) (Nikarágoua)
Nicholas	Νικόλαος (Nikolaos)
Niger	Νίγηρας (n) (Nígiras)
Nigeria	Νιγηρία (f) (Nigiría)
North America	Βόρεια Αμερική (Vória Amerikí) (f)
North Korea	Βόρεια Κορέα (Vória Koréa) (f)
North Sea	Βόρεια Θάλασσα (Vóreia Thálassa) (f)
Northern Europe	Βόρεια Ευρώπη (f) (Vóreia Evrópi)
Northern Ireland	Βόρειος Ιρλανδία (f) (Vóreios Irlandía)
Norway	Νορβηγία (f) (Norvigía)
Norwegian	νορβηγικά (n); Νορβηγική (f) (norviγikí)
November	Νοέμβριος (Noémvrios) (m), Νοέμβρης (Noémvris) (m)
Occitan	οσιτανικά (n)
Oceania	Ωκεανία (f) (Okeanía)
October	Οκτώβριος (m) (Októvrios); Οκτώβρης (m) (Októvris)
Olympic Games	Ολυμπιακοί Αγώνες (m)
Oman	Ομάν (n) (Omán)
Pacific Ocean	Ειρηνικός Ωκεανός (m) (Eirinikós Okeanós)
Pakistan	Πακιστάν (n) (Pakistán)
Palestine	Παλαιστίνη (f) (Palaistíni)
Panama	Παναμάς
Papua New Guinea	Παπουασία-Νέα Γουινέα (f) (Papouasía-Néa Gouinéa); Παπούα-Νέα Γουινέα (f) (Papoúa-Néa Gouinéa)
Paris	Παρίσι (n) (parísi)
Paul	Παύλος (m) (Pávlos)
Persian	περσικά (n); φαρσί (farsí)
Peru	Περού (n) (Peroú)
Philippines	Φιλιππίνες (Philippínes)
Pisces	Ιχθύες (m)
Pleiades	Πλειάδες (f)
Poland	Πολωνία (f) (Polonía)
Polish	πολωνικά (n)
Portugal	Πορτογαλία (f) (Portogalía)
Portuguese	Πορτογάλος (m); (f)
Prague	Πράγα (f) (Prága)
Pythagoras	Πυθαγόρας
Qatar	Κατάρ (n) (Katár)
Red Sea	Ερυθρά θάλασσα
Reykjavik	Ρέικιαβικ (Réikiavik); Ρέυκιαβικ (Réykiavik)
Richard	Ριχάρδος (m); Ρίτσαρντ (m)
Roman	ρωμαϊκός (m) (romaïkós); ρωμαϊκή (f) (romaïkí); ρωμαϊκό (n) (romaïkó)
Romania	Ρουμανία (f) (Roumanía)
Romanian	ρουμάνικα (n) 
Rome	Ρώμη (Rómi)
Russia	Ρωσία (f) (Rosía)
Russian	ρωσικά (n)
Russian Federation	Ρωσική Ομοσπονδία (f) (Rosikí Omospondía)
Rwanda	Ρουάντα (f) (Rouánda)
Saint Petersburg	Αγία Πετρούπολη (Agía Petroúpoli)
San Marino	Άγιος Μαρίνος (m) (Ágios Marínos)
Sanskrit	σανσκριτική γλώσσα (f)
Santa Claus	Άγιος Βασίλης (Áyios Vasílis)
Satan	Σατανάς (m) (Satanás)
Saturday	Σάββατο (Sávvato) (n)
Saturn	Κρόνος (m) (Krónos)
Saudi Arabia	Σαουδική Αραβία (f) (Saoudikí Aravía)
Scotland	Σκωτία (f) (Skotía)
Senegal	Σενεγάλη (f) (Senegáli)
Seoul	Σεούλ (Seoúl)
September	Σεπτέμβριος (m); (m) (m)
Serb	Σέρβος (m) (Sérvos)
Serbia	Σερβία (f) (Servía)
Serbia and Montenegro	Σερβία και Μαυροβούνιο (Servía kai Mavrovoúnio) (f)
Serbian	Σέρβος (m); Σέρβα (f)
Shanghai	Σανγκάη (Sangkái)
Shinto	ςιντοϊσμός
Siberia	Σιβηρία (f) (Siviría)
Sicily	Σικελία
Singapore	Σιγκαπούρη (f) (Singapoúri)
Slovakia	Σλοβακία (f) (Slovakía)
Slovene	σλοβενικά (n)
Slovenia	Σλοβενία (f) (Slovenía)
Snow White	Χιονάτη (f) (Chionáti)
Sochi	Σότσι (Sótsi)
Sofia	Σόφια (Sófia)
Solar System	ηλιακό σύστημα (n) 
Somalia	Σομαλία (f) (Somalía)
Sophocles	Σοφοκλής (m) (Sophokles)
South Africa	Νότια Αφρική (f) (Nótia Afrikí)
South America	Νότια Αμερική (f) (Nótia Amerikí)
South Korea	Νότια Κορέα (f) (Nótia Koréa)
South Ossetia	Νότια Οσετία (f) (Nótia Osetía)
South Sudan	Νότιο Σουδάν (Nótio Soudán)
Soviet Union	Σοβιετική Ένωση (f) (Sovietikí Énosi)
Spain	Ισπανία (f) (Ispanía)
Spanish	ισπανικά (n); ισπανική γλώσσα (spanikí glóssa)
Sparta	Σπάρτη (Spárti)
Sri Lanka	Σρι Λάνκα (f) (Sri Lánka)
Stalin	Στάλιν (m) (Stálin)
Sudan	Σουδάν (n) (Soudán)
Suez Canal	Διώρυγα Σουέζ
Sunday	Κυριακή (f) (Kyriakí)
Suriname	Σουρινάμ (n) 
Sweden	Σουηδία (f) (Souidía)
Swedish	σουηδικά (n) 
Switzerland	Ελβετία (f) (Elvetía)
Syria	Συρία (f) (Syría)
Taipei	Ταϊπέι (Taïpéi)
Taiwan	Ταϊβάν (f) (Taïván)
Tajikistan	Τατζικιστάν (n) (Tatzikistán)
Tallinn	Ταλλίν (n) (Tallín); Ταλίν (n) (Talín)
Tanzania	Τανζανία (f)
Tbilisi	Τιφλίδα (f) (Tiflídha)
Tehran	Τεχεράνη (tekheráni)
Tel Aviv	Τελ Αβίβ (Tel Avív); Τελ Αβίβ - Γιάφα (Tel Avív-Yáfa)
Telugu	τελούγκου (telúgu)
Ten Commandments	δέκα εντολές (p)
Thai	Ταϊλανδικά (Taïlandiká), Ταϋλανδικά (Taÿlandiká) (n'p)
Thailand	Ταϊλάνδη (f) (Taïlándi)
The Hague	Χάγη (f) (Cháyi)
Thursday	Πέμπτη (f) 
Togo	Τόγκο (n)
Transnistria	Υπερδνειστερία (f)
Tuesday	Τρίτη (f) (Tríti)
Tunisia	Τυνησία (f)
Turkey	Τουρκία (n) (Tourkía)
Turkish	τουρκικά (n); τούρκικα (n)
Turkmenistan	Τουρκμενιστάν (n) (Tourkmenistán)
USA	ΗΠΑ (f)
USSR	ΕΣΣΔ (f) (ESSD)
Uganda	Ουγκάντα (f) (Ougánda)
Ukraine	Ουκρανία (f) (Oukranía)
Ukrainian	Ουκρανικά (n)
Union of Soviet Socialist Republics	Ένωση Σοβιετικών Σοσιαλιστικών Δημοκρατιών (f) 
United Arab Emirates	Ηνωμένα Αραβικά Εμιράτα (n)
United Kingdom	Ηνωμένο Βασίλειο (n) (Inoméno Vasílio)
United States	Ηνωμένες Πολιτείες (f)
United States of America	Ηνωμένες Πολιτείες της Αμερικής (f); (f) Ηνωμένες Πολιτείες (f); ΗΠΑ (f) 
Uranus	Ουρανός (m) (uranós)
Uruguay	Ουρουγουάη (Ourougouái) (f)
Uzbekistan	Ουζμπεκιστάν (n) (Ouzbekistán)
Valkyrie	Βαλκυρία (f) 
Vatican City	Βατικανό (n)
Venezuela	Βενεζουέλα (f) (Venezouéla)
Venus	Βένους (f) (Vénous); Αφροδίτη (f) (Afrodíti)
Vienna	Βιέννη (f) (Viénni); Βιένη (f) (Viéni)
Vietnam	Βιετνάμ (n) (Vietnám)
Wales	Ουαλία (f) (Oualía)
Warsaw	Βαρσοβία (f) (Varsovía)
Wednesday	Τετάρτη (f) (Tetárti)
Western Europe	Δυτική Ευρώπη (f) (Dytikí Evrópi)
Western Sahara	Δυτική Σαχάρα (f) (Dytikí Sahára)
White House	Λευκός Οίκος (m) (Lefkós Oíkos)
White Sea	Λευκή Θάλασσα (f) (Lefkí Thálassa)
Wikipedia	Βικιπαίδεια (f) (Vikipaídeia)
Wiktionary	Βικιλεξικό (n) (Vikilexikó)
Wiktionary:Usability/flag	σημαία (f)
William	Γουλιέλμος
World War II	Δεύτερος Παγκόσμιος Πόλεμος (m) (Défteros Pagkósmios Pólemos); Β' Παγκόσμιος Πόλεμος (m) (V' Pagkósmios Pólemos)
Wroclaw	Βρότσλαβ (Vrotslav)
Yangon	Ρανγκούν (f) (Rangún); Ραγγούν (f) (Rangún)
Yaoundé	Γιαουντέ (Yaoundé)
Yekaterinburg	Γεκατερίνμπουργκ (m) (Yekaterínbourg)
Yemen	Υεμένη (f) (Yeméni)
Yerevan	Γιερεβάν (n) (Yiereván)
Yugoslavia	Γιουγκοσλαβία (f) (Yiougoslavía)
Zagreb	Ζάγκρεμπ (Zágkreb)
Zambia	Ζάμπια (f) (Zámbia)
Zoroastrianism	Ζωροαστρισμός
aardvark	μυρμηγκοφάγος (m) (myrmēgkofágos)
abacus	άβακας (m) 
abandon	εγκαταλείπω (engkatalípo)
abbot	ηγούμενος
abbreviation	συντομογραφία (f) (syntomografía); βραχυγραφία (f) (vrachygrafía)
absolute zero	απόλυτο μηδέν (n) (apólyto midén)
accordion	ακορντεόν (n) 
accusative	αιτιατική (f)
acid	οξύ
acorn	βελανίδι (velanídi)
actinium	ακτίνιο (n) 
actor	(m) (hypokritēs) (m)
address	διεύθυνση (f) (diéfthynsi)
adjective	επιθετικός (epithetikós)
admiration	θαυμασμός (m) (thaumasmós)
adverb	επίρρημα (n) (epírrima)
advertisement	διαφήμιση (f) (diafimisi)
aeroplane	αεροπλάνο (n) (aeropláno); αεροσκάφος (n) (aeroskáfos)
after	μετά (metá)
afternoon	απόγευμα (n) (apógevma)
again	ξανά (xaná); πάλι (páli)
age	ηλικία 
aggressive	επιθετικός (epithetikós) (m), επιθετική (f), επιθετικό (n)
ago	πριν 
agriculture	γεωργία (f) (georgía); αγροκαλλιέργεια (f) (agrokalliérgeia)
aircraft	αεροσκάφος (n) (aeroskáfos)
airplane	αεροπλάνο (n) (aeropláno); αεροσκάφος (n) (aeroskáfos)
airport	αεροδρόμιο (n) (aerodrómio); αερολιμένας (m) (aeroliménas)
alcohol	οινόπνευμα (n) (oinópnevma); αλκοόλ (n) (alkoól)
algorithm	αλγόριθμος (m) (algórithmos)
alkyne	αλκίνιο (n) (alkínio)
all	όλοι 
all rights reserved	με επιφύλαξη παντός δικαιώματος (me epifílaksi pandós diceómatos); όλα τα δικαιώματα προστατεύονται (óla ta diceómata prostatévonde)
alligator	αλλιγάτορας (m) (alligátoras); αλιγάτορας (m)
almond	αμύγδαλο (n) (amýdgalo)
almost	σχεδόν (skhedón)
alphabet	αλφάβητο (n) 
already	ήδη
also	επίσης
aluminium	αργίλιο; αλουμίνιο (n) (aloumínio)
am	είμαι (eímai)
amber	ήλεκτρο (n) (ílektro); κεχριμπάρι (n) (kechrimpári)
ambulance	ασθενοφόρο (n) (asthenofóro)
americium	αμερίκιο (n) (ameríkio)
ampersand	συμπλεκτικό σύμβολο (symplektikó sýmvolo) (n)
an	ένας (énas)
anal sex	πρωκτική συνουσία (f) (proktikí sinusía); πρωκτικό σέξ (n) (proktikó sex)
anarchism	αναρχισμός (m) (anarchismós)
and	και (kai)
anger	οργή (f) (orgí)
angry	θυμωμένος (m) (thimoménos)
anime	ανιμέ (animé)
ankle	αστράγαλος (m) (astrágalos)
answer	απάντηση (f) (apántisi); απόκριση
ant	μυρμήγκι (n) (mirmigi); μερμήγκι (n) (mermigi)
anthrax	άνθρακας (m) (ánthrakas)
antimony	αντιμόνιο (n) (antimónio)
antonym	αντώνυμο (n) 
anus	πρωκτός (proktós)
anvil	αμόνι (n) 
apartment	διαμέρισμα (n) (diamérisma)
apple	μήλο (n) (mílo)
apple tree	μηλιά (f) (miliá)
apricot	βερίκοκο (n) (veríkoko)
archaeology	αρχαιολογία (f) (arçeoloyia)
architect	αρχιτέκτονας (m)
architecture	αρχιτεκτονική (f) (architektonikí)
argent	ασημί (asimí) (n), ασημένιο (asiményo) (n), αργυρό (arghiró) (n)
argon	αργό (n) (argó)
arm	χέρι (n) (chéri)
armpit	μασχάλη (mascháli)
army	στρατός (m) (stratós); στράτευμα (n) (strátevma)
arrow	βέλος (n) (vélos); σαΐτα (f) (saḯta)
arsenic	αρσενικό (n) (arsenikó)
artichoke	αγκινάρα (f) (aginara)
article	άρθρο (árthro)
ash	στάχτη (f) (stáchti); τέφρα (f) (téfra)
ask	παρακαλώ (parakaló), ζητώ (zitó)
ass	όνος (m) (onos); γάϊδαρος (m) (gaidaros)
astatine	άστατο (n) (ástato)
asteroid	αστεροειδής (m) (asteroeidís)
astronomical unit	αστρονομική μονάδα (f) (astronomiki monada)
astrophysics	αστροφυσική (f) (astrofysikí)
at	στον (ston) (m), στη (sti) (f), στο (sto) (n); στους (stous) (m'p), στις (stis) (f'p), στα (sta) (n'p)
at sign	παπάκι (n) (papáki)
atheism	αθεϊσμός (m) (atheïsmós); αθεΐα (f) (atheḯa)
atom	άτομο (n)
aubergine	μελιτζάνα (melitzána) (f), παπούτσι (papoutsí, "shoe") (n) (colloquial)
aunt	θεία (f) (theía)
autumn	φθινόπωρο (n) (fthinóporo)
avalanche	χιονοστιβάδα (f) (chionostiváda)
awake	ξυπνώ (ksypnó); αφυπνίζω (afypnízo)
axe	τσεκούρι (n) (tsekoúri)
axis	άξονας (m) (áksonas)
baby	μωρό (n) (moró); βρέφος (n) (vréfos)
babysitter	μπεϊμπισίτερ (beïbisíter); μπέμπι−σίτερ (bébi-síter)
back	πλάτη (f) (pláti)
bad	κακός (kakós); άσχημος (áschimos)
badger	ασβός (m)
bag	σακούλα (f) (sakúla); σάκος (m) (sákos)
bagpipes	γκάιντα (f) (gkáivta)
bakery	φούρνος (m) (foúrnos)
balcony	μπαλκόνι (n) (balkóni)
bald	φαλακρός
ball	σφαίρα (f) (sfaíra)
balloon	μπαλόνι (balόni)
banana	μπανάνα (f) (banána)
bank	τράπεζα 
barcode	γραμμοκωδικός (m) (γramokoδikós)
barium	βάριο (n) (vário)
bark	φλοιός (m) (floiós)
barley	κριθάρι (n) (krithári)
barn owl	πεπλόγλαυκα (peplóglafka) (f)
baseball	μπέιζμπολ (béizbol)
basket	καλάθι (n) (kaláthi); κάνιστρο (n) (kánistro)
basketball	καλαθοσφαίριση (f) (kalathosférisi)
bat	νυχτερίδα (f) (nychterída)
bathroom	λουτρό (n) (loutró); μπάνιο (n) (bánio)
battery	μπαταρία
battle	μάχη (f)
bay	κόλπος (kólpos)
be	γίνομαι (gínomai)
beach	αμμουδιά (f) (ammudiá); παραλία (f) (paralía); ακρογυαλιά (f) (akroyaliá)
beak	ράμφος (n) (rámfos)
bear	αρκούδα (f) (arkoúda); άρκτος (f) (árktos)
beard	γένι (n) (géni)
beautiful	ωραίος (m); (m)
beauty	ομορφιά (f) (omorfiá)
beaver	κάστορας (m) (kástoras)
because	διότι (dióti); επειδή (epeidí); γιατί (yiatí)
become	γίνομαι (ginomai)
bed	κρεβάτι (n) (kreváti); κλίνη (f) (klíni); κοίτη (f) (kjíti); ευνή (f) (evní)
bedroom	υπνοδωμάτιο (n) (ipnodomatio)
beech	οξιά (f) (oxia)
beef	βοδινό (n) (vodinó); βόειο (n) (vóeio)
beer	μπίρα (f) (bíra); ζύθος (m) (zýthos)
beetle	σκαθάρι (n) (skafári)
before	πριν (prin)
begin	αρχίζω (archízo)
behind	πίσω από 
bell	καμπάνα (f) (kampána)
belly	κοιλιά (koiliá)
belt	ζώνη (f) (zóni)
berkelium	μπερκέλιο (n) (berkélio)
berry	μώρον (n) (móron)
beryllium	βηρύλλιο (n) (virýllio)
better	καλύτερος (m) 
bicycle	ποδήλατο (n) (podílato)
big	μεγάλος (megálos)
bill	ράμφος (n) (rámfos)
billion	δισεκατομμύριο (n) (disekatommýrio)
biochemistry	βιοχημεία (f)
biology	βιολογία (f) (viología)
bipolar disorder	διπολική διαταραχή (f) (dipolikí diatarachí)
birth	γέννα (f) (génna); τοκετός (m) (toketós)
birthday	γενέθλια (genéthlia)
biscuit	μπισκότο (m) (biskóto)
bishop	αξιωματικός (m) (axiomatikós)
bismuth	βισμούθιο (n) (vismoúthio)
bitch	σκύλα (f) (skýla); λύκαινα (líkena)
bitter	πικρός (m) (pikrós)
black	μαύρο (n) (mávro); μελανό (n) (melanó); μέλαν (n) (mélan)
black grouse	λυροπετεινός (liropetinós) (m)
black hole	μαύρη τρύπα (f) (mávri trýpa); μελανή οπή (f) (melaní opí)
black woodpecker	μαυροτσικλιτάρα
blackberry	βατόμουρο (n)
blackbird	κόσσυφος (m) (kóssyfos); κοτσύφι (n) (kotsýfi)
blanket	κουβέρτα (f) (kouverta)
bleed	αιμορραγώ (aimorragó); ματώνω (matóno)
bless you	γείτσες (geítses)
blind	τυφλός (tyflos)
blog	ιστολόγιο (n) (istológio)
blood	αίμα (n) (aíma)
blue	γαλάζιο (ghalázio), γαλανό (ghalanó), μπλε (ble), κυανό (kianó), γλαυκό (ghlafkó)
boar	κάπρος (m) (kápros); αγριογούρουνο (n) (agriogúruno)
boat	βάρκα (f); λέμβος (f); καΐκι (n)
body	σώμα (n) 
bomb	βόμβα (f) (vómva)
bon appétit	καλή όρεξη (kalí órexi)
bon voyage	καλό ταξίδι (kaló taxídi)
bone	κόκαλο (m) (kókalo)
bookshop	βιβλιοπωλείο (n) (vivliopoleío)
boot	μπότα (f) (bóta)
boron	βόριο (n) (vório)
bottle	μπουκάλι (n) (boukáli); φιάλη (f) (fiáli)
box	κιβώτιο (kivotio) (n), κουτί (kuti) (n), κασόνι (kasoni) (n)
boxing	πυγμαχία (pygmakhía) (f), μποξ (mbox) (n)
boy	αγόρι (n) (agóri)
bra	στηθόδεσμος (m)
brain	εγκέφαλος (m) (egkéfalos); μυαλά (n)
branch	κλαδί (n) (klaδí); κλαρί (n) (klarí)
brave	γενναίος (gennaíos)
break	σπάω ('spao)
breakfast	πρωινό (n) (proinó); πρόγευμα (n) (prógevma)
breast	στήθος (n) (stíthos); μαστός (m) (mastós)
brick	τούβλο (n) (toúvlo)
bride	νύφη (f) (nýfi)
bridge	γέφυρα (f) (géfyra)
bromine	βρόμιο (n) (vrómio)
broom	σκούπα (f); (n) (n)
brother	κουνιάδος (m) (kouniádos)
brown	καστανός (m) (kastanós)
brush	βούρτσα (f) (voúrtsa)
bucket	κουβάς (kuvas) (m)
buffalo	βίσονας (m) (vísonas)
building	δόμηση (f); οικοδόμηση (f)
bull	ταύρος (m) (távros)
bullet	σφαίρα (f) (sfaíra)
bus	λεωφορείο (n) (leoforeío)
busy	πολυάσχολος (polyáskholos)
but	μολονότι (molonóti), παρόλο (parólo), καίτοι (kéti), αν και (an ke)
butcher	χασάπης (m) (chasápis)
butter	βούτυρο (n) (voútyro)
buy	αγοράζω (agorázo)
buzzard	γερακίνα (f)
cactus	κάκτος (m)
cadmium	κάδμιο (n) (kádmio)
caesium	καίσιο (n) (kaísio)
café	καφενείο (n) (kafenío)
calcium	ασβέστιο (n) (asvéstio)
calendar	ημερολόγιο (n) (imerológio)
calf	μοσχάρι (n) (moschári)
californium	καλιφόρνιο (n) (kalifórnio)
camel	καμήλα (f)
can	μπορώ 
canary	καναρίνι (n) (kanaríni)
cancer	καρκίνος (m) (karkínos)
candle	κερί (n) (kerí)
cannabis	καννάβεις (kannávis)
canyon	φαράγγι (n) (farángi); χαράδρα (f) (kharáðra)
capercaillie	αγριόκουρκος ' '
capital	κεφάλαιο (n) (kefálaio)
capital city	πρωτεύουσα (f) (protévousa); μητρόπολη (f) (mitrópoli)
capitalism	κεφαλαιοκρατία (f) (kefalaiokratía); καπιταλισμός (m) (kapitalismós)
car	άμαξα (f) (ámaksa); βαγόνι (n) (vaγóni)
caramel	καραμέλλα (f) (karamélla)
carbon	άνθρακας (m) (ánthrakas)
carp	κυπρίνος (m) (kiprinos); σαζάνι (n) (sazani)
carpenter	ξυλουργός (m) (xylourgós); μαραγκός (m) (marangkós)
carpet	τάπητας (m) (tápitas)
carrot	καρότο (n) (karoto)
carry	κουβαλώ (kouvaló)
castle	κάστρο (n) (kástro)
cat	(n) (ailouroeidés)αίλουρος (m) (aílouros)
caterpillar	κάμπια (f) (kámpia)
cauliflower	κουνουπίδι (n) (kunupídi)
cave	σπηλιά (f) (spiliá); σπήλαιο (n)
cedar	Κέδρος (kedros)
ceiling	οροφή (f) (orofí); ταβάνι (n) (taváni)
cell	κύτταρο (n) (kýttaro)
cell phone	κινητό τηλέφωνο (n)
center	κέντρο (n) (kéntro)
centimetre	εκατοστόμετρο (ekatostómetro); εκατοστό (n) (ekatostó)
centipede	σαρανταποδαρούσα (f) (sarantapodaroúsa)
century	αιώνας (m) (aiónas); εκατονταετία (f) (ekatontaetía)
cerium	δημήτριο (n) (dimítrio)
chain	αλυσίδα (f) (alisíδa)
chair	καρέκλα (f) 
chamois	αγριόγιδο [aɣriˈo̞ʝiˌðo̞] (n), αγριοκάτσικο [aˌɣrio̞ˈkatsiˌko̞] (n), αίγαγρος [ˈe̞ɣaˌɣro̞s] (m)
change	αλλάζω (allázo); μεταμορφώνομαι (metamorfónomai)
chaos	χάος (n) (cháos)
chapter	κεφάλαιο (n) (kefálaio)
chase	κυνηγώ; καταδιώκω
cheap	φθηνός; φτηνός
cheek	μάγουλο (n) (mágoulo)
cheers	εις υγείαν (eis ygeían), στην υγειά… (stin ygeiá…), ’ς υγεία’ ('s ygeía'), γεια μας (geia mas)
cheese	τυρί (n) (tyrí)
cheetah	γατόπαρδος (m) (gatópardos)
chemistry	χημεία (f) (chimeía)
cherry	κεράσι (n) (kerási)
chess	σκάκι (n) (skáki)
chest	στήθος (n) (stíthos); στέρνο (n) (stérno); θώρακας (m) (thórakas)
chestnut	κάστανο (n)
chew	μασάω (masáo)
chicken	κοτόπουλο (n) (kotópoulo)
child	παιδί (n); (m)
chimpanzee	χιμπατζής (m) (khimpatzís)
chin	σαγόνι (n); πηγούνι (n)
chlorine	χλώριο (n) (chlório)
chocolate	σοκολάτα (f) (sokoláta)
choice	επιλογή (f) 
choir	χορωδία (f) (chorodía)
choose	διαλέγω 
chord	ακόρντο (n); συγχορδία (f)
chromium	χρώμιο (n) (chrómio)
church	Εκκλησία (f) (Eklisía)
cigarette	τσιγάρο (n) (tsigáro)
cinema	κινηματογράφος (m) (kinimatográfos); σινεμά (n) (sinemá)
clarinet	κλαρινέτο (n) (klarinéto)
clay	άργιλος (m) (árgilos); πηλός (m) (pilós)
clean	καθαρίζω
clock	ρολόι; ρολόγια
cloud	σύννεφο (n) (sýnnefo)
coast	ακρογιαλιά (f); (m) (f) (f)
cobalt	κοβάλτιο (n) (kováltio)
cock	κόκορας (m) ('kókoras')
cockroach	κατσαρίδα (f) (katsarída)
coconut	καρύδα (f) (karýda)
cod	μπακαλιάρος (m) (bakaliáros)
coffee	καφές (m) (kafés)
coffin	φέρετρο (n) (féretro)
coin	κέρμα (n) (kérma); νόμισμα (nómisma)
cold	κρύωμα (n) (krýoma)
cold war	ψυχρός πόλεμος (m) (psychrós pólemos)
collect	προσχωρήσουν (proschorísoun); συγκεντρώνουν (synkentrónoun)
color	χρώμα (n) (chróma)
columbine	ακουιλέγκια (akouilégkia)
come	έρχομαι (érchomai)
common gull	γλάρος ' '
communism	κομμουνισμός (m) (kommounismós)
company	εταιρεία (f) (etereía); εταιρία (f) (etería)
compass	πυξίδα (f) (pyxída)
computer	υπολογιστής (m) (ypologistís)
computer language	γλώσσα προγραμματισμού (f) (ɤlósa proɤramatiʑmú)
comrade	σύντροφος (m) (sýntrofos); συντρόφισσα (f) (syntrófissa)
concrete	σκυρόδεμα (n) (skyródema); μπετόν (n) (betón)
condom	προφυλακτικό (n) (profylaktikó)
conjunction	σύνδεσμος (m)
connective tissue	συνδετικός ιστός (m) (syndetikós istós)
conscience	συνείδηση (f) (syneídese)
continent	ήπειρος (f) (ípeiros)
copper	χαλκός 
corn	καλαμπόκι (kalaboki)
corpse	πτώμα (n) (ptóma); κουφάρι (n) (kufári)
corridor	διάδρομος (m) (δiáδromos)
cotton	βαμβάκι (vamváki)
cough	βήχω (víkho)
count	μετράω (metráo)
country	ύπαιθρος (f) (ýpaithros); εξοχή (f) (exochí)
courage	κουράγιο (n) (kourágio); θάρρος (n) (thárros)
crab	καβούρι (n) (kavoúri); καρκίνος (m) (karkinos)
crane	γερανός (m) (geranós)
cream	κρέμα γάλακτος (f) (kréma gálaktos)
cricket	γρύλος (m) (grýlos)
crime	έγκλημα (n)
crocodile	κροκόδειλος (m) (krokódeilos)
cross	σταυρός (m)
crossword	σταυρόλεξο (staurolexo, stavrolexo)
crow	κουρούνα (f) (kouroúna)
cruel	σκληρός (sklērós)
cry	κλαίω (kléo)
crystal	κρύσταλλος (krýstallos) <!--move translation to Greek page: [ˈkristaˌlo̞s]--> (m)
cube	κύβος (m)
cuckoo	κοϋκος (kúkos) (m)
cucumber	αγγούρι (n) (angoúri)
culture	ec=Grek
cunt	μουνί (n) (mouní)
cup	φλιτζάνι (n) (flitzáni); κούπα (f) (koúpa)
curium	κιούριο (n) (kioúrio)
current	ρεύμα (n) (révma)
curse	κατάρα (f) (katára)
curtain	κουρτίνα (f)
dance	χορεύω (chorévo)
dangerous	επικίνδυνος (m), επικίνδυνη (f), επικίνδυνο (n)
dark	σκοτεινός (m) 
dark matter	σκοτεινή ύλη (f) (skoteini yli)
darkness	σκοτάδι (n) (skotádi); έρεβος (n) (érevos); ζόφος (m) (zófos)
data	δεδομένα (n)
date	συνάντηση (f)
date palm	χουρμαδιά (f) (chourmadiá)
daughter	νύφη (f) (nýphī); κόρη (f) (kórī)
day	ημέρα (f); (f)
dead	νεκρός (nekrós), πεθαμένος (pethaménos), άψυχος (ápsykhos) (soul-less), άζω(τ)ος [ázō(t)os] (life-less)
deaf	κωφός (m) (kofós); κουφός (m) (koufós)
dear	ακριβός (m) (akrivós); δαπανηρός (m) (δapanirós)
death	θάνατος (m) (thánatos)
decade	δεκαετία (f)
deer	ελάφι (eláfi) (n), ζαρκάδι (zarkáði) (n), δορκάδα (ðorkáða) ('Gazella dorcas') (f), άλκη (álci) ('Cervus elaphus') (f)
delicious	εύγευστος (m), εύγευστη (f), εύγευστο (n)
democracy	δημοκρατία (f) 
demon	,
dentist	οδοντίατρος (odontíatros); οδοντογιατρός (m)
dessert	επιδόρπιο (n) (epidórpio); γλυκό (n) (glykó)
devil	διάβολος (m) (diávolos)
dew	πάχνη (f) (páchni); δροσιά (f) (drosiá); δρόσος (f) (drósos)
dialect	διάλεκτος (f) (diálektos)
diarrhea	διάρροια (diárroia); ευκοιλιότητα (f) (efkoiliótita)
diary	ημερολόγιο (n) (imerolóyio)
dick	ψωλή (psolí); πούτσος (poútsos); πούτσα; καυλί (kavlí); πούλος (púlos)
dictionary	λεξικό (n) (lexikó)
die	ζάρι (n) (zári); ζάρια (zária); κύβος (kývos); κύβοι (kývoi)
difficult	δύσκολος (dúskolos)
dining room	τραπεζαρία (f)
dinosaur	δεινόσαυρος (m) (deinósavros)
dirty	βρώμικος (m) (vromikos); ακάθαρτος (m) (akathartos); λερωμένος (m) (leromenos)
discussion	συζήτηση (f) (syzítísí); συνομιλία (f) (synomilía)
disease	ασθένεια (asthéneia); αρρώστια (f) (aróstia); νόσος (f) (nósos); πάθηση (f) (páthisi)
do	κάμνω (kámno)
do you speak English	μιλάς αγγλικά (milás angliká?); μιλάτε αγγλικά (miláte angliká?)
doctor	διδάκτορας (m)
documentation	τεκμηρίωση
dog	σκύλος (skílos); κύων (kíon)
doll	κούκλα (f) (kúkla)
dollar	δολλάριο (n) (dollário); δολάριο (n) (dolário)
donation	δωρεά (IPA'[ðo̞ˌre̞ˈa]) (f), συνεισφορά (IPA'[siˌnisfo̞ˈra]) (f), εισφορά (IPA'[ˌisfo̞ˈra]) (f)
donkey	γάιδαρος (m) (gáidaros)
door	πόρτα (f) (pórta); θύρα (f) (thýra)
dormouse	δασομυωξός (m)
doubt	αμφιβολία (amphibolía)
dough	ζύμη (f) (zými)
doughnut	λουκουμάς (m) (loukoumás)
dove	περιστέρι (n) (peristéri)
dozen	δωδεκάδα (f) (dodekáda)
dragonfly	λιβελλούλη (f) (livelúli)
draw	σχεδιάζω 
drawer	συρτάρι (n) (syrtári)
dream	ονειρεύομαι (oneirévomai)
dress	φουστάνι (n) (fustáni)
drink	οινοπνευματώδες ποτό (oinopnevmatódes potó); αλκοολούχο ποτό (alkooloúcho potó); ποτό (n) (potó)
dromedary	δρομάς (f) (dromás)
drop	σταγόνα (f) (stagóna)
drum	τύμπανο (n) (týmpano)
drunk	μεθυσμένος (m) (methysménos)
dry	στεγνός (m); (m) (xirós)
dubnium	ντούμπνιο (n) (vtoúmpnio)
duck	πάπια (f) (pápia); νήσσα (f) (níssa)
duke	δούκας (m) (doúkas)
dust	σκόνη (f) (skóni)
duty	καθήκον (n) (kathíkon)
dyslexia	δυσλεξία (f) (dyslexía)
dysprosium	δυσπρόσιο (n) (dysprósio)
e	ηλεκτρονικό ταχυδρομείο (n) (ilektronikó tachydromeío); ηλεκτρονικό μήνυμα (n) (ilektronikó mínyma)
e.g.	π.χ. (παραδείγματος χάριν)
each	έκαστος (ekastos) (s), κάθε (kathe), κάθε ένας (kathe enas), καθένας (kathenas)
eagle	αετός (m) (aetós); αϊτός (m) (aïtós)
eagle owl	μπούφος (m) (boúfos)
ear	αυτί (n) (afti)
early	νωρίς (noris)
earth	γη (f) (gí)
earthquake	σεισμός (m) (seismós); Εγκέλαδος (m) (Egkélados)
earthworm	γαιοσκώληκας
east	ανατολή (f) 
easy	εύκολος (éfkolos)
eat	τρώω (tróo); τρώγω (tróɣo); εσθίω (esthío)
echo	ηχώ (f) (ichó); αντήχηση (f) (antíchisi); αντίλαλος (m) (antílalos)
eco	οικο- (oikología or ikología)
ecology	οικολογία (f) (oikología)
economics	οικονομικά (n)
education	εκπαίδευση (f); παιδεία (f); αγωγή (f); διαπαιδαγώγηση (f); μόρφωση (f)
egg	ωάριο (n) (oário)
eight	οκτώ (októ)
eighteen	δεκαοκτώ (dekaoktó)
eighty	ογδόντα (ogdónda)
einsteinium	αϊνστάνιο (n) (aïnstánio)
ejaculation	εκσπερμάτιση (f) (ekspermátisi)
elbow	αγκώνας (m) 
electricity	ηλεκτρισμός (m) (ilektrismós)
electromagnetism	ηλεκτρομαγνητισμός (m) (ilektromagnitismos)
electron	ηλεκτρόνιο (n) (ilektrónio)
electronics	ηλεκτρονική
elephant	ελέφαντας (m) (eléfantas)
eleven	έντεκα (éndeka)
elf	ξωτικά (xotiká)
embassy	πρεσβεία (f) (presveía)
empty	άδειος (m) (áδios); κενός (m) (kenós)
encyclopedia	εγκυκλοπαίδεια (f) (egkyklopaídeia)
end	τέλος (n) (télos)
enemy	εχθρός (ekhthrós) (m)
enjoy your meal	καλή όρεξη (kalí órexi)
enter	μπαίνω (béno)
epithelium	επιθήλιο (n) (epithílio)
equation	εξίσωση (f) (exísosi)
erbium	έρβιο (érvio) (n)
erection	στύση (f) (stýsi)
ermine	ερμίνα (f) (ermína)
erotic	ερωτικός (erotikós)
etymology	ετυμολογία (f) (etymología)
euro	ευρώ (n) (evró)
europium	ευρώπιο (n) (evrópio)
euthanasia	ευθανασία (f) (evthanasía)
evening	εσπέρα (f) (espéra); βράδυ (n) (vrádhy); δειλινό (n) (dhilinó)
event horizon	ορίζοντας γεγονότων (m) (orizontas yegonoton)
every	κάθε (káthe)
everybody	όλοι (óloi); οι πάντες (í pántes)
everyone	κάθε ένας; άπαντες; οι πάντες 
everything	όλα (n); τα πάντα (n)
evil	κακός (m) (kakos); φαύλος (m) (favlos); πονηρός (m) (poniros)
example	παράδειγμα (parádeigma)
expensive	ακριβός (akrivós)
expression	έκφραση (f) (ékfrasi); ύφος (n) (ífos); μορφασμός (m) (morfasmós)
eye	μάτι (n) (máti)
eye for an eye, a tooth for a tooth	οφθαλμόν αντί οφθαλμού και οδόντα αντί οδόντος
eyebrow	φρύδι (n) (frýdi)
eyelash	βλεφαρίδα (f) (vlefaríða); ματόκλαδο (n) (matóklaðo)
eyelid	βλέφαρο (n) 
face	πρόσωπο (n) (prósopo)
factory	εργοστάσιο (n) (ergostásio)
fairy	νεράιδα (f) 
falcon	γεράκι (n) (geraki)
fall	πέφτω (péfto)
fallow deer	πλατώνι
family	οικογένεια (f) (oikogéneia)
far	μακριά 
farmer	αγρότης (m) (agrótis); αγρότισσα (f) (agrótissa); κτηνοτρόφος (m) (ktinotrófos)
fart	κλάνω (kláno)
fascism	φασισμός (m) (fasismós)
fast	νηστεία (f) (nistía)
fat	λιπαρός (m) (liparós); παχύς (m) (pachýs)
father	πεθερός (petherós)
fear	φοβάμαι (fovámai)
feather	φτερό (n) (fteró)
federation	ομοσπονδία (f) (omospondía)
female	θήλυ (n) (thíly); θηλυκό (n) (thilykó)
feminism	φεμινισμός (m) (feminismós)
fermium	φέρμιο (n) (férmio)
ferret	κουνάβι (n); νυφίτσα (f) (nyfítsa)
ferry	πορθμείο (n) (porthmeío)
fever	πυρετός (m) (pyretós)
fifteen	δεκαπέντε (dekapénte)
fifth	πέμπτος (m) (pémptos)
fifty	πενήντα (penínta)
fig	σύκο (syko) (n)
fight	πάλη (páli)
film	ταινία (f) (tainía)
finger	δάχτυλο (m) (dáchtylo)
fir	έλατο (n) (élato); έλατος (m)
fire	φωτιά (f) (fotiá)
first	πρώτος (m) (prótos)
fish	ψαρεύω (psarévo)
five	πέντε 
five hundred	πεντακόσια (pendakósia)
flag	σημαία (f) (simaía)
flame	φλόγα (f)
flea	ψύλλος (m) (psýllos)
floor	όροφος (m); (n)
flour	αλεύρι (n) (alévri)
flower	ανθώ [anˈθo̞], ανθίζω [anˈθizo̞], λουλουδίζω [luluˈðizo̞]
fluorine	φθόριο (n) (fthório)
flute	φλάουτο (n) (fláouto)
fly	πετώ (petó)
foam	αφρός (m) (afrós)
fog	ομίχλη (f)
food	τροφή (f) (trofí); φαγητό (n) (fagitó); φαΐ (n) (faḯ)
fool	ανόητος (m)
foot	αφθώδης πυρετός (m) (afthódis pyretós)
football	ποδόσφαιρο (n) (podósfairo)
for example	παραδείγματος χάριν
forefinger	δείκτης (m) (deíktis)
forehead	μέτωπο (n) (métopo)
foreign	αλλοεθνής (aloeθnís); αλλοδαπός (aloðapós); ξένος (ksénos)
foreigner	ξένος (m) (ksénos); αλλοδαπός (m) (alodapós)
forest	δάσος (n) (ðásos); δρυμός (m) (ðrimós)
fork	πηρούνι (n) (piroúni)
fortress	φρούριο (n) (froúrio)
forty	σαράντα (saránda)
four	τέσσερις (m); (n)
fourteen	δεκατέσσερις (m); δεκατέσσερα (n) (dekatéssera)
fourth	τέταρτος (tetartos)
fox	αλεπού (f) (alepoú)
francium	φράγκιο (n) (frágkio)
free	ελευθερώνω (eleftheróno)
freedom	ελευθερία (f) 
freedom of speech	ελευθερία έκφρασης (f) (elefthería ékfrasis)
friend	φίλος (m); (f)
friendship	φιλία (f) (filía)
frog	βάτραχος (m) (vátrachos)
from	από (apó)
fruit	καρπός (m) (karpós); οπώρα (f) (opóra); οπωρικό (n) (oporikó); φρούτο (n) (frúto)
fuck	συνουσιάζομαι (synousiázomai); γαμώ (gamó)
full	πλήρης (m); γεμάτος (m)
fungus	μύκητας (m) 
future	μέλλον (n) 
gadolinium	γαδολίνιο (n) (gadolínio)
galaxy	γαλαξίας (m) (galaxías)
gall bladder	χοληδόχος κύστη (f) (cholidóchos kýsti); χολή (f) (cholí)
gallium	γάλλιο (n) (gállio)
game	παιχνίδι (n) (paichnídi)
garbage	απορρίματα (n); σκουπίδια (n)
garden	περιβόλι (n) (perivóli); περβόλι (n) (pervóli); κήπος (m) (cípos)
gas	αέριο (n) (aério); ατμός (m) (atmós)
gasoline	βενζίνη (f) (venzíni)
genitive	γενική (f) (yenikí)
genocide	γενοκτονία (f) (genoktonía)
geography	γεωγραφία (f) (geografia)
geometry	γεωμετρία (f) (geometría)
germanium	γερμάνιο (n) (germánio)
geyser	θερμοπίδακας (thermopídakas)
ghost	φάντασμα (fántasma); φάσμα (n) (fásma); στοιχειό (n) (stoikheió); πνεύμα (n) (pnévma)
giant	γίγαντας (m) (gígantas)
gift	δώρο (n) (dóro); δωρεά (f) (doreá); χάρισμα (n) (chárisma)
ginger	πιπερόριζα (f) (piperóriza)
giraffe	καμηλοπάρδαλη (f) (kamilopárdali)
girl	κορίτσι (n) (korítsi)
give	δίνω (díno)
glacier	παγετώνας (m)
glass	ποτήρι (n) (potíri)
glove	γάντι (n) (gánti); χειρόκτιο (n) (cheiróktio)
glue	κολλα (kolla)
go	πάω (páo)
goalkeeper	τερματοφύλακας (m)
god	θεός (m) (theós); θεά (f) (theá)
gold	χρυσός (m) (chrysós)
golf	γκολφ (golf)
good	καλός (m) (kalós)
good afternoon	καλό απόγευμα (kaló apógevma)
good day	καλημέρα (kaliméra)
good evening	καλησπέρα (kalispéra); καλό βράδυ (kaló vrády)
good luck	καλή τύχη (kalí týchi!)
good morning	καλημέρα (kaliméra)
good night	καληνύχτα (kalinýchta); καλό βράδυ (kaló vrády)
goodbye	γεια (geia); αντίο (antío); εις το επανιδείν (eis to epanideín)
goods	αγαθά (n)
goose	χήνα (f) (chína)
goshawk	διπλοσάινο
government	κυβέρνηση (f) (kyvérnisi)
gram	γραμμάριο (n) (grammário)
grammar	γραμματική (f) (grammatikí)
grandchild	εγγόνι (n) 
granddaughter	εγγονή (f) 
grandfather	παππούς (m) (pappoús); πάππος (páppos)
grandmother	γιαγιά (yiayiá); μάμμη (mámmi)
grandson	εγγονός (m) 
grape	σταφύλι (n) (stafíli)
grasshopper	ακρίδα (f) (akrída)
graveyard	νεκροταφείο (n) (nekrotafeío); κοιμητήριο (n) (koimitírio)
great spotted woodpecker	παρδαλοτσικλιτάρα
great tit	καλόγερος
green	πράσινο (n) (prásino)
green tea	πράσινο τσάι
green woodpecker	πρασινοτσικλιτάρα, πρασινοτσικλιτήρα ' '
grey	γκρι (gri) (n), σταχτί (stakhtí) (n), φαιό (feó) (n)
grey heron	σταχτοτσικνιάς (m) (stachtotsikniás)
greylag goose	χήνα
griffon vulture	όρνιο (órnio)
guilt	ενοχή (enochē)
guinea fowl	φραγκόκοτα (f)
guinea pig	(ινδικό χοιρίδιο (f) (indikó choirídio)
guitar	κιθάρα (f) (kithára)
gull	γλάρος (m) (gláros)
gunpowder	μπαρούτι
gypsy	τσιγγάνος (m) (tsingános); αθίγγανος (m) (athínganos)
hafnium	άφνιο (n) (áfnio)
hail	χαλάζι (n) (chalázi)
hair	τρίχες (f)
half	μισό (n) (misó)
hammer	σφυρί (n) (sfyrí)
hamster	χάμστερ (n) (chámster)
hand	χέρι (n) (chéri)
happen	συμβαίνω (simvéno); τυχαίνω (tiçéno); λαχαίνω (laçéno); τυγχάνω (tiŋxáno); διαδραματίζομαι (ðiaðramatízome); σημειώνομαι (simiónome)
happiness	ευτυχία (f) (eftychía)
happy	ευτυχής (eftikhis) (m), ευτυχισμένος (eftikhismenos) (m)
happy birthday	χαρούμενα γενέθλια (charoúmena genéthlia)
hard	δύσκολος (m) (dýskolos)
hard drive	σκληρός δίσκος (m) (sklerós dískos)
hare	λαγός (m) (lagós)
hat	καπέλο (n) (kapélo); πίλος (m) (pílos)
hate	μίσος (mísos) (n), απέχθεια (apékhthia) (f)
hatred	μίσος (n) (mísos); έχθρα (f) (ékhthra)
have	έχω (ekhō)
hawk	γεράκι (n)
hay	άχυρο (n) (áchyro); σανός (m) (sanós)
hazelnut	φουντούκι (n) 
he	αυτός (m) (avtós)
head	κεφάλι (n) (kefáli)
health	υγεία (f) (iía)
hear	ακούω
heart	καρδιά (f) (karðiá); κούπα (f) (koúpa)
heaven	ουρανός (m) (uranós); ουράνια (n)
heavy	βαρύς (m) 
hedgehog	σκαντζόχοιρος (m) (skantzóchoiros)
heel	φτέρνα (f)
helicopter	ελικόπτερο (n) (elikóptero)
helium	ήλιο (n) (ílio)
hell	Κόλαση (f) (Kólasi)
hello	εμπρός (emprós)
help	βοήθεια! (voíthia)
hemp	κάνναβη (f) (kánavi)
hen	κότα (kóta) (f), όρνιθα (órnitha) (f)
her	της (tis) (f)
here	εδώ (eðó)
hero	ήρωας (m) (íroas); ηρωίδα (f) (iroída)
heron	ερωδιός (erodiós); αρδέα (ardea); τσικνιάς (tsiknias)
hi	γεια (geia)
hill	λόφος (m) (lófos); ύψωμα (n) (ýpsoma)
hippopotamus	ιπποπόταμος (hippopotamos, ippopotamos)
his	του (m) (tou)
history	ιστορικό (n) (istorικό)
holmium	όλμιο (n) (ólmio)
home	σπίτι (n) (spíti); σπιτικό (n) (spitikó)
homophobia	ομοφοβία (f) (omofovía)
homosexuality	ομοφυλοφιλία (f) (omofilofilía)
honey	μέλι (n) (méli)
hoof	οπλή (f) (oplí)
hope	ελπίδα (f)
horn	,
hornet	βόμβος (m) (vómvos); αγριομέλισσα (f) (ágriomélisa)
hospital	νοσοκομείο (n) (nosokomío)
hot	ζεστός (m); (thermós)
hotel	ξενοδοχείο (n) (xenodohío)
hour	ώρα (f) (óra)
house	σπίτι (n) (spíti); οίκος (m); οικία (f); κατοικία (f); σπιτικό (n)
how	πόσο 
how are you	τι κάνεις; (ti káneis?); τι κάνετε; (ti kánete?); πως είσαι; (pos eísai?); πως είστε; (pos eíste?)
how much does it cost	πόσο κάνει (póso kánei?); πόσο κοστίζει (póso kostízei?)
how old are you	πόσο χρονών είσαι (póso chronón eísai?); πόσο χρονών είσαστε (póso chronón eísaste?)
human	άνθρωπος (m) (ánthropos)
human being	άνθρωπος (m); (n)
hundred	εκατό (ekató); εκατόν (ekatón)
hungry	πεινασμένος (m)
hunt	κυνηγώ (kynigó); θηρεύω (thirévo)
hurricane	ανεμοστρόβιλος (m) (anemostróstrovilos); κυκλώνας (m) (kyklónas)
husband	σύζυγος (m) (sýzygos); άνδρας (m) (ándras)
hydrate	ένυδρο άλας (énydro álas); υδρίτης (m) (ydrítis)
hydrogen	υδρογόνο (n) (ydrogóno)
hyena	ύαινα (f) (íena)
ibex	αίγαγρος (m) (aígagros)
ice	πάγος (m) (págos)
ice cream	παγωτό (n) (pagotó)
iceberg	παγόβουνο (n) (pagóvouno)
idea	ιδέα (f)
idiot	ηλίθιος (m) (ilíthios)
ill	άρρωστος (m) (árrōstos); άρρωστη (f) (árrōstē)
illness	ασθένεια [aˈsθe̞niˌa] (f), αρρώστια [aˈro̞stça] (f), νόσος [ˈno̞so̞s] (f), νόσημα [ˈno̞siˌma] (n), πάθηση [ˈpaθiˌsi] (f)
index	κατάλογος (m) (katálogos); ευρετήριο (n) (evretírio)
indium	ίνδιο (n) (índio)
information	πληροφορία (f) (plērophoría); πληροφορίες (f)
injury	ζημία '(zēmía)' (f)
ink	μελάνι (meláni)
insanity	παραφροσύνη (paraphrosýnē)
insect	έντομο (n) (éntomo)
insulin	ινσουλίνη (f)
intelligence	νοημοσύνη (f) (noimosýni); ευφυΐα (f) (effyḯa); εξυπνάδα (f) (exypnáda)
interesting	ενδιαφέρων
international	διεθνής (m) (diethnis)
interpreter	διερμηνέας (dierminéas)
iodine	ιώδιο (n) (iódio)
iridium	ιρίδιο (n) (irídio)
iron	σιδερώνω (sideróno)
is	είναι (eínai)
it	το; αυτό 
jackdaw	κάργια (kárgia)
jay	κίσσα (f)
jellyfish	τσούχτρα (f) (tsúchtra); μέδουσα (f) (médusa)
journalism	δημοσιογραφία (f) (dimosiografía)
journey	ταξίδι (n) (taxidi)
joy	ευφορία (f); αγαλλίαση (f); χαρά (f) (khará)
juice	χυμός (m)
juniper	γιουνίπερος (m) (giouníperos)
kangaroo	καγκουρό (n) (kangouró)
kestrel	κιρκινέζι (n) (kirkινéζι)
ketchup	κέτσαπ
key	κλειδί (n) (kleidí)
keyboard	πληκτρολόγιο (n) 
kidney	νεφρό (n) (nefró); νεφρός (m) (nefrós); νεφρί (n) (nefrí)
kill	σκοτώνω (skotóno); θανατώνω (thanatóno); φονεύω (fonévo)
kilometre	χιλιόμετρο (n) (çiliómetro)
king	ρήγας (rigas)
kingdom	βασίλειο (n) (vasíleio)
kiss	φιλώ (filó); ασπάζομαι (aspazome); δίνω φιλί (dino fili)
kitchen	κουζίνα (f) (kouzína); μαγειρείο (n) (mageireío)
kite	χαρταετός (m) (chartaetós)
knee	γόνατο (n) (gónato)
knife	μαχαίρι (n) (machaíri)
knight	ιππότης (m) 
know	γνωρίζω 
krypton	κρυπτό (n) (kryptó)
ladybird	πασχαλίτσα (paschalítsa)
ladybug	πασχαλίτσα (paskhalítsa) (f)
lake	λίμνη (f) (límni)
lamb	αρνί (n) (arní); αμνός (m) (amnós)
land	ξηρά (ksirá) (dry-land) (f), γη (yi) (f)
language	γλώσσα προγραμματισμού (f) (glossa programatismou); κώδικας (m) (kodikas)
lanthanum	λανθάνιο (n) (lanthánio)
larch	λάρικας (larikas)
large	(f) (megáli̱)
lark	σταρήθρα
laser	λέιζερ (léizer)
last	τελευταίος
last year	πέρυσι (n) 
lava	λάβα (f) (láva)
lawrencium	λωρένσιο (n) (lorénsio)
lawyer	δικηγόρος (m)
lead	μόλυβδος (m) (mólyvdos)
learn	μαθαίνω
least weasel	νυφίτσα ' '
leather	δέρμα (n) (dérma)
leech	βδέλλα (f) (vdélla)
leek	πράσο (n) (práso)
leg	πόδι (n) (pódi)
lemon	λεμόνι (n) (lemóni)
length	μήκος
leopard	λεοπάρδαλη (f) (leopárdali)
lesbian	λεσβία (f) (lesvía)
lesser spotted woodpecker	νανοτσικλιτάρα
lesson	μάθημα (n) (máthima)
letter	επιστολή (f) (epistolí); γράμμα (n) (grámma)
lettuce	μαρούλι (n) (maroúli)
liar	ψεύτης (m); ψεύτρα (f)
library	βιβλιοθήκη (f) (vivliothíki)
lick	γλείφω 
lie	ψεύδομαι (pseúdomai)
life	ζωή (f) (zoí)
light	φωτίζω
light year	έτος φωτός (n) (étos fotós)
lighthouse	φάρος (m) 
lightning	αστραπή (f) (astrapí)
like	σαν (san)
lily	κρίνο (kríno)
linguistics	γλωσσολογία (f)
lion	λιοντάρι (n) (liontári)
lip	χείλος (n) (kheílos); χείλι (n) (kheíli)
listen	ακούω (akoúo)
literature	λογοτεχνία (f) (logotechnía)
lithium	λίθιο (n) (líthio)
litre	λίτρο (n) (lítro)
little	μικρός (mikrós); λίγος (lígos)
little finger	μικρός (m) (mikrós)
little owl	κουκουβάγια (koukouvágia) (f)
live	διαμένω (diaméno), κατοικώ (katikó), μένω (méno), ζω (zo)
liver	ήπαρ (n) (ípar); (m) (ipatikos)
lizard	σαύρα (f) (sávra)
lobster	αστακός (m) (astakós)
long	νανόμπουφος
look for	ψάχνω (psáchno)
louse	ψείρα (f) (pseíra)
love	αγάπη (f) (agápi); έρωτας (m) (érotas)
lukewarm	χλιαρός (m) (chliarós)
lung	πνεύμονας (m) (pnévmonas)
lute	λαούτο (n) (laúto); λαγούτο (n) (lagúto)
lutetium	λουτέτσιο (n) (loutétsio)
lynx	λύγκας (m)
machine language	γλώσσα μηχανής (f) (glóssa michanís); κώδικας μηχανής (m) (kódikas michanís)
mackerel	σκουμπρί (n) (skoumprí)
mad	τρελός (m), παράφρονας (m), φρενοβλαβής (m), μανιακός (m)
magma	μάγμα (n) (mágma)
magnesium	μαγνήσιο (n) (magnísio)
magpie	καρακάξα (karakáksa) (f), κίσσα (kisa) (f)
maize	καλαμπόκι (n) (kalamoóki)
mallard	αγριόπαπια (f) (agriópapia)
mammal	θηλαστικό (n) (thilastikó); μαστοφόρο (n) (mastofóro)
man	άνθρωπος (m) (ánθropos)
manganese	μαγγάνιο (n) (mangánio)
mango	μάνγκο (n) (mángko)
many	πολλοί (m)
map	χάρτης (xártis) (m), άτλαντας (átla[n]das) (m), άτλας (átlas) (m)
maple	σφενδάμι (sfendámi)
mare	φοράδα (f) (foráda)
marijuana	μαριχουάνα (f) (marichouána)
market	αγορά (f) 
marmot	μαρμότα (f) (marmóta)
marten	δενδροκούναβο (dendrokúnavo)
masturbation	αυνανισμός; μαλακία
match	σπίρτο (n) (spírto)
maternal grandfather	παππούς (papús)
mathematics	μαθηματικά (n)
mattress	στρώμα (n) (stróma)
maybe	ίσως (isos)
mayor	δήμαρχος (dímarkhos) (m)
me	με (me); εμένα (eména)
meal	γεύμα (n) (gévma); φαγητό (n) (fagitó)
meat	κρέας (n) (kréas)
medicine	ιατρική (f) (iatriki)
melon	πεπόνι (n) (pepóni)
memory	μνήμη (f) (mními)
mendelevium	μεντελέβιο (n) (mentelévio)
mercury	υδράργυρος (m) (ydrárgyros)
microscope	μικροσκόπιο (n)
middle finger	μέσος (m) (mésos)
midnight	μεσονύκτιο (n) (mesonýktio); μεσάνυχτα (n)
midwife	μαία (f) (maía); μαμμή (f) (mammí)
milk	αρμέγω (armégo)
milliard	δισεκατομμύριο (disekatommýrio) (n)
million	εκατομμύριο (n) (ekatommírio)
millipede	σαρανταποδαρούσα (sarantapodarooúsa)
mind	νους (nus) (m), διάνοια (ðiánia) (f), μυαλό (myaló) (n)
mine	δικός μου; δικό μου; δική μου; δικοί μου; δικά μου; δικές μου
mineralogy	ορυκτολογία (f) (oryktología)
mint	μέντα (f) (ménta)
minute	λεπτό (n) (leptó)
mirror	καθρέφτης (m) (kathréftis)
moat	τάφρος (f) (táfros)
mobile phone	κινητό τηλέφωνο (kinétó téléfono); κινητό (kinétó)
mole	τυφλοπόντικας (m) (tyflopóntikas); ασπάλακας (m) (aspálakas)
molecule	μόριο (n) (mório)
molybdenum	μολυβδένιο (n) (molyvdénio)
moment	στιγμή (f) 
monarchy	μοναρχία (f) (monarchía)
monastery	μοναστήρι (n) (monastíri); μονή (f) (moní)
money	χρήματα (n); χρήμα (n); λεφτά (n)
monk	μοναχός (m) (monachós); καλόγερος (m) (kalógeros)
monkey	πίθηκος (m) (píthikos); μαϊμού (f) (maimu)
month	μήνας (m) (mínas)
moon	σεληνιακός μήνας (m) (seliniakós mínas); φεγγάρι (n) (fengári)
morning	πρωί (n) (proí); πρωινό (n) (projnò)
mosque	τέμενος (n) (témenos); τζαμί (n) (tzamí)
moss	βρύο (n) (brýo)
moth	νυχτοπεταλούδα (f) (nikhtopetaloúδa)
mother	πεθερά (f)
mother tongue	μητρική γλώσσα (f) (mitriki glossa)
motorcycle	μηχανή (mikhaní) (f), δίκυκλο (ðíkiklo) (n) μοτοσικλέτα (motosikléta) (f)
mouflon	μουφλόν (mouflón)
mountain	όρος (n) (óros); βουνό (n) (vunó)
mouse	ποντίκι (n) (pontíki)
moustache	μουστάκι (n)
mouth	στόμα (n) (stóma)
movie	ταινία (f) (tenía); (n) (érɣo) (n) (film)
mud	λάσπη (laspi) (f), πηλός (pilos) (m), βόρβορος (vorvoros) (m), γύψος (gypsos) (m)
mule	μουλάρι (n) (moulári)
murder	φόνος (m) (fónos); δολοφονία (f) (dolofonía); ανθρωποκτονία (f) (anthropoktonía)
muscle	μυς (m) (mys)
museum	μουσείο (n) (mouseío)
mushroom	μανιτάρι (n) (manitári)
music	μουσική (f) (musicí)
musical instrument	μουσικό όργανο (musikó órgano) (n)
musician	μουσικός (m)
muskrat	μοσχοπόντικας
mustard	μουστάρδα (f) (moustárda)
my	μού (mou)
my name is	το όνομα μου είναι... (to ónoma mou einai)
mysterious	μυστήριος (mystērios)
mystery	μυστήριο (n) (mistírio)
mythology	μυθολογία (f) (mithología)
nail	καρφί (n) (karfí)
naked	γυμνός (gymnós)
name	όνομα (n) (ónoma)
narrow	στενός (m) (stenós)
nation	έθνος (n) (éthnos)
nationalism	εθνικισμός (m) (ethnikismós)
nature	φύση (f) (:el:Φύση'el)
navel	ομφαλός (m) (omfalós); αφαλός (m) (afalós)
nebula	νεφέλωμα (n) (neféloma)
neck	λαιμός (m) (laimós)
necklace	κολιέ (n) (kolié)
need	χρειάζομαι (khriázome)
needle	βελόνα (f) (velóna)
neighbour	γείτονας (m) (geítonas); γειτόνισσα (f) (geitónissa)
neodymium	νεοδύμιο (n) (neodýmio)
neon	νέον (n) (néon)
nephew	ανιψιός (m) (anipsiós)
neptunium	ποσειδώνιο (n) (poseidónio)
nest	φωλιά (f)
nettle	τσουκνίδα (f) (tsuknída)
neutrino	νετρίνο (n) (netrino)
never	ποτέ
new	νέος (neos) (m), καινούργιος (kenuryios) (m)
news	ειδήσεις; νέα
newspaper	εφημερίδα (f) (efimerída)
nickel	νικέλιο (n) (nikélio)
niece	ανεψιά (f) (anepsiá)
night	νύχτα (f) (nýchta)
nightingale	αηδόνι (n) (aidóni)
nightmare	εφιάλτης (m) (efiáltis)
nine	εννέα (ennéa); εννιά (enniá)
nineteen	δεκαεννέα (dekaennéa); δεκαεννιά (dekaenniá)
ninety	ενενήντα (enenínda)
ninth	ένατος 
niobium	νιόβιο (n) (nióvio)
nipple	ρώγα (f) (roga); (f) (thilí)
nitrogen	άζωτο (n) (ázoto)
no	όχι (óchi)
no smoking	απαγορεύεται το κάπνισμα (apagorévetai to kápnisma)
nobelium	νομπέλιο (n) (nompélio)
nobody	κανένας (kanenas)
nominative case	ονομαστική (f) 
non	μη κυβερνητικές οργανώσεις
noon	μεσημέρι (n) (mesiméri)
north	βορράς (vorrás)
nose	μύτη (f) (míti)
not	δεν (den); δε (de); μη (mi)
notebook	σημειωματάριο (n) 
nothing	τίποτε (n) (tipote); τίποτα (n) (tipota)
noun	ουσιαστικό (n) (ousiastikó)
now	τώρα
nude	γυμνός (m) 
number	αριθμός (m) (arithmós); πλήθος (n) (plíthos)
nurse	νοσοκόμα (f) (nosokoma); νοσοκόμος (m) (nosokomos); νοσηλεύτρια (f) (nosileftria); νοσηλευτής (m) (nosileftis)
oak tree	δρυς (f) (drys); βελανιδιά (f) (velanidiá)
oar	κουπί (n) (koupí)
obedience	υπακοή (ypakoí)
obesity	παχυσαρκία (f)
oboe	όμποε (m) (óboe); οξύαυλος (m) (oxíavlos)
ocean	ωκεανός (m) (okeanós)
octopus	χταπόδι (n) (chtapódi)
of course	βέβαια (vévaia); φυσικά (fisiká)
office	γραφείο (n) (grafío)
often	συχνά (sikhná)
oil	πετρέλαιο (n) (petrélaio)
old	γηραιός (m); (m)
olive	ελιά (f) (eliá)
omelette	ομελέτα (omeléta)
on	πάνω; σε
once upon a time	μια φορά κι έναν καιρό 
one	ένας (m) (énas); μια (f) (mia); ένα (n) (éna)
onion	κρεμμύδι (n) (kremmýdi)
open	ανοιχτός (anoichtós)
operating system	λειτουργικό σύστημα (n) (litourgikó sístima)
opinion	γνώμη (f); άποψη (f)
or	ή (í); είτε (eíte)
orange	πορτοκαλιά (f) (portokaliá)
organism	οργανισμός (m) (organismós)
orgasm	οργασμός (m) (orgazmós)
orphan	ορφανός (m) (orfanós); πεντάρφανος (m) (pentárfanos)
osmium	όσμιο (n) (ósmio)
ostrich	στρουθοκάμηλος (struthokamilos)
other	άλλος (állos)
otter	βίδρα (f) (vídra)
our	μας
ovary	ωοθήκη (f) (oothíki)
owl	γλαύκα (f) (gláfka); κουκουβάγια (f) (kukuváya)
oxygen	οξυγόνο (n) (oxygóno)
page	σελίδα (selíδa)
pain	πόνος (m) (pónos); άλγος (n) (álgos)
paint	βαφή (f); χρώμα (n)
painter	ζωγράφος (m)
palace	παλάτι (paláti)
palladium	παλλάδιο (n) (palládio)
palm	παλάμη (f) (palámi)
pancreas	πάγκρεας (n) (págkreas)
paper	χαρτί (n) (chartí)
paradox	παραδοξολογία (f)
park	πάρκο (n) (párko)
parliament	βουλή (f) (voulí); κοινοβούλιο (n) (koinovoúlio)
parrot	παπαγάλος (m) 
part	μέρος (n) (méros)
partridge	πέρδικα (f) (pérdika)
passport	διαβατήριο (diavatírio)
password	κωδικός (m) (kodikós); συνθηματικό (n) (synthimatikó)
paternal aunt	θεία (theía) (f); θεια (theia) & θείτσα (theítsa) (affectionate terms but also pejoratives) (f)
paternal grandfather	παππούς (papús)
pawn	πιόνι (n) (pióni); στρατιώτης (m) (stratiótis)
peach	ροδάκινο (n) (rodákino)
peacock	παγώνι
peanut	φυστίκι (n) (fistíki)
pear	αχλαδιά (akhlaðyá) (f), απιδιά (apiðyá) (f), αχλάδα (akhláða) (f) ('folk and poetic'), απιδέα (apiðéa) (f) (obsolete)
pen	στυλό (n) (styló)
pencil	μολύβι (n) (molývi)
penguin	πιγκουίνος (m) (pigkouínos)
penicillin	πενικιλίνη (f) (penikilíni)
peninsula	χερσόνησος (f) (khersónisos)
people	λαός (m) (laós); κόσμος (m) (kósmos); έθνος (n) (éthnos)
pepper	πιπέρι (n) (pipéri)
percent	τοις εκατό (tois ekató)
peregrine falcon	πετρίτης (m) (petritis)
perestroika	περεστρόικα (perestróika)
perineum	περίνεο (n) (perineo)
person	άνθρωπος (m); (n)
petrol	βενζίνη (f) (venzíni)
petroleum	πετρέλαιο (petréleo)
pharaoh	Φαραώ (m) (Faraó)
pharmacy	φαρμακείο (n) (farmakeío)
pheasant	φασιανόs (phasianós)
philosopher	φιλόσοφος (m)
philosophy	φιλοσοφία (f) (philosophia)
phoenix	φοίνικας (m) (foínikas)
phone	τηλέφωνο (n) (tiléfono)
phosphorus	φώσφορος (m) (fόsforos)
photograph	φωτογραφία (f) (fotografía)
photography	φωτογραφία (f) 
photosynthesis	φωτοσύνθεση (f) (fotosýnthesi)
physics	φυσική (f) (fysikí)
piano	πιάνο (n) (piáno); κλειδοκύμβαλο (n) (kleidokýmvalo)
picture	εικόνα (f) (ikóna); θέαμα (n) (θéama); οπτική παράσταση (f) (optikí parástasi)
pie	πίτα (f) (píta)
piece	κομμάτι (n) 
pig	γουρούνι (n) (gouroúni); χοίρος (m) (choíros)
pigeon	περιστέρι (n) (peristéri)
piglet	γουρουνόπουλο (n) (gourounópoulo)
pillow	μαξιλάρι (n) (maxilári)
pimple	σπυρί (n) (spyri); σπυράκι (n) (spyráki)
pin	καρφίτσα (f) (karfitsa)
pineapple	ανανάς (ananás)
pink	ροζ (inv)
pirate	πειρατής (m) ('piratis')
pizza	πίτσα (f) (pitsa)
place	τόπος (tópos); θέση (théssi); περιοχή (periochí); τοποθεσία (topothessía); μέρος (méros); σημείο (semeío); χώρος (chóros)
planet	πλανήτης (m) (planítis)
plant	φυτό; φυτά
plate	πιάτο (n) (piáto)
platinum	πλατίνα (m) (platina); λευκόχρυσος (m) (lefkóchrysos)
platypus	πλατύπους (platypous)
play	παίζω (pézo)
please	παρακαλώ (parakaló)
pleasure	ευχαρίστηση (eucharístēsē) (f), απόλαυση (apolafsē) (f), τέρψη (terpse) (f), ηδονή (hedoné) (f)
plough	αλέτρι (n) (alétri); άροτρο (n) (árotro)
plum	δαμασκηνιά (f) 
plutonium	πλουτώνιο (n) (ploutónio)
pocket	βαλάντιο (n) (valádio, valándio); τσέπη (f) (tsépi); θυλάκιο (n) (thilácio)
poem	ποίημα (n) (poíima)
poetry	ποίηση (f) (pí'isi)
poison	δηλητήριο (n) (dilitírio); φαρμάκι (n) (farmáki)
polar bear	πολική αρκούδα (f)
polecat	οζοϊκτίς; βρωμοκούναβο
police	αστυνομία (f) (astynomía)
policeman	αστυφύλακας (m); (m) (astinomikós)
polite	ευγενικός (evyenikós)
politician	πολιτικός (politikós)
politics	πολιτική (f) (politikí)
polonium	πολώνιο (n) (polónio)
polygon	πολύγωνο (n) (polýgono)
pomegranate	ρόδι (n) (ródi)
poor	φτωχός (ftokhós) (m)
pope	πάπας (m) 
pornography	πορνογραφία (f) (pornografía)
port	λιμάνι (n) (limáni); λιμένας (m) (liménas)
post office	ταχυδρομείο (n) (tachydromeío)
postage stamp	γραμματόσημο (n) (grammatósimo)
postcard	κάρτα (kárta)
postcode	ταχυδρομικός κώδικας (m) (tachydromikós kódikas); ΤΚ (TK)
postmodernism	μεταμοντερνισμός (m) (metamodernismós)
potassium	κάλιο (n) (kálio)
pound	λίβρα (f); μνα (f) (mnah)
power	δύναμη (dinami) (f), ισχύς (iskhis) (f), κράτος (kratos) (n)
praseodymium	πρασεοδύμιο (n) (praseodýmio)
prayer	προσευχή (f) (proseuchí)
pregnancy	εγκυμοσύνη (f) (egkymosýni); κύηση (f) (kýisi); κυοφορία (f) (kyoforía)
pregnant	έγκυος (f) (égkyos)
preposition	πρόθεση (f) 
prepuce	ακροποσθία (f)
president	πρόεδρος (m)
pretty	ωραίος (m) (oréos); όμορφος (m) (ómorfos); χαριτωμένος (m) (kharitoménos); ελκυστικός (m) (elkistikós)
price	τιμή (f) (timí); αξία (f) (aksía)
priest	ιερέας (ieréas) (m), ιερωμένος (ieroménos) (m), κληρικός (klirikós) (m), παπάς (papás) (m), εφημέριος (efimérios) (Greek-Orthodox) (m), πρεσβύτερος (prezvíteros) (Anglican) (m), πρωτοπρεσβύτερος (protoprezvíteros) (Roman-Catholic) (m)
prime minister	πρωθυπουργός (m) (prothypourgós)
prime number	πρώτος αριθμός (m) 
prison	φυλακή (f) (fylaki); δεσμωτήριο (n) (ðesmotírio)
problem	πρόβλημα (n) (próvlima)
profession	επάγγελμα (n) (epángelma)
programming language	γλώσσα προγραμματισμού (m) (glossa programmatismou)
promethium	προμήθιο (n) (promíthio)
pronoun	αντωνυμία (f) 
pronunciation	προφορά (proforá)
property	ιδιοκτησία (f) 
prophet	προφήτης (m) (profítis)
prostitute	πόρνη (f) (pórni); πόρνος (m) (pórnos); πουτάνα (f) (poutána)
protactinium	πρωτακτίνιο (n) (protaktínio)
protect	προστατεύω (prostatévo)
proton	πρωτόνιο (n) (protónio)
proverb	παροιμία (f)
pumpkin	κολοκύθα (kοlοkútha)
puppy	κουτάβι (n) (koutávi)
purgatory	καθαρτήριο (kathartério)
purple	μωβ (mov), ιώδες (iódhes), ιόχρουν (iókhrun), βιολετί (vyoletí), μαβί (maví), μενεξεδί (menexedhí), πορφυρό (porfiró)
pussy	μουνί (n); μουνάκι (n)
pyramid	πυραμίς (f) (piramís); πυραμίδα (f) (piramíða)
quarter	τέταρτο (n) (tétarto); τεταρτημόριο (n) (tetartimório)
queen	βασίλισσα (f) 
question	ερώτηση (f) (erótisi)
quotation marks	εισαγωγικά (n) 
rabbit	κουνέλι (n) (kounéli)
radio	ραδιόφωνο (n) (radiófono); ράδιο (n) (rádio)
radon	ραδόνιο (n) (radónio)
railway	σιδηρόδρομος (m) 
rain	βρέχω 
rainbow	ουράνιο τόξο (n) (ouránio tóxo)
rake	τσουγκράνα (f) (tsougkrána)
ram	κριάρι (n) (kriári); κριός (m) (kriós)
rape	βιασμός (m) (viasmόs)
raspberry	σμέουρο (zméouro) (n), βατόμουρο (vatómouro) (n)
rat	αρουραίος (aruréos)
read	διαβάζω 
recent	πρόσφατος (prósphatos)
recipe	συνταγή (f) (syntagí)
rectangle	ορθογώνιο παραλληλόγραμμο
red	κόκκινο (n) (kókkino); ερυθρό (n) (erythró); πορφυρό (n) (porfyró); άλικο (n) (áliko)
red deer	ελάφι (n) (eláfi)
refrigerator	ψυγείο (n)
reindeer	τάρανδος (m) (táranðos)
relative	συγγενής (m); οικείος (m) (oikeíos)
religion	θρησκεία (f) (thriskeía)
remember	θυμάμαι (thymámai)
restaurant	εστιατόριο (n) (estiatório)
revenge	εκδίκηση (f) (ekdíkisi)
revolution	επανάσταση (f) (epanástasi)
rhenium	ρήνιο (n) (rínio)
rhinoceros	ρινόκερος (m) (rinókeros); ρινόκερως (m) (rinókeros); ριονκερώντος (m) (rionkeróntos)
rhodium	ρόδιο (n) (ródio)
rice	όρυζα (oríza) (f)
rich	πλούσιος (m) (ploúsios); εύπορος (m) (éfporos)
rifle	τυφέκιον (n) (tifékion); τουφέκι (n) (toufeki)
ring	δαχτυλίδι (n) (dactylídi)
ring finger	παράμεσος (m) (parámesos)
river	ποτάμι (n) (potámi)
road	οδός (f) (odós); δρόμος (m) (drómos)
robin	κοκκινολαίμης (m) (kokkinolaímis)
robot	ρομπότ (m) (rompót)
rock dove	αγριοπερίστερο (n)
rodent	τρωκτικό (n) (troktikó)
roe deer	ζαρκάδι (n) (zarkádi)
rook	πύργος (m) 
room	χώρος (m) (chóros)
root	ρίζα (f) 
rope	σκοινί (n) 
rose	τριαντάφυλλο (n) (triantáfyllo); ρόδο (n) (ródo)
rubidium	ρουβίδιο (n) (rouvídio)
ruble	ρούβλι (n) (roúvli)
run	τρέχω (trékho)
ruthenium	ρουθήνιο (n) (routhínio)
rutherfordium	ραδερφόρντιο (n) (raderfórntio)
rye	σίκαλη (f) (síkali)
salary	μισθός (m) (misthós)
saliva	σίελος (m) (síelos); σάλιο (n) (sálio)
salt	αλάτι (n) (aláti)
samarium	σαμάριο (n) (samário)
same	ίδιος (ídios)
sand	άμμος (f) (ámmos)
sandwich	σάντουιτς (n) (sántouits)
sauce	σάλτσα (f) (sáltsa)
sausage	σαλάμι (n) (salámi)
saw	πριόνι (n) (prióni)
scandium	σκάνdιο (n) (skándio)
scar	ουλή (f) (oulí)
scarlet	κόκκινος (m) (kókkinos)
schizophrenia	σχιζοφρένεια (f) (schizofrenia)
school	σχολή (f) (scholí)
science	επιστήμη (f)
scissors	ψαλίδι (n)
scorpion	σκορπιός (m) (skorpiós)
scrotum	όσχεο
sea	θάλασσα (f) (thálassa); πέλαγος (n) (pélagos)
seaborgium	σιμπόργκιο (n) (simpórgkio)
seagull	γλάρος (m) (gláros)
seal	φώκια (f) (fókia)
season	εποχή (epokhí) (f)
second	δεύτερος (m) (défteros)
secret	κρυφός (m) (krifos); μυστικός (m) (mistikos)
sect	αίρεση (f) (aíresi)
see	βλέπω (vlépo); αντικρίζω (antikrízo); (thoró)
seed	σπόρος (m)
selenium	σελήνιο (n) (selínio)
semen	σπέρμα (n)
service	υπηρεσία (f) (ipiresía)
seven	επτά (eptá)
seventeen	δεκαεπτά (dekaeptá)
seventy	εβδομήντα (evdomínta)
sex	φύλο (n) (fýlo)
shadow	σκιά (skiá) (f), ίσκιος (ískios) (m)
shame	ντροπή (dropí) (f)
she	αυτή (aftí)
sheep	πρόβατο (n) (próvato)
shepherd	βοσκός (m) (voskós)
shield	ασπίδα (f)
ship	πλοίο (n) (ploío); καράβι (n) (karávi); ναυς (f) (nafs); σκάφος (n) (skáfos)
shirt	πουκάμισο (n) (poukámiso); υποκάμισο (n) (ypokámiso)
shit	σκατό (n) (skató); σκατά (skatá)
shoe	παπούτσι (n) (papoútsi); υπόδημα (n) (ypódīma)
shop	μαγαζί (n) (magazí)
shoulder	ώμος (m) (ómos)
shrew	νανομυγαλίδα (nanomigalída)
sick	άρρωστος (m) (árrōstos); ασθενής (m) (asthenḗs)
sickle	δρεπάνι (n) (drepáni)
silence	σιωπή (f); σιγή (f)
silicon	πυρίτιο (n) (pyrítio)
silk	μέταξα (f) (métaxa); μετάξι (n) (metáxi)
silver	ασήμι (n) (asími)
sin	αμαρτία (f) (amartía); αμάρτημα (n) (amártima)
sing	τραγουδάω; τραγουδώ; άδω; ψέλνω 
sister	αδελφή (f) (adelfí)
six	έξι (éksi)
sixteen	δεκαέξι (dekaéxi)
sixth	έκτος (ektos)
sixty	εξήντα (exínda)
skeleton	σκελετός (m) (skeletós)
skin	δέρμα (n) (dérma)
skirt	φούστα (f) (fusta)
skull	κρανίο (n) (kranío)
sky	ουρανός (m) (ouranós)
skylark	σταρήθρα (f)
skyscraper	ουρανοξύστης (m) (uranoxístis)
slave	δούλος (m) (doúlos)
sleep	κοιμάμαι (koimámai)
slow	αργός (m) (argós); βραδύς (m) (vradís)
small	μικρός (mikrós)
smell	μυρωδιά (f)
smile	χαμογελώ (chamogeló)
smoke	καπνίζω (kapnízo)
snail	σαλιγκάρι (n) (saligkári)
sneeze	πταρνίζομαι (ptarnízomai)
snooker	σνούκερ (m) (snúker)
snow leopard	ίρβις (f) (írvis)
snowflake	νιφάδα (f) (nipháda)
soccer	ποδόσφαιρο (n) (podósfairo)
socialism	σοσιαλισμός (m) (sosialismós)
sock	κάλτσα (f) (káltsa); περιπόδιο (n) (peripódio)
sodium	νάτριο (n) (nátrio)
sofa	καναπές (m) (kanapés)
software	λογισμικό (n) (logismikó)
soldier	στρατιώτης (m) 
someone	κάποιος (kapios) (m)
something	κάτι (kati) (n)
sometimes	ενίοτε (eníote); μερικές φορές (merikés forés); καμιά φορά (kamiá forá)
son	γαμπρός (m); (m)
song	τραγούδι (n) (traɣúði); άσμα (n) (ázma); ωδή (f) (oðí)
soon	σύντομα; νωρίς
sorry	συγγνώμη (singnómi)
soul	ψυχή (f) (psychí)
sound	ήχος (m) (íchos)
soup	σούπα (f) (soúpa)
sour	ξινός (m) (xinós)
south	νότος (m) (nótos)
spacecraft	διαστημόπλοιο (n) (diastimóploio)
spaceship	διαστημόπλοιο (n) (diastimóploio)
spacetime	χωρόχρονος (m) 
spade	φτυάρι (n)
sparrow	σπουργίτης (m)
sparrow hawk	ξεφτέρι
speak	μιλώ (miló); λέω (léo)
spectacles	ματογυάλια (matoyialia) (n'p), γυαλιά (yialia) (n'p)
speech	λόγος (m) (lógos); ομιλία (f) (omilía)
sphere	σφαίρα (f) (sfaíra)
spice	καρύκευμα (n) (karýkevma)
spider	αράχνη (f) (aráchni)
spinach	σπανάκι (n) (spanáki)
spirit	πνεύμα (n) (pnévma)
spit	φτύνω
spleen	σπλην (m) (splin); σπλήνα (f) (splína)
spoon	κουτάλι (n) (koutáli)
spring	ελατήριο (n) (elatírio); σούστα (f) (soústa)
spruce	ερυθρελάτη (erythrelati) (n)
spy	κατάσκοπος (m) (katáskopos)
square	πλατεία (f) (plateía)
squid	καλαμάρι (kalamári) (n), τευθίς (tefthis) (f)
squirrel	σκίουρος (m) (skíouros)
star	αστέρι (astéri) (n), αστέρας (astéras) (m), σταρ (star) (m)
starling	ψαρόνι (n) (psaróni)
station	στάθμευση (f) (státhmefsi)
statue	άγαλμα (n) (ágalma)
steel	χάλυβας (xálivas) (m), ατσάλι (atsáli) (n) (from Medieval Venetian "azzal")
stomach	στομάχι (n) (stomáchi); κοιλιά (f) (koiliá)
stone	λίθος (m) (líthos)
stork	πελαργός (pelargós); λελέκι (n)
story	ιστορία (f) (istoría)
strange	παράξενος (paraksenos) (m), παράδοξος (paradoksos) (m), αλλόκοτος (alokotos) (m). περίεργος (periergos) (m)
strawberry	φράουλα (fráula) (f), χαμοκέρασο (khamocéraso) (n)
street	οδός (f) (odós); δρόμος (m) (drómos)
strength	δύναμη (f) (δínami)
string	σπάγγος (m) (spángos)
strontium	στρόντιο (n) (stróntio)
student	σπουδαστής (m) (spoudastís); σπουδάστρια (f) (spoudástria)
submarine	υποβρύχιο (n) (ypovrýchio)
suddenly	ξαφνικά (ksafniká)
sugar	ζάχαρη (f) (záchari)
suicide	αυτοκτονία (f) (aftoktonía); αυτοχειρία (f) (aftocheiría)
sulfur	θείο (n) (theío)
summer	καλοκαίρι (n) (kalokaíri)
sun	ήλιος (m) (ílios)
sunflower	ηλιοτρόπιο (n) (iliotrόpio)
surname	επώνυμο (n) (epónymo); επίθετο (n) (epítheto)
swallow	καταπίνω (katapíno)
swan	κύκνος (kyknos) (m)
sweet	γλυκός (glykós)
sweet potato	γλυκοπατάτα (f) (glykopatáta)
sweetener	γλυκαντικό (m) (glukantikό)
swim	κολυμπάω (kolympáo)
sword	ξίφος (ksífos) (n), σπαθί (spathí) (n)
swordfish	ξιφίας (ksifias) (m)
syringe	σύριγγα (f) (sýringa)
system	σύστημα (n) (sýstima)
table	πίνακας (m) (pínakas)
taiga	τάιγκα
tail	ουρά (f) (ourá)
talent	τάλαντο (tála[n]do) (n), ταλέντο (talé[n]do) (n)
talk	μιλώ (miló); συνομιλώ (sinomiló)
tank	άρμα μάχης (n) (árma máchis)
tantalum	ταντάλιο (n) (tantálio)
tattoo	τατουάζ (n) (tatouáz)
tawny owl	χουχουριστιής
taxi	ταξί (n) (taxí)
tea	τσάι (n) (tsái)
teach	διδάσκω
teacher	δάσκαλος (m) (dáskalos); δασκάλα (f) (daskála)
tear	δάκρυ (n) (dákry)
technetium	τεχνήτιο (n) (technítio)
telephone	τηλεφωνώ (tilefonó); καλώ
telescope	τηλεσκόπιο (n)
television	τηλεόραση (f) (tileórasi)
tellurium	τελλούριο (n) (telloúrio)
temperature	θερμοκρασία (f) 
temple	ναός (m) (naós)
ten	δέκα (déka)
tent	σκηνή (f)
terbium	τέρβιο (n) (térvio)
terrorism	τρομοκρατία (f) 
terrorist	τρομοκράτης (m) (tromokrátis)
testicle	όρχις (m) (orchis); αρχίδι (m) (archíði)
thallium	θάλλιο (n) (thállio)
thank you	ευχαριστώ (efcharistó)
thank you very much	ευχαριστώ πολύ
thanks	ευχαριστώ (efcharistó)
that	εκείνος (m), εκείνη (f), εκείνο (n), εκοίνοι (p), εκείνες (f'p), εκείνα (n'p)
then	τότε (tóte)
there	εκεί (ekí)
they	αυτοί (m) (aftí); αυτές (f) (aftés); αυτά (n) (aftá)
thick	παχής (m) (pachis)
thief	κλέφτης (m) (kléftis)
thigh	μηρός (m)
thimble	δαχτυλίθρα (f)
thing	πράγμα (n) (prágma); πλάσμα (n) (plasma); υποκείμενο (n) (ipokimeno)
third	τρίτος (trítos); (tríti)τρίτο (tríto); τρίτοι (tríti); τρίτες (trítes); τρίτα (tríta)
thirst	δίψα (f) (dípsa)
thirsty	διψασμένος 
thirteen	δεκατρείς (m); δεκατρία (n) (dekatría)
thirty	τριάντα (triánda)
this	ούτος (oútos) (m), αύτη (ávti) (f), τούτο (toúto) (n)
thorium	θόριο (n) (thório)
thorn	αγκάθι (agkáthi)
thought	σκέψη (f) 
thousand	χίλια (khília)
thread	νήμα (n); κλωστή (f) (klostí)
three	τρεις (m); τρία (n) (tría)
throat	λαιμός (m) (lemós)
thulium	θούλιο (n) (thoúlio)
thumb	αντίχειρας (m) (antícheiras)
thunder	κεραυνός (m) (keravnós)
tiger	τίγρη (m)
time	φορά (f) 
tin	κασσίτερος (m) (kassíteros); λευκοσίδηρος (m) (lefkosídiros)
titanium	τιτάνιο (n) (titánio)
to	προς (pros), σε (se)
toad	φρύνος (m) 
tobacco	καπνός (m) (kapnós)
today	σήμερα (símera)
together	μαζί (mazí)
toilet	μπάνιο (n) (bánio)
tomato	ντομάτα (f) (domáta); τομάτα (f) (tomáta)
tomorrow	αύριο (ávrio)
tongue	γλώσσα (f) (glóssa)
too	υπερβολικά (ipervolika)
tooth	δόντι (n) (dónti)
toothbrush	οδοντόβουρτσα (f) (odontóvourtsa)
tortoise	χελώνα
touch	αγγίζω (angizo)
tourism	τουρισμός (m) (tourismós)
town	πόλη (f) (póli)
toy	παιχνίδι (n) (pekhnídi); παιχνίδακι (n) (pechnídaki)
tradition	παράδοση (f) (paradosi)
train	αμαξοστοιχία (n) (amaxostikhía); τραίνο; (n) (treno)
tram	τραμ (n) (tram)
translate	μεταφράζω
translation	μετάφραση (f) (metáfrasi)
translator	μεταφραστής (m) 
tree	δέντρο (n) (ðéndro); δένδρο (n) (ðénðro)
tribe	φύλο (n) (fýlo); φυλή (f) (fylí)
truck	φορτηγό (fortigó); φορτάμαξα (fortámaxa)
true	αληθινός
trumpet	τρομπέτα (f) (trompéta); σάλπιγγα (f) (sálpinga)
tsar	τσάρος (m) (tsáros)
tsunami	τσουνάμι (n) (tsounámi)
tungsten	βολφράμιο 
turkey	γαλοπούλα (f) (galopoúla); διάνος (m) (ðiános)
turtle	νεροχελώνα (f) (nerochelóna)
turtle dove	τριγόνι ' '
twelve	δώδεκα (dódeka)
twenty	είκοσι πέντε (eíkosi pénde)
twin	δίδυμος (dídymos)
two	δύο (dýo)
two hundred	διακόσια (diakósia)
typhoon	τυφώνας (m) (tufónas)
umbrella	ομπρέλα (f); (n) (n)
uncle	θείος (m) (thíos)
understand	καταλαβαίνω 
unemployment	ανεργία (f) (anergía)
universe	σύμπαν (n) (sýmpan)
university	πανεπιστήμιο (n) (panepistímio)
uranium	ουράνιο (n) (ouránio)
urethra	ουρήθρα (f) (uríthra)
urine	ούρα (n)
use	χρησιμοποιώ
useful	χρήσιμος (khrēsimos)
vagina	κόλπος (m) (kolpos)
valley	κοιλάδα (f) (koiláda)
vampire	βαμπίρ (n) (vampír)
vanadium	βανάδιο (n) (vanádio)
vegetable	λαχανικό (n) (lachanikó)
verb	ρήμα (n) (ˈrima)
very	πολύ (polý)
victory	νίκη (níke)
village	χωριό (khorió) (n)
vinegar	ξύδι (ksidi) (n), ξυνό (ksino) (n)
violet	ιόχρουν (iókhrun), βιολετί (vyoletí), μενεξεδί (menexedhí)
violin	βιολί (n) (biolí)
virgin	παρθένα (f) (parthéna)
virus	ιός (m) (iós)
visa	βίζα (f) (víza)
vodka	βότκα (f) (vótka)
voice	φωνή (f) (foní)
volcano	ηφαίστειο (n) (ifaísteio)
volleyball	πετοσφαίριση (petosférisi) (f), βόλλεϋ or βόλεϊ (vólei) (n)
volt	βολτ (n) (volt)
vulture	γύπας (gypas); όρνεο (n)
wait	περιμένω (periméno)
waiter	σερβιτόρος (m) (servitóros)
walk	περπατώ (perpató); βαδίζω (vadízo)
wall	τείχος (n) 
walrus	οδόβαινος (f) (odóvenos); θαλάσσιος ίππος (f) (thalássios íppos)
want	θέλω (thélo)
war	πόλεμος (m) (pólemos)
warship	πολεμικό πλοίο (n)
wart	κρεατοελιά (f) (kreatoeliá)
wash	πλένω
watch	ρολόι (n)
waterfall	καταρράκτης (m) (kataráktis)
watermelon	υδροπεπόνι (n) (ydropepóni); καρπούζι (n) (karpoúzi)
wave	κύμα (n)
wax	κερί (n) (kerí); κηρός (m) (kirós)
way	δρόμος
we	εμείς 
weapon	όπλο (n) (óplo)
weather	καιρός (m) (kairós)
web site	ιστότοπος (m) (istótopos); ιστοχώρος (m) (istochóros)
wedding	γάμος (m) (gamos)
week	εβδομάδα (f) (evdomáda); επταήμερο (n) (eptaímero)
welcome	καλώς ορίσατε! (kalós orísate), καλώς ήρθες!
well	καλά (kalá); καλώς (kalós)
werewolf	λυκάνθρωπος (m) (lykánthrōpos)
west	δύση (f) 
wet	βρεγμένος (m) (vregménos); υγρός (m) (iγrós); μουσκεμένος (m) (mouskeménos)
whale	φάλαινα (f) (fálena)
what	τί (ti)
what is your name	πώς σε λένε (pós se léne?)
what time is it	τι ώρα είναι (ti óra eínai?)
wheat	σιτάρι (n) (sitári)
wheel	τροχός (trokhós) (m), ρόδα (róda) (f)
when	πότε (póte)
where	όπου (ópou)
where is the toilet	πού είναι η τουαλέτα (poú eínai i toualéta?)
whip	μαστίγιο (m) (mastíjio)
whiskey	ουίσκι (n) (ouíski)
white	άσπρο (n) (áspro); λευκό (n) (lefkó)
who	ποιος (m) (poios)
whore	πόρνη (pórni) (f), ιερόδουλη (ieróduli) (f), (vulgar:) πουτάνα (putána) (f)
why	γιατί (yiatí)
wide	ευρύς (m) (ev̱rýs); ευρεία (f) (ev̱reía)
widow	χήρα (f) (chíra)
wife	σύζυγος (f) (sýzygos); γυναίκα (f) (gynaíka); συμβία (f) (symvía)
wild boar	αγριογούρουνο (n) (agriogοúrοuno)
wildcat	αγριόγατος (agriógatos) (m), γάτα (gáta)
willow	ιτιά (f) (itiá)
wind	άνεμος (m) 
window	παράθυρο (n) (paráthyro)
wing	φτερό (n) (fterό)
winter	χειμώνας (m) (cheimónas)
wise	σοφός (sophós)
wisent	βόνασος ευρωπαϊκώς (m)
wish	εύχομαι (éfkhome)
witch	μάγισσα (f) (mágissa)
with	με (mé), μαζί (mazí)
without	χωρίς (chorís)
wolf	λύκος (m) (lýkos); λύκαινα (f) (lýkaina)
wood	,
woodpecker	δρυοκολάπτης (m)
word	λέξη (f) (léxi)
work	έργο (n); εργασία (f); δουλειά (f)
workers of the world, unite	προλετάριοι όλου του κόσμου, ενωθείτε! (proletárii ólu tu kósmu, enothíte!), προλετάριοι όλων των χωρών, ενωθείτε! (proletárii ólon ton chorón, enothíte!)
world	κόσμος (m) (kósmos)
wrist	καρπός (m) (karpós)
write	γράφω 
writer	συγγραφέας (m)
xenon	ξένο (xéno) (n)
xenophobia	ξενοφοβία (f) (xenofovía)
yawn	χασμουριέμαι (chasmouriémai)
yeast	μαγιά (f); ζύμη (f)
yellow	κίτρινο (kítrino) (n), ώχρα (ókhra) (f)
yes	ναι (nai)
yesterday	χθες (chthes)
yoga	γιόγκα
yoghurt	γιαούρτι (n) (yiaoúrti)
yolk	κρόκος (m) (krókos)
you	εσείς 
young	νεαρός (nearós)
your	σας; σας (n) (sas)
ytterbium	υττέρβιο (n) (yttérvio)
yttrium	ύττριο (n) (ýttrio)
zebra	ζέβρος (m) (zévros); ζέβρα (f) (zévra); όναγρος (m) (ónagros)
zero	μηδέν (n) (midén)
zinc	ψευδάργυρος (m) (psevdárgyros)
