English	Japanese
AIDS	エイズ (eidzu); 後天性免疫不全症候群 (こうてんせいめんえきふぜんしょうこうぐん, kōtensei men’eki fuzen shōkōgun)
Abidjan	アビジャン (Abijan)
Abkhaz	アブハズ語 (abuhazu-go); アブハジア語 (abuhajia-go)
Abkhazia	アブハジア (Abuhajia)
Abraham	アブラハム (Aburahamu)
Adam	アダム (Adamu)
Afghanistan	アフガニスタン (Afuganisutan)
Africa	アフリカ (Afurika); 阿弗利加
Afrikaans	アフリカーンス語 (Afurikānsu-go)
Alaska	アラスカ州 (Arasuka shū)
Albania	アルバニア (Arubania)
Alberta	アルバータ (Arubāta); アルバータ州 (Arubāta-shū)
Alexander	アレクサンダー (Arekusandā)
Algeria	アルジェリア (Arujeria)
Algiers	アルジェ (Aruje)
Allah	アッラーフ (Arrāfu); アッラー (Arrā); アラー (Arā)
Alps	アルプス (Arupusu)
America	アメリカ州 (Amerika-shū); (べいしゅう, Beishū)
American	アメリカ人 (Amerika-jin); 米国人 (べいこくじん, Beikoku-jin)
Amsterdam	アムステルダム (Amusuterudamu)
Amur	アムール川 (Amūru-gawa); 黒竜江 (こくりゅうこう, Kokuryūkō)
Andorra	アンドラ (Andora); アンドラ公国 (Andora-kōkoku)
Andrew	アンドリュー (Andoryū)
Anglo	古英語 (こえいご, koeigo)
Angola	アンゴラ (Angora)
Ankara	アンカラ (Ankara)
Antarctica	南極 (なんきょく, Nankyoku); 南極大陸 (なんきょくたいりく, Nankyoku tairiku)
Antigua and Barbuda	アンティグア・バーブーダ (Antigua Bābūda)
April	四月 (しがつ, shigatsú); 卯月 (うづき, uzuki)
Arabic	アラビア語 (Arabiá-go)
Arctic Ocean	北極海 (ほっきょくかい, Hokkyokukai); 北氷洋 (ほっぴょうよう, Hoppyōyō); 北極洋 (ほっきょくよう, Hokkyokuyō)
Argentina	アルゼンチン (Aruzenchin)
Argonaut	アルゴナウタイ
Armenia	アルメニア (Arumenia)
Armenian	アルメニア人 (Arumenia-jin)
Asclepius	アスクレーピオス (asukurēpiosu)
Asia	アジア (あじあ, Ajia); 亜細亜 (あじあ, Ajia)
Athena	アテーナー (Atēnā)
Athens	アテネ (Atene)
Atlantic Ocean	大西洋 (たいせいよう, Taiseiyō)
August	八月 (はちがつ, hachigatsú); 葉月 (はづき, hazuki)
Australia	オーストラリア (Ōsutoraria); 濠洲; 豪州 (ごうしゅう, Gōshū); 濠; 豪 (ごう, Gō)
Austria	オーストリア (Ōsutoria); 墺太利
Aymara	アイマラ語
Azerbaijan	アゼルバイジャン (Azerubaijan)
Azeri	アゼルバイジャン語 (Azerubaijan-go)
Bahamas	バハマ (Bahama)
Bahrain	バーレーン (Bārēn)
Baku	バクー (Bakū)
Balearic Islands	バレアレス諸島 (Barearesu shotō)
Baltic Sea	バルト海 (Baruto-kai)
Bambara	バンバラ語
Bangkok	バンコク (Bankoku)
Bangladesh	バングラデシュ (Banguradeshu)
Barbados	バルバドス (barubadosu)
Bashkir	バシキール語 (Bashikīru-go)
Beijing	北京; ペキン (Pekin)
Beirut	ベイルート (Beirūto)
Belarus	ベラルーシ (Berarūshi); ベロルシア (Berorushia)
Belarusian	ベラルーシ語 (berarūshi-go)
Belgium	ベルギー (Berugī)
Belgrade	ベオグラード (Beogurādo)
Belorussian	ベラルーシ語 (berarūshi-go)
Berlin	ベルリン (Berurin)
Bermuda	バーミューダ (Bāmyūda)
Bhutan	ブータン (Būtan)
Bible	聖書 (せいしょ, seisho); バイブル (baiburu); 経典 (きょうてん, kyōten, けいてん, keiten)
Black Sea	黒海 (こっかい, Kokkai)
Bolivia	ボリビア (Boribia)
Bosnia	ボスニア (Bosunia)
Bosnia and Herzegovina	ボスニア・ヘルツェゴヴィナ (Bosunia-Herutsegovina)
Bosphorus	ボスフォラス海峡 (Bosuporasu kaikyō)
Botswana	ボツワナ (Botsuwana)
Brazil	ブラジル (Burajiru); 伯剌西爾 
Breton	ブルトン語 (Buruton-go)
Brunei	ブルネイ (Burunei)
Brussels	ブリュッセル (Buryusseru)
Bucharest	ブカレスト (Bukaresuto)
Buddha	仏陀 (ぶっだ, Budda; ぶつだ, Butsuda); 仏 (ほとけ, Hotoke)
Buddhism	仏教 (ぶっきょう, bukkyō)
Bulgaria	ブルガリア (Burugaria)
Bulgarian	ブルガリア語 (Burugaria-go)
Burkina Faso	ブルキナファソ (Burukina-faso)
Byzantine Empire	東ローマ帝国 (Higashi Rōma teikoku)
Cambodia	カンボディア (Kambodia); カンボジア (Kambojia)
Cameroon	カメルーン (Kamerūn)
Canada	カナダ (Kanada); 加奈陀 (Kanada)
Cape Verde	カーボベルデ (Kāboberude)
Carthage	カルタゴ (Karutago)
Caspian Sea	カスピ海 (Kasupi-kai)
Catalan	カタルーニャ語 (Katarūnya-go)
Caucasus	カフカース (Kafukāsu)
Central African Republic	中央アフリカ共和国 (Chūō-Afurika kyōwakoku)
Chad	チャド (Chado)
Chicago	シカゴ (Shikago)
Chile	チリ (Chiri)
China	中国 (ちゅうごく, Chūgoku)
Chinese	中国人 (ちゅうごくじん, Chūgokujin)
Chisinau	キシナウ (Kishinau); キシニョフ (Kishinyofu)
Christ	キリスト (Kirisuto); ハリストス (Harisutosu)
Christian	クリスチャン (Kurisuchan); キリスト教徒 (Kirisuto-kyōto)
Christianity	キリスト教 (Kirisuto-kyō)
Christmas	クリスマス (Kurisumasu)
Christopher	クリストファー (Kurisutofā)
Coca	コカ・コーラ (Koka-Kōra)
Cold War	米ソ冷戦 (Bei-So reisen); 冷戦 (れいせん, reisen)
Colombia	コロンビア (Koronbia)
Commonwealth of Independent States	独立国家共同体 (どくりつこっかきょうどうたい, dokuritsu-kokka-kyōdōtai)
Constantinople	コンスタンティノポリス (konsutantinoporisu)
Copenhagen	コペンハーゲン (Kopenhāgen)
Costa Rica	コスタリカ (Kosutarika)
Croatia	クロアチア (Kuroachia)
Croatian	クロアチア語 (kuroachia-go)
Cuba	キューバ (Kyūba)
Cyprus	キプロス (Kipurosu)
Cyrillic	キリル文字 (Kiriru moji); キリル (Kiriru)
Cyrillic alphabet	キリル文字 (きりるもじ, Kiriru moji)
Czech	チェコ語 (Cheko-go)
Czech Republic	チェコ (Cheko); チェコ共和国 (Cheko-kyōwakoku)
Czechia	チェコ (Cheko)
Czechoslovakia	チェコスロバキア (Chekosurobakia)
Damascus	ダマスカス (Damasukasu)
Danish	デンマーク語 (Denmākugo)
Danube	ドナウ川 (Donau-gawá)
Dead Sea	死海 (しかい, Shikai)
December	十二月 (じゅうにがつ, jūnigatsú); 師走 (しわす, shiwasu)
Denmark	デンマーク (Denmāku); 丁抹
Dominican Republic	ドミニカ共和国 (Dominika kyōwakoku)
Dutch	オランダの (oranda-no); オランダ語の (oranda-go no); 蘭 (らん-, Ran-)
Earth	地球 (ちきゅう, Chikyū)
East Timor	東ティモール (ひがしティモール, Higashi-Timōru); 東チモール (ひがしチモール, Higashi-Chimōru)
Easter	復活祭 (ふっかつさい, Fukkatsu-sai); 聖大パスハ (Seidai-Pasuha)
Easter Island	イースター島 (Īsutā-tō)
Eastern Europe	東欧 (tōō); 東ヨーロッパ 
Edmonton	エドモントン (Edomonton)
Egypt	エジプト (Ejiputo)
England	イングランド (Ingurando); イギリス (Igirisú); 英国; (Eikokú)
English	イギリス人 (Igirisú-jin); (えいこくじん, Eikoku-jin)
Esperanto	エスペラント (Esuperanto); エスペラント語 (Esuperanto-go)
Estonia	エストニア (Esutonia)
Ethiopia	エチオピア (Echiopia)
Eurasia	ユーラシア (Yūrasia); 亜欧 (あおう, Aō); 欧亜 (おうあ, Ōa)
Europe	ヨーロッパ (Yōroppa); 欧羅巴 (Yōroppa); 欧州 (Ōshū)
European Union	欧州連合 (おうしゅうれんごう, Ōshū-Rengō); ヨーロッパ連合 (Yōroppa-Rengō); ＥＵ
Far East	極東 (きょくとう, Kyokutō)
Faroe Islands	フェロー諸島 (Ferō-shotō)
Faroese	フェロー語 (ferō go), ファロエズ語 (faroezu go)
February	二月 (にがつ, nigatsú); 如月 (きさらぎ, kisaragi)
Fiji	フィジー (Fijī)
Finland	フィンランド (Finrando)
Finnish	フィンランド語 (finrando-go)
France	フランス (Furánsu); 仏蘭西 (Furánsu)
French	フランス人 (furansu-jin)
Friday	金曜日 (きんようび, kinyōbi)
GDP	GDP
Ganges	ガンジス川 (Ganjisu-gawa); ガンジス (Ganjisu)
Gaza Strip	ガザ地区 (Gaza-chiku)
Geneva	ジュネーブ (Junēbu); ジュネーヴ (Junēvu)
George	ジョージ (Jōji)
Georgia	グルジア (Gurujia)
Georgian	グルジア語 (Gurujia-go)
German	ドイツ (Doitsu-no); 独 (どく-, Doku-)
Germany	ドイツ (Doitsu); 独逸 (Doitsu)
Ghana	ガーナ (Gāna)
Ghent	ヘント
Gibraltar	ジブラルタル (Jiburarutaru)
Goa	ゴア州 (Goa-shū); ゴア (Goa)
God	神 (かみ, kami), 神様 (かみさま, kamisama),デウス
Great Britain	ブリテン (Buriten); イギリス (Igirisu); グレートブリテン島 (Gureito Buriten-tō); 英国 (えいこく, Eikoku)
Great Pyramid of Giza	ギザの大ピラミッド (Giza-no dai-piramiddo); クフ王のピラミッド (Kufu-ō-no piramiddo)
Greece	ギリシャ (Girisha); ギリシア (Girishia)
Greek	ギリシア人 (Girishia-jin); ギリシャ人 (Girisha-jin)
Greenland	グリーンランド (Gurīnrando)
Guinea	ギニア (Ginia)
Gujarati	グジャラティ語 (Gujarati-go)
Gulf of Finland	フィンランド湾 (Finrando-wan)
Guyana	ガイアナ (Gaiana)
Haiti	ハイチ (Haichi)
Happy New Year	よいお年を (yoi otoshi-o); 明けましておめでとう (akemashite omedetō)
Hebrew	ヘブライ語 (Heburai-go)
Hezbollah	ヒズボラ (Hizubora)
Hindi	ヒンディー語 (hindii-go)
Hokkaido	北海道 (ほっかいどう, Hokkaidō)
Holland	オランダ (Oranda); 蘭国 (らんこく, Rankoku)
Holocaust	ユダヤ人大虐殺 (Yudayajin dai-gyakusatsu); ホロコースト (Horokōsuto)
Holy Spirit	聖霊 (せいれい, seirei)
Hong Kong	香港 (ほんこん, Honkon); ホンコン (Honkon); シャンガン (Shangan)
Hungarian	ハンガリー人 (Hangarī-jin)
Hungary	ハンガリー (Hangarī)
I	私 (わたし, watashí); わたくし; あたし (f) (atashí); こちら (kochira); うち (uchi); 僕 (m) (ぼく, boku); 俺 (m) (おれ, ore); 我 (われ, ware); (shōsei)愚生 (gusē); 朕 (chin); わて (wate); あっし (f) (asshi); あたい (atai); 自分 (jibun); うち (f) (uchi); わっし (m) (wasshi); わし (washi); 我輩 (wagahai); 予 (yo)
I am English	私はイギリス人です (watashi-wa Igirisú-jin desu)
I have a question	質問があります (しつもんがあります, shitsumon-ga arimasu)
I love you	大好き (だいすき, Daisuki)
I need an interpreter	私は通訳が必要です (わたしはつうやくがひつようです, watashi-wa tsūyaku-ga hitsuyō desu)
Iceland	アイスランド (Aisurando)
India	インド (Indo); 印度 (Indo)
Indian Ocean	インド洋 (Indoyō)
Indonesia	インドネシア (Indoneshia)
Interlingua	インターリングア (Intāringua); インターリングア語 (Intāringua-go)
International Phonetic Alphabet	国際音声記号 (kokusai onsei kigō)
Internet	インターネット (intānetto); ネット (netto)
Iran	イラン (Iran)
Iraq	イラク (Iraku)
Ireland	アイルランド (Airurando)
Islam	イスラム教 (イスラムきょう, Isuramu-kyō); 回教 (かいきょう, Kai-kyō)
Israel	イスラエル (isuraeru)
Italian	イタリア (Itaria-no); 伊 (い-, i-)
Italy	イタリア (Itariá); 伊太利亜 (イタリア, Itariá); イタリー (Itarī); 伊太利 (イタリー, Itarī)
Jamaica	ジャマイカ (Jamaika)
January	一月 (いちがつ, ichigátsu); 睦月 (むつき, mutsuki)
Japan	日本 
Japanese	日本 (にほん, Nihon-); 日本 (にほんの, Nihon-no); 日 (にち, Nichi-, にっ, Ni-); 和 (わ, Wa-)
Jerusalem	エルサレム (Erusaremu); イェルサレム (Yerusaremu)
Jesus	イエス (Iésu); (いえす, Iésu)イイスス (Iisusu); イエズス (Iezusu); イエス・キリスト (Iesu-Kirisuto)
Jesus Christ	イエスキリスト; イエス・キリスト (Iésu-Kirisutó)
Jew	ユダヤ人 (Yudaya-jin)
Jewish	ユダヤ人 (ゆだやじん) ('Yudaya-jin'), ユダヤの (ゆだやの) ('Yudaya-no')
John	ジョン (Jon)
Jordan	ヨルダン (Yorudan)
Judaism	ユダヤ教 (Yudaya-kyō)
July	七月 (shichí-gatsú); 文月 (ふみづき, fumizuki, ふづき, fuzuki)
June	六月 (ろくがつ, rokú-gatsú); 水無月 (みなづき, minazuki)
Jupiter	ジュピター (Jupitā)
Kannada	カンナダ語 (Kannada-go)
Karnataka	カルナータカ州 (Karunātaka shū); カルナータカ (Karunātaka)
Kazakhstan	カザフスタン (Kazafusutan)
Kenya	ケニア (Kenia)
Khartoum	ハルツーム (Harutsūmu)
Khmer	クメール語 (Kumēru-go)
Khrushchev	フルシチョフ (Furushichofu)
Kiev	キエフ (Kiefu)
Korea	朝鮮 (ちょうせん, 'Chōsen'); (きたちょうせん, Kitachōsen) (かんこく, Kankoku) (ちょうせんはんとう, Chōsen-hantō)
Korean	韓国語 (かんこくご, Kankoku-go); 朝鮮語 (ちょうせんご, Chōsen-go)
Kosovo	コソボ (Kosobo); コソヴォ (Kosovo)
Kurdish	クルド語 (Kurudo-go)
Kuwait	クウェート (Kuwēto)
Kyrgyzstan	キルギス (Kirugisu)
Laos	ラオス (Raosu)
Latin	ラテン語 (Raten-go)
Latvia	ラトビア (Ratobia); ラトヴィア (Ratovia, Ratobia)
Liberia	リベリア (Riberia)
Libya	リビア (Ribia)
Liechtenstein	リヒテンシュタイン (Rihitenshutain)
Lisbon	リスボン (Risubon)
Lithuania	リトアニア (Ritoania)
London	ロンドン (Rondon)
Luxembourg	ルクセンブルク (Rukusenburuku)
Macedonia	マケドニア (Makedonia); マケドニア共和国 (Makedonia kyōwakoku)
Magna Carta	マグナ・カルタ (maguna karuta)
Malayalam	マラヤーラム語 (Marayāramu-go)
Malaysia	マレーシア (Marēshia)
Maldives	モルディブ (Morudibu); モルジブ (Morujibu)
Malta	マルタ (Maruta); マルタ島 (マルタとう, Maruta tō)
Man	ヒト (hito); 人間 (ningen)
Manchuria	満州 (まんしゅう, Manshū)
Maoism	毛沢東思想 (もうたくとうしそう, Mō-Takutō shisō); 毛主義 (もうしゅぎ, Mō-shugi); 毛沢東主義 (もうたくとうしゅぎ, Mō Takutō-shugi)
March	三月 (さんがつ, sángatsu); 弥生 (やよい, yayoi)
Mars	マールス (Mārusu)
Marshall Islands	マーシャル諸島 (Māsharu shotō)
Mary	メアリー (mearī); マリー (marii)
Matthew	マシュー (mashū)
Mauritius	モーリシャス (mōrishasu)
May	五月 (ごがつ, gógatsu); 皐月 (さつき, satsuki)
Mediterranean Sea	地中海 (ちちゅうかい, Chichūkai)
Mercury	メルクリウス (Merukuriusu)
Merry Christmas	メリークリスマス (Meri Kurisumasu)
Mexico	メキシコ (Mekishiko)
Michael	マイケル (Maikeru)
Middle East	中東 (ちゅうとう, Chūtō)
Minsk	ミンスク (Minsuku)
Miss	お嬢さん (おじょうさん, o-jō-san); お嬢様 (おじょうさま, o-jō-sama); さん (-san)
Moldova	モルドヴァ (Morudova); モルドバ (Morudoba); モルダビア (Morudabia)
Monaco	モナコ (Monako)
Monday	月曜日 (げつようび, getsuyōbi)
Mongolia	モンゴル (Mongoru); 蒙古 (もうこ, Mōko)
Montenegro	モンテネグロ (Monteneguro)
Moon	月 (つき, tsukí); ムーン (Mūn)
Morocco	モロッコ (Morokko)
Moscow	モスクワ (Mosukuwa)
Moses	モーセ (Mōse)
Mount Everest	エベレスト (Eberesuto); チョモランマ (Chomoranma)
Mozambique	モザンビーク (Mozanbīku)
Mrs	夫人 (-ふじん, -fujin); さん (-san); 様 (-さま, -sama)
Muhammad	マホメット (Mahometto); モハメッド (Mohameddo); ムハンマド・イブン＝アブドゥッラーフ (muhanmado ibun-abudurrāfu)
Mumbai	ムンバイ (Munbai)
Munich	ミュンヘン (Myunhen)
Muslim	ムスリム (Musurimu); イスラム教徒 (イスラムきょうと, Isuramu-kyōto); 回教徒 (かいきょうと, Kaikyōto)
Myanmar	ミャンマー (Myanmā); ビルマ (Biruma)
NATO	北大西洋条約 (きたたいせいようじょうやく, kita-taiseyō-jōyaku); ナトー (Natō)
Namibia	ナミビア (Namibia)
Naypyidaw	ネピドー (Nepidō)
Nepal	ネパール (Nepāru); ニハラ (Nihara)
Neptune	海王星 (かいおうせい, Kaiōsei)
Netherlands	オランダ (Oranda); 蘭国 (らんこく, Rankoku)
New Delhi	ニューデリー (Nyū-Derī); ニュー・デリー (Nyū-Derī)
New York City	ニューヨーク市 (Nyūyōkushi); ニューヨーク (Nyūyōku); 紐育 (Nyūyōku)
New Zealand	ニュージーランド (Nyūjīrando); ニュー・ジーランド (Nyū-Jīrando)
Nicaragua	ニカラグア (Nikaragua)
Nicholas	ニコラス (Nikorasu) ('transliteration')
Nigeria	ナイジェリア (Naijeria)
North America	北アメリカ (Kita-Amerika); 北米 (ほくべい, Hoku-Bei)
North Korea	北朝鮮 (きたちょうせん, Kita-Chōsen)
Northern Europe	北ヨーロッパ; (Hokuō)
Northern Ireland	北アイルランド (Kita-Airurando)
Norway	ノルウェー (Noruwē)
November	十一月 (じゅういちがつ, jūichigatsú); 霜月 (しもつき, shimotsuki)
Occitan	オック語 (Okku-go)
Oceania	オセアニア (Oseania); 大洋州 (たいようしゅう, Taiyōshū)
October	十月 (じゅうがつ, jūgatsú); 神無月 (かんなづき, kannazuki, かみなづき, kaminazuki, かむなづき, kamunazuki)
Olympic Games	オリンピック (Orimpikku); オリンピック競技大会 (Orinpikku kyōgi taikai)
Oman	オマーン (Omān)
Ottoman Empire	オスマン帝国 (Osuman teikoku)
Pacific Ocean	太平洋 (たいへいよう, Taiheiyō)
Pakistan	パキスタン (Pakisutan)
Palestine	パレスチナ (Paresuchina)
Papua New Guinea	パプアニューギニア (Papua-Nyūginia)
Paris	パリ (Pari)
Paul	ポール (Pōru)
Persian	ペルシア語 (Pérushia-go)
Peru	ペルー (Perū)
Philippines	フィリピン (Firipin)
Pisces	魚座 (うおざ, uoza)
Pleiades	(pureadesu seidan)
Pluto	冥王星 (めいおうせい, Meiōsei)
Poland	ポーランド (Pōrando)
Polish	ポーランド語 (Pōrando-go)
Portugal	ポルトガル (Porutogaru); 葡萄牙 (Porutogaru)
Portuguese	ポルトガル語 (Porutogaru-go)
Prague	プラハ (Puraha)
Pythagoras	ピタゴラス (Pitagorasu); ピュタゴラス (Pyutagorasu)
Red Sea	紅海
Reykjavik	レイキャビク (Reikyabiku)
Roman	ローマ (Rōma-no)
Romania	ルーマニア (Rūmania)
Romanian	ルーマニア語 (Rūmania-go)
Rome	ローマ (Rōma); 羅馬 (Rōma)
Russia	ロシア (Róshia); 露西亜 (Róshia); 露国 (ろこく, Rokoku)
Russian	ロシア (Roshia-no); 露 (ろ, Ro-)
Russian Federation	ロシア連邦 (ロシアれんぽう, Roshia-renpō)
Rwanda	ルワンダ (Ruwanda)
Saint Petersburg	サンクトペテルブルク (Sankutopeteruburuku)
Sanskrit	サンスクリット (Sansukuritto); 梵語 (ぼんご, Bon-go)
Santa Claus	サンタクロース (Santakurōsu)
Satan	サタン (Satan)
Saturday	土曜日 (どようび, doyōbi)
Saturn	土星 (どせい, Dosei)
Saudi Arabia	サウジアラビア (Sauji-Arabia)
Scotland	スコットランド (Sukottorándo); 蘇格蘭 
Senegal	セネガル (Senegaru)
Seoul	ソウル (Souru); 京城 (けいじょう, Keijō); 漢城 (かんじょう, Kanjō)
September	九月 (くがつ, kúgatsu); 長月 (ながつき, nagatsuki)
Serb	セルビア人 (Serubia-jin)
Serbia	セルビア (Serubia)
Serbia and Montenegro	セルビア・モンテネグロ (Serubia-Monteneguro)
Serbian	セルビア人 (Serubia-jin)
Shanghai	上海 (Shanhai); (Shanhai)
Shinto	神道 (しんとう, shintō)
Siberia	シベリア (Shiberia); 西比利亜
Sicily	シチリア (Shichiria)
Singapore	シンガポール (Shingapōru)
Slovakia	スロヴァキア (Surovakia); スロバキア (Surobakia)
Slovene	スロベニア語 (Surobenia-go)
Slovenia	スロヴェニア (Surovenia); スロベニア (Surobenia)
Snow White	白雪 
Sofia	ソフィア (sofia)
Solar System	太陽系 (たいようけい, taiyō-kei)
Somalia	ソマリア (Somaria)
South Africa	南アフリカ (Minamí-Afuriká)
South America	南アメリカ (Minami-Amerika); 南米 (なんべい, Nan-Bei)
South Asia	南アジア (Minami-Ajia); 南亜 (なんあ, Nan-A)
South Korea	韓国 (かんこく, Kankoku)
South Ossetia	南オセチア (Minami Osechia)
Southeast Asia	東南アジア (Tōnan-Ajia)
Soviet Union	ソ連 (So-ren); ソビエト連邦 (Sobiéto Rempō); ソヴェト連邦 (Sovéto Rempō)
Spain	スペイン (Supéin); 西班牙 (Supéin)
Spanish	スペインの (Supein no)
Sparta	スパルタ (suparuta)
Sri Lanka	スリランカ (Suriranka)
Stalin	スターリン (Sutārin)
Sudan	スーダン (Sūdan)
Suez Canal	スエズ運河 (Suezu unga); スエズ地峡 (Suezu chikyō)
Sun	太陽 (たいよう, taiyō)
Sunday	日曜日 (にちようび, nichiyōbi)
Suriname	スリナム (Surinamu)
Sweden	スウェーデン (Suwēden)
Swedish	スウェーデン語 (Suwēden-go)
Switzerland	スイス (Suisu); 瑞西
Syria	シリア (Shiria)
Taipei	台北 (タイペイ, Taipei, たいほく, Taihoku); タイペイ (Taipei); タイベイ (Taibei)
Taiwan	台湾 (たいわん, Taiwan)
Tajikistan	タジキスタン (Tajikisutan)
Tallinn	タリン (Tarin)
Tanganyika	タンガニーカ湖
Tanzania	タンザニア (Tanzania)
Tbilisi	トビリシ (Tobirishi)
Tehran	テヘラン (Teheran)
Tel Aviv	テルアビブ (Teru-Abibu)
Telugu	テルグ語 (テルグご, terugu-go)
Ten Commandments	モーセの十戒 (モーセのじっかい, mōse no jikkai)
Thai	タイ語 (Tai-go)
Thailand	タイ (Tai); タイ国 (Tai-koku); 泰国 (たいこく, Taikoku)
The Hague	ハーグ (Hāgu); デン・ハーグ (Den-Hāgu)
Thursday	木曜日 (もくようび, mokuyōbi)
Transnistria	沿ドニエストル共和国 (えんドニエストルきょうわこく, en-Doniesutoru-kyōwakoku); 沿ドニエストル (En-Doniesutoru)
Transylvania	トランシルヴァニア (Toranshiruvania)
Tuesday	火曜日 (かようび, kayōbi)
Tunisia	チュニジア (Chunijia)
Turkey	トルコ (Toruko)
Turkish	トルコ語 (toruko-go)
Turkmenistan	トルクメニスタン (Torukumenisutan)
USA	アメリカ (Amerika); USA; 米国 (べいこく, Beikoku); 米 (Bei-); ユー・エス・エー (yū-esu-ē)
USSR	ソ連 (それん, Soren)
Uganda	ウガンダ (Uganda)
Ukraine	ウクライナ (Ukuraina)
Ukrainian	ウクライナ語 (Ukuraina-go)
United Arab Emirates	アラブ首長国連邦 (アラブしゅちょうこくれんぽう, Arabu shuchōkoku renpō)
United Kingdom	英国 (えいこく, Eikoku); イギリス (igirisu); グレートブリテンおよび北アイルランド連合王国 (Gurēto Buriten oyobi Kita-Airurando rengō ōkoku); 連合王国 (れんごうおうこく, Rengō ōkoku)
United States	合衆国 (Gasshūkoku); アメリカ合衆国 (Amerika Gasshūkoku); 米国 (べいこく, Béikoku); アメリカ (Amerika)
United States of America	米国 (べいこく, Béikoku); アメリカ合衆国 (アメリカがっしゅうこく, Amerika Gasshūkoku); 米 (べい, Bei-); (Amerika)
Uranus	天王星 (てんのうせい, Tennōsei), ウラヌス ('uranusu')
Uzbekistan	ウズベキスタン (Uzubekisutan)
Valkyrie	ヴァルキリー (wārukirī), 戦乙女 (いくさおとめ ikusaotome), 戦女神 (いくさめがみ ikusamegami)
Vatican City	バチカン (Bachikan); 法王庁 (ほうおうちょう, Hōōchō)
Venezuela	ベネズエラ (Benezuera); ベネスエラ (Benesuela); ヴェネズエラ (Venezuera)
Venus	ヴィーナス (Vīnasu); ウェヌス (Wenusu)
Victory Day	戦勝記念日 (せんしょうきねんび, senshō kinenbi)
Vienna	ウィーン (Wīn)
Vietnam	ベトナム (Betonamu)
Vishnu	ヴィシュヌ (Vishunu); ビシュヌ (Bishunu)
Wales	ウェールズ (Wēruzu)
Warsaw	ワルシャワ (Warushawa)
Wednesday	水曜日 (すいようび, suiyōbi)
Western Europe	西ヨーロッパ; (nishi yōroppa)
Western Sahara	西サハラ (Nishi-Sahara)
White House	ホワイトハウス (Howaitohausu)
White Sea	白海 (はっかい, Hakkai)
Wikipedia	ウィキペディア (Wikipedia)
Wiktionary	ウィクショナリー (Wikushonarī)
Wiktionary:Usability/flag	(Jpan'旗) ((Jpan'はた), hata)
William	ウィリアム (Wiriamu)
Wroclaw	ヴロツワフ (Vurotsuwafu)
Yangon	ヤンゴン (Yangon)
Yangtze	長江 (ちょうこう, chōkō); 揚子江 (ようすこう, yōsukō)
Yaoundé	ヤウンデ (Yaunde)
Yellow Sea	黄海 (こうかい, Kōkai)
Yemen	イエメン (Iemen)
Yerevan	エレバン (Ereban)
Yugoslavia	ユーゴスラビア (Yūgosurabia); ユーゴスラヴィア (Yūgosuravia)
Zagreb	ザグレブ (Zagurebu)
Zambia	ザンビア (Zanbia)
Zoroastrianism	ゾロアスター教
aardvark	ツチブタ (tsuchibuta); アリクイ (arikui)
abacus	算盤; そろばん (soroban)
abandon	断念する (だんねんする, dannensuru); 止める (yameru)
abbot	僧正 (sōjō)
abdomen	腹 (はら, hara), 腹部 (ふくぶ, fuku-bu)
accordion	アコーデオン (akōdeon), 手風琴 (てふうきん, tefūkin)
acorn	どんぐり (donguri)
actinium	アクチニウム (akuchiniumu)
actor	俳優 (はいゆう, haiyū); 役者 (やくしゃ, yakusha); 女優 (じょゆう, joyū)
address	住所 (じゅうしょ, jūsho); 宛名 (あてな, atena)
adjective	形容詞; 形容する (keiyō-suru)
admiration	賞賛 (しょうさん, shōsan); 感心 (かんしん, kanshin)
adverb	副詞 (ふくし, fukushi)
advertisement	広告 (こうこく, kōkoku); CM (シーエム, shī-emu)
aeroplane	飛行機 (ひこうき, hikōki); 航空機 (こうくうき, kōkūki)
after	後 (あとに, ato-ni)
afternoon	午後 (ごご, gogo)
again	又; また (mata); 再び (ふたたび, futatabi); もう一度 (mō ichido); あらためて (aratamete)
age	年齢 (ねんれい, nenrei); (とし, toshi)
aggressive	積極的 (せっきょく てき, sekkyoku teki); 侵略的な (shinryakuteki na); 攻撃的な (kōgekiteki na)
agriculture	農業 (のうぎょう, nōgyō)
air	空気 (くうき, kūki); エア (ea)
aircraft	航空機 (こうくうき, kōkūki); 飛行機 (ひこうき, hikōki)
airplane	飛行機 (ひこうき, hikōki); 航空機 (こうくうき, kōkūki)
airport	空港 (くうこう, kūkō)
al	アルカーイダ (Arukāida)
alcohol	アルコール (arukōru); 酒 (さけ, sake)
algorithm	アルゴリズム (arugorizumu); 演算手順 (えんざんてじゅん, enzantejun)
alive	生きる (ikite iru)
all	全て (すべて, subete); あらゆる (arayuru); 全体 (ぜんたい, zentai); 全 (ぜん, zen-)
all rights reserved	著作権を所有します (ちょさくけんをしょゆうします, chosaku-ken-o shoyū shimasu)
alligator	わに (wani); ワニ (wani)
almond	アーモンド (āmondo)
almost	ほとんど (hotondo)
alphabet	アルファベット (arufabetto); 文字 (もじ, moji)
already	既に (すでに, súde-ni); もう (mō); もはや (mohaya); とっくに (tokku-ni)
also	も (mo); また (mata); さらに (sara-ni); にも (nimo)
aluminium	アルミニウム (aruminiumu)
always	いつも (itsu-mo)
am	です (desu)
amber	琥珀 (こはく, kohaku)
ambulance	救急車 (きゅうきゅうしゃ, kyūkyūsha)
americium	アメリシウム (amerishiumu)
ampersand	アンパサンド (ampasando); アンド (ando)
an	'not used'
anal sex	アナルセックス (anarusekkusu); 肛門性交 (こうもんせいこう, kōmon seikō)
anarchism	アナキズム (anākizumu)
anchor	錨 (いかり, ikari)
and	然して (そして, soshite)
angel	天使 (てんし, tenshi); 天の使い (てんのつかい, ten-no tsukai); エンゼル (enzeru)
anger	(fundo, funnu)怒気 (doki)
angry	怒る (おこった, okotta)
animal	動物 (どうぶつ, dōbutsu)
anime	アニメ (anime); アニメーション (animēshon)
ankle	足首 (あしくび, ashikubi); 踝 (くるぶし, kurubushi)
answer	答え (こたえ, kotae)
ant	蟻 (あり, arí); アリ (arí)
anthrax	炭疽症 (たんそしょう, tansoshō)
antimony	アンチモン (anchimon), アンチモニー (anchimoni)
antonym	対義語 (たいぎご, taigigo); 反意語 (はんいご, han'igo); 反対語 (はんたいご, hantaigo)
anus	肛門 (こうもん, kōmon)
anvil	金床 (かなとこ, kanatoko)
apple	林檎 (りんご, ringo); りんご (ringo)
apple tree	林檎の木 (りんごのき, ringo no ki)
apricot	杏子 (あんず, anzu)
archaeology	考古学 (こうこがく, kōkogaku)
architect	建築家 (けんちくか, kenchikuka)
architecture	建築 (けんちく, kenchiku); 建築学 (けんちくがく, kenchikugaku)
argent	銀 (gin)
argon	アルゴン (arugon)
arm	腕 (うで, udé)
armpit	脇の下 (waki no shita)
army	陸軍 (りくぐん, rikugun); 軍隊 (ぐんたい, guntai)
arrow	矢 (や, ya)
arsenic	ヒ素 (ひそ, hiso)
artichoke	朝鮮薊 (chōsen azami); アーティチョーク (ātichōku)
article	記事 (きじ, kiji), 論文 (ろんぶん, ronbun)
ash	灰 (はい, hai)
ask	頼む (たのむ, tanomu)
ass	尻 (しり, shiri); お尻 (おしり, o-shiri)
astatine	アスタチン (asutachin)
asteroid	小惑星 (しょうわくせい, shōwakusei); 星状体 (せいじょうたい, seijōtai)
astronomical unit	天文単位 (てんもんたんい, tenmon tan'i)
astronomy	天文学 (てんもんがく, tenmongaku)
astrophysics	宇宙物理学 (うちゅうぶつりがく, uchūbutsurigaku)
at	で (de), に (ni)
at sign	アットマーク (atto māku); 単価記号 (たんかきごう, tanka kigō)
atheism	無神論 (むしんろん, mushinron)
atom	原子 (げんし, genshi)
aubergine	茄子 (nasu)
aunt	おば (oba); 叔母 (おば, oba); 伯母 (おば, oba)
autumn	秋 (あき, aki)
avalanche	雪崩 (なだれ, nadare)
axe	斧 (おの, ono); アックス (akkusu)
axis	軸 (じく, jiku)
baby	赤ちゃん (あかちゃん, akachan); 赤ん坊 (あかんぼう, akanbō); 嬰児 (eiji); 幼児 (yōji)
babysitter	ベビーシッター (bebīsittā); 子守 (こもり, komori)
back	背 (せ, se); 背中 (せなか, senaka); 背面 (はいめん, haimen)
bad	悪い (わるい, warui)
badger	アナグマ (anaguma); 穴熊 (あなぐま, anaguma)
bag	鞄 (かばん, kaban); 袋 (ふくろ, fukuró)
bagpipes	バグパイプ (bagupaipu)
bakery	パン屋 (ぱんや, panya)
balcony	バルコニー (barukonī)
bald	禿げ (ハゲ, hage)
balloon	風船 (ふうせん, fūsen)
banana	バナナ (bánana)
bank	銀行 (ぎんこう, ginkō)
barcode	バーコード (bākōdo)
barium	バリウム (bariumu)
bark	樹皮 (じゅひ, juhi), 木の皮 (きのかわ, ki no kawá)
barley	大麦 オオムギ (oomugi)
barn owl	メンフクロウ (めんふくろう, men-fukurō)<!-- 面梟 not sure about kanji - kana is the usual way to write it -->
basalt	玄武岩 (げんぶがん, genbugan)
baseball	野球 (やきゅう, yakyū)
basket	篭 (かご, kago); (basuketto)ざる (zaru)
basketball	バスケットボール (basukettobōru); バスケ (basuke)
bat	蝙蝠 (こうもり, kōmori); コウモリ (kōmori)
bathroom	風呂場 (ふろば, furoba); 浴室 (よくしつ, yokushitsu)
battery	電池 (でんち, denchi); バッテリー (batterī)
battle	戦い; (tatakai) (ikusa)戦闘 (せんとう, sentō)
bay	湾 (わん, wan)
be	です (desu); である (dearu); だ (da)
beach	浜 (はま, hama); ビーチ (bīchi); 海岸 (かいがん, kaigan)
beak	嘴 (くちばし, kuchibashi)
bean	豆 (まめ, mamé)
bear	熊 (くま, kuma); クマ (kuma)
beard	顎鬚 (あごひげ, agohige); あごひげ (agohige)
beautiful	美しい (うつくしい, utsukushii); 綺麗; きれい (kirei); 素敵 (すてき, suteki)
beauty	美しい (うつくしさ, utsukushisa); 美 (び, bi)
beaver	ビーバー (bībā); 海狸 (かいり, kairi, うみだぬき, umidanuki)
because	なぜなら (názenara); だって (datte); から (kara); ので (node)
become	なる (...-ni naru); なる (...-to naru); 成る (なる, naru)
bed	ベッド (beddo); 寝床 (ねどこ, nedoko)
bedroom	寝室 (しんしつ, shinshitsu)
bee	蜂 (はち, hachi); 蜜蜂 (みつばち, mitsubachi)
beech	ブナ, ぶな (buna)
beef	牛肉 (ぎゅうにく, gyūniku); ビーフ (bīfu)
beer	ビール (bīru)
beetle	甲虫 (kōchū)
before	前 (...のまえに, ...-no mae-ni)
begin	始める (はじめる, hajimeru); 開始する (かいしする, kaishi-suru); (はじまる, hajimaru)
behind	後ろ (-no ushiro-ni)
bell	(Jpan'鐘) ((Jpan'かね), kane), (Jpan'鈴) ((Jpan'すず), suzu), (Jpan'ベル) (beru)
belly	胃 (い, i); お腹 (おなか, o-naka); 腹 (はら, hara)
belt	ベルト (beruto)
berkelium	バークリウム (bākuriumu)
berry	ベリー (berī); 木の実 (きのみ, ki-no mi); 果実 (かじつ, kajitsu)
beryllium	ベリリウム (beririumu)
better	もっといい (motto ii); より良い (yoriyoi)
bicycle	自転車 (じてんしゃ, jiténsha); チャリンコ (charinko)
big	大きい (おおきい, ōkíi)
bill	嘴 (くちばし, kuchibashi)
billion	十億 (じゅうおく, jū-oku)
biochemistry	生化学 (seikagaku)
biology	生物学 (せいぶつがく, seibutsugaku)
bipolar disorder	双極性障害
bird	鳥 (とり, tori); 鳥類 (ちょうるい, chōrui)
birth	出産 (しゅっさん, shussan)
birthday	誕生日 (たんじょうび, tanjōbi); バースデー (bāsudē)
biscuit	ビスケット (bisuketto)
bishop	ビショップ 
bismuth	ビスマス (bisumusu)
bitch	雌犬 (めすいぬ, mesuinu); いけいけ (ikeike)
bite	噛む (かむ, kamu)
bitter	(Jpan'苦い) ((Jpan'にがい), nigai)
black	黒 (くろ, kuro)
black hole	ブラックホール (burakkuhōru)
blanket	毛布 (もうふ, mōfu)
bleed	出血する (しゅっけつする, shukketsu suru), 血を流す (ちをながす, chi o nagasu)
bless you	お大事に (おだいじに, o-daiji ni)
blind	視覚障害者 (shikaku-shōgaisha); 目の見えない (me-no mienai); 盲目 (もうもく, mōmoku); 盲 (mekura)
blog	ブログ (burogu)
blood	血 (ち, chi); 血液 (けつえき, ketsueki)
blue	青 (あお, ao)
boar	野猪 (yacho), 猪 (いのしし, inoshishi)
boat	舟 (ふね, fúne); ボート (bōto)
body	体 (からだ, karada); 身体 (しんたい, shintai)
bohrium	ボーリウム (bōriumu)
bomb	爆弾 (ばくだん, bakudan)
bon appétit	頂きます (いただきます, itadakimasu); どうぞめしあがれ (dōzo meshiagare)
bon voyage	どうぞご無事で (dōzo go-buji-de); 道中ご無事で (dōchū go-buji-de); ご機嫌よう (go-kigen-yō); よい旅を (よいたびを, yoi tabi-o); 一路平安を祈る (いちろへいあんをいのる, ichiroheian-o inoru)
bone	骨 (ほね, hone)
book	本 (ほん, hon)
bookshop	本屋 (ほんや, hon'ya); 書店 (しょてん, shoten)
boot	ブーツ (būtsu)
boron	ホウ素 (ほうそ, hōso); 硼素
bottle	瓶 (びん, bin)
bow	弓 (ゆみ, yumi)
box	箱 (はこ, hako)
boy	男の子 (おとこのこ, otoko-no-ko); 少年 (しょうねん, shōnen); 坊や (ぼうや, bōya)
bra	ブラ (bura); ブラジャー (burajā)
brain	脳 (のう, nō); 脳髄 (のうずい, nōzui)
branch	枝 (えだ, eda)
brave	勇敢 (yūkan-na); 勇気 (yūki aru); 勇猛 (yūmō-na)
bread	パン (pan)
break	割れる (wareru), 散らばる (chirabaru)
breakfast	(Jpan'朝食) ((Jpan'ちょうしょく), chōshoku), (Jpan'朝御飯) ((Jpan'あさごはん), asa-gohan)
breast	胸 (むね, mune'muné), 乳房 (ちぶさ, chibusa; or にゅうぼう, nyūbō)
breathe	呼吸する (kokyū-suru); 息をする (iki-o suru); 吐く (haku)
brick	煉瓦 (れんが, renga); れんが (renga)
bride	花嫁 (hanayome); 新婦 (shinpu); 嫁 (yome)
bridge	橋 (はし, hashi)
bromine	臭素 (しゅうそ, shūso)
broom	箒 (ほうき) (houki)
brother	兄弟 (きょうだい, kyōdai); あに (あに, ani); お兄さん (おにいさん, oniisan); おとうと (おとうと, otōto)
brown	茶色い (ちゃいろい, chairoi); 褐色 (かっしょく, kasshoku)
brush	刷子 (さっし, sasshi, はけ, hake); ブラシ (burashi)
bucket	バケツ (baketsu)
buffalo	野牛 (yagyū)
building	建築 (けんちく, kenchiku); 建造 (けんぞう, kenzō); 建設 (けんせつ, kensetsu)
bull	雄牛 (おうし, oushí)
bullet	弾丸 (だんがん, dangan); 弾 (たま, tama)
bumblebee	円花蜂, 丸花蜂 (まるはなばち, maruhanabachi)
burn	燃える (moeru); (yakeru)
bus	バス (basu)
busy	忙しい (いそがしい, isogashii); 使用中 (しようちゅう, shiyō-chū)
but	が (ga); でも (demo)
butcher	肉屋 (にくや, nikuya)
butter	バター (batā); 乳酪 (にゅうらく, nyūraku)
butterfly	蝶々 (ちょうちょう, chōchō); 蝶 (ちょう, chō); 蝴蝶 (こちょう, kochō); バタフライ (batafurai)
buy	買う (かう, kau); 購入する (こうにゅうする, kōnyū-surú)
cabbage	キャベツ (kyabetsu)
cactus	サボテン (saboten), シャボテン (shaboten)
cadmium	カドミウム (kadomiumu)
caesium	セシウム (seshiumu)
café	カフェー (kafē); コーヒー店 (kōhī-ten); コーヒーハウス (kōhī-hausu); 喫茶店 (きっさてん, kissaten)
cake	(kēki)
calcium	カルシウム (karushiumu)
calendar	暦 (こよみ, koyomi); カレンダー (karendā)
calf	子牛 
californium	カリホルニウム (karihoruniumu)
camel	駱駝; ラクダ (rakuda)
can	できる (dekíru); れる (-reru); られる (-rareru)
canal	運河 (うんが, unga)
canary	カナリア 
cancer	癌 (がん, gan); 悪性腫瘍 (あくせい しゅよう, akusei shuyō); 悪性新生物 (あくせいしんせいぶつ, akusei shinseibutsu)
candle	蝋燭 (ろうそく, rōsoku)
cannabis	大麻 (たいま, taima); インド大麻 (Indo-taima)
canyon	峡谷 (きょうこく, kyōkoku)
capital	資本 (しほん, shihon)
capital city	首都 (しゅと, shuto); 都 (miyako)
capitalism	資本主義 (しほんしゅぎ, shihonshugi)
car	車 (くるま, kurumá); 自動車 (じどうしゃ, jidōsha)
carbon	炭素 (たんそ, tanso)
carpenter	大工 (だいく, daiku)
carpet	カーペット (kāpetto); 絨毯 (じゅうたん, jūtan)
carrot	ニンジン (ninjin), 人参 (にんじん, ninjin)
carry	持って行く (もっていく, motte-iku); 運ぶ (はこぶ, hakobu)
castle	城; しろ; shiro
cat	ネコ (ねこ, neko)
caterpillar	毛虫 (けむし, kemushi); 芋虫 (いもむし, imomushi)
cauliflower	カリフラワー (karifurawā)
cave	洞窟 (どうくつ, dōkutsu)
cedar	ヒマラヤスギ (himarayasugi)
ceiling	天井 (てんじょう, tenjō)
cell	細胞 (さいぼう, saibō)
cell phone	携帯電話 (keitai-denwa); (keitai)セルホーン (seru hoon); セルフォン (seru fon)
center	中心 (ちゅうしん, chūshin); 間 (aida)
centimetre	センチメートル (senchimētoru); センチ (senchi)
centipede	ムカデ (mukade); 百足 (むかで, mukade); 蜈蜙; 蝍蛆 
century	世紀 (せいき, seiki)
cerium	セリウム (seriumu)
chain	鎖 (くさり, kusari), チェーン (chēn)
chair	椅子 (いす, isu); ソファ (sofa)
change	変化 (へんか, henka); 変更 (へんこう, henkō)
chaos	混乱 (こんらん, konran); 無秩序 (むちつじょ, muchitsujo); 混沌 (こんとん, konton)
chapter	章 (しょう, shō)
chase	追いかける; (ou)
cheap	安い 
cheek	頬 (ほほ, hoho; ほお, hoo)
cheers	乾杯 (かんぱい, kanpai)
cheese	チーズ (chiizu); 乾酪 (かんらく, kanraku)
cheetah	チーター (chītā)
chemistry	化学 (かがく, kagaku)
cheque	小切手 (こぎって, kogitte)
cherry	(dark cherry) チェリー (cherī), (Japanese cherry) さくらんぼ (sakuranbo)
chess	西洋将棋 (せいようしょうぎ, seiyōshōgi); チェス (chesu)
chest	胸 (むね, mune); 胸郭 (きょうかく, kyōkaku)
chestnut	栗 (kuri)
chew	噛む (かむ, kamu)
chicken	鶏 (にわとり, ニワトリ, 'niwatori')
child	子供 (こども, kodomo), 子 (こ, ko), 未成年 (mi-seinen)
chimpanzee	チンパンジー (chinpanjī); 黒猩々 (くろしょうじょう, kuroshōjō)
chin	顎 (あご, ago)
chlorine	塩素 (えんそ, enso)
chocolate	チョコレート (chokorēto); チョコ (choko)
choice	選択 (せんたく, sentaku)
choir	聖歌隊 (せいかたい, seikatai); 合唱団 (がっしょうだん, gasshōdan)
choose	選ぶ (えらぶ, erabu)
chord	和音 (わおん, waon)
chromium	クロム (kuromu)
church	教会 (きょうかい, kyōkai)
cigarette	タバコ (tabako); 煙草 (たばこ, tabako); 紙巻き煙草 (かみまきたばこ, kamimaki tabako); 紙巻きタバコ
cinema	映画館 (えいがかん, eigakan)
circle	円 (えん, en), 丸 (まる, maru)
city	都市 (とし, toshi); 都会 (とかい, tokai); 町 (まち, machi)
clarinet	クラリネット (kurarinetto)
clay	粘土 (ねんど, néndo)
clean	綺麗な (きれいな, kirei-na); 清潔 (せいけつな, seiketsu-na)
clitoris	クリトリス (kuritorisu); 陰核 (いんかく, inkaku)
clock	時計 (とけい, tokei)
close	閉める (しめる, shimeru); 閉まる (しまる, shimaru); 閉じる (とじる, tojiru)
clothes	衣服 (いふく, ifuku); 服 (ふく, fuku); 衣類 (いるい, irui)
cloud	雲 (くも, kumo); 靄 (もや, moya); 霧 (きり, kiri)
coast	(Jpan'海岸) (かいがん) (kaigan)
cobalt	コバルト (kobaruto)
cock	コケコッコ (kokekokko)
cockroach	ゴキブリ (gokiburi)
coconut	ココナッツ (kokonattsu); 椰子の実 (やしのみ, yashi no mi)
coffee	珈琲; コーヒー (kōhī)
coffin	棺 (ひつぎ, hitsugi)
coin	硬貨 (こうか, kōka), コイン (koin)
cold	風邪 (かぜ, kaze); 感冒 (かんぼう, kanbō)
cold war	冷戦 (れいせん, reisen)
color	色 (いろ, iro); 色彩 (しきさい, shikisai)
columbine	オダマキ (odamaki)
comb	櫛 (くし, kushi)
come	来る (くる, kúru); いらっしゃる (irassharu); おいでになる (o-ide-ni naru); 参る (まいる, mairu)
common gull	カモメ; 鴎 (kamome)
communism	共産主義 (きょうさんしゅぎ, kyōsanshugi)
compass	方位磁石 (ほういじしゃく, hōi-jíshaku); 羅針盤 (らしんばん, rashimbán); コンパス
computer	コンピュータ (kompyūta); 電子計算機 (でんしけいさんき, denshi-keisanki)
computer language	計算機言語 (keisanki-gengo); プログラミング言語 (puroguramingu gengo)
comrade	同志 (どうし, dōshi)
concrete	コンクリート (konkurīto)
condom	コンドーム (kondōmu)
conjunction	接続詞 (setsuzokushi)
connective tissue	結合組織 (ketsugou soshiki)
conscience	良心 (りょうしん, ryōshin)
continent	大陸 (たいりく, tairikú)
conversation	会話; かいわ (kaiwa); 談話 (tanwa); 対話 (taiwa); 対話 (taiwa); 話し (hanashi); カンバセーション (kanbāsēshon)
copper	銅 (どう, dō; あかがね, akagané: "red metal")
corn	トウモロコシ (tōmorokoshi)
corpse	死体 (したい, shitai); 屍体 (したい, shitai)
corridor	廊下 (ろうか, rōka); 回廊 (かいろう, kairō)
cotton	綿 (わた, wata), コットン (kotton)
cough	咳をする (せきをする, seki o surú)
count	数える (かぞえる, kazoeru)
country	田舎 (いなか, inaka)
courage	勇気 (ゆうき, yūki), 度胸 (どきょう, dokyō)
cow	雌牛 (めうし, meushi); 牛 (うし, ushi)
crab	カニ (kani); 蟹 (かに, kani)
crane	鶴 (つる, tsuru)
cream	クリーム (kurīmu)
cricket	蟋蟀 (コオロギ, kōrogi)
crime	犯罪 (はんざい, hanzai); 罪 (つみ, tsumi); 犯行 (はんこう, hankō)
crocodile	鰐; ワニ (wani)
crossword	クロスワードパズル
crow	烏; カラス (karasu)
cruel	残酷 (ざんこく, zankoku); 酷い (ひどい, hidoi); 惨い (むごい, mugoi)
cry	泣く (なく, naku)
crystal	結晶 (けっしょう, kesshō)
cube	立方体 (りっぽうたい, rippōtai)
cuckoo	カッコウ (kakkō)
cucumber	胡瓜 (きゅうり, 'kyūri')
culture	文化 (búnka)
cunt	まんこ (manko); おまんこ (omanko); ぼぼ (bobo); へへ (hehe); ほと (hoto); おめこ (omeko); おそそ (ososo); みと (mito); つび (tsubi)
cup	カップ (kappu); (koppu)茶わん (ちゃわん, chawan)
curium	キュリウム (kyuriumu)
current	流れ (nagare)
curse	呪い (のろい, noroi)
cycling	サイクリング (saikuringu)
dance	踊る (おどる, odoru); ダンス (dansu-surú)
dangerous	危険 (きけん, kiken); 危ない (あぶない, abunai)
dark	暗い (kurai)
dark matter	暗黒物質 (あんこくぶっしつ, ankokubbushitsu)
darkness	闇 (やみ, yami); 暗黒 (あんこく, ankoku)
data	データ (dēta); 資料 (shiryō); 事実 (jijitsu); 情報 (jōhō)
date	デート (dēto)
date palm	ナツメヤシ (natsumeyashi)
daughter	嫁 (よめ, yome)
day	日 (ひ, hi)
dead	死んだ (shinda)
deaf	聴覚障害者 (chōkaku-shōgaisha); 耳の聞こえない (mimi-no kikoenai); 聾 (tsunbo); (ろうしゃ, rōsha)
dear	高い (たかい, takai)
death	死 (し, shi); 死亡 (しぼう, shibō)
decade	十年 (じゅうねん, jūnen)
deer	鹿 (しか, shika); シカ (shika)
delicious	美味しい (おいしい, oishii); おいしい (oishii); 旨い (うまい, umai)
democracy	民主主義 (minshushugi)
demon	悪魔 (akuma), 鬼 (oni)
dentist	歯医者 (はいしゃ, haisha); 歯科医 (しかい, shikai)
desert	砂漠; 沙漠 (さばく, sabaku); 荒野 (こうや, kōya, あらの, arano)
devil	悪魔 (あくま, akuma); 鬼 (おに, oni); 悪鬼 (あっき, akki)
dew	露 (tsuyu)
dialect	方言 (ほうげん, hōgen); 弁 (-べん, -ben)
diary	日記; にっき (nikki)
dick	ちんこ (chinko); ちんぽ (chinpo); ちんちん (chinchin); おちんちん (o-chinchin); ぽこちん (pokochin); まら (mara); ちんぽこ (chinpoko)
dictionary	辞書 (じしょ, jisho); 字書 (じしょ, jisho); 辞典 (じてん, jiten); 字典 (じてん, jiten); 字引 (じびき, jibiki)
die	賽子; 骰子 (さいころ, saikoro)
difficult	難しい (むずかしい, muzukashii); 困難 (こんなんな, konnan-na)
dig	掘る (ほる, horu)
dining room	食堂 (しょくどう, shokudō)
dinosaur	恐竜 (きょうりゅう, kyōryū)
dirty	汚い (きたない, kitanai)
discussion	議論 (ぎろん, giron); 討論 (とうろん, tōron)
disease	病気 (びょうき, byōki); 疾病 (しっぺい, shippei)
do	する (surú); やる (yaru); なさる (nasaru); 致す (いたす, itasu)
do you speak English	英語を話せますか (Eigo-o hanasemasu ka?)
doctor	博士 (はくし, hakushi, はかせ hakase)
documentation	に関する文書
dog	犬 (いぬ, inu)
doll	人形 (にんぎょう, ningyō)
dollar	ドル (doru)
dolphin	海豚; イルカ (iruka)
donation	寄付 (きふ, kifu)
donkey	驢馬 (ろば, roba)
door	戸 (と, to); 扉 (とびら, tobira); ドア (dóa)
dormouse	ヤマネ (yamane)
doubt	不審 (ふしん, fushin), 疑い (うたがい, utagai), 疑問 (ぎもん, gimon)
dove	鳩 (はと, hato)
dozen	ダース (dāsu)
dragon	竜 (りゅう, ryū; りょう, りょう; たつ, tatsu); (doragon)
dragonfly	蜻蛉 (とんぼ, tonbo)
dream	夢を見る (ゆめをみる, yume o miru); 夢見る (..をゆめみる, ...o yume-miru)
dress	ワンピース (wanpīsu); ドレス (doresu); 服 (ふく, fuku)
drink	お酒 (osake)
drop	雫 (shizuku)
drum	太鼓 (たいこ, taiko), ドラム (doramu)
drunk	酔っ払い (よっぱらい, yopparai); 酔い (よい, yoi)
dry	乾く (かわいた, kawaita)
dubnium	ドブニウム (dobuniumu)
duck	アヒル (ahiru); 鴨; カモ (kamo)
dust	埃 (ほこり, hokori)
duty	義務(ぎむ, gimu)
dynamite	ダイナマイト (dainamaito)
dyslexia	失読症 (shitsudokushō)
dysprosium	ジスプロシウム (jisupuroshiumu)
e	電子メール (でんしメール, denshi mēru); Eメール (ī mēru); イーメール (īmēru); メール (mēru)
e.g.	例 (rei)
each	それぞれの (sorezore no)
eagle	鷲 (わし, washi)
ear	耳 (みみ, mimí)
early	早く (はやく, hayaku)
earth	地 (ち, chi)
earthquake	地震 (じしん, jishin)
earthworm	ミミズ (mimizu)
east	東 (ひがし, higashi)
easy	簡単 (かんたん, kantan); 易い (やすい, yasui); (ようい, yōi)
eat	食べる (たべる, taberu); 食う (くう, kuu); 食事 (しょくじする, shokuji-surú); 召し上がる (めしあがる, meshi-agaru); 頂く (いただく, itadaku)
echo	反響 (はんきょう, hankyō); こだま (kodama); エコー (ekō)
eco	生 (sei), probably iko- on non-Japanese words
ecology	生態学 (せいたいがく, seitaigaku)
economics	経済学 (keizai-gaku)
education	教育 (きょういく, kyōiku)
eel	ウナギ, 鰻 (unagi)
egg	卵 (たまご, tamago); 玉子 (たまご, tamago)
eight	(やっつ, やつ, yattsu, yatsu)８
eighteen	十八 (jū-hachi)
eighth	八番目 (はちばんめ, hachiban-me)
eighty	八十 (はちじゅう, hachi-jū)
einsteinium	アインスタイニウム (ainsutainiumu)
ejaculation	射精 (shasei)
elbow	肘 (ひじ, hiji)
electricity	電気 (でんき, denki)
electromagnetism	電磁気学 (denjikigaku)
electron	電子 (でんし, denshi)
electronics	電子工学
elephant	象 (ぞう, zō)
eleven	十一 (じゅういち, jū-ichi)
elf	妖精 (ようせい, yōsei); エルフ (erufu)
embassy	大使館 ( たいしかん, taishikan)
emperor	帝王 (teiō); (kōtei) (tennō)
empty	空 (からの, kara-no); 空っぽ (からっぽな, karappo-na)
encyclopedia	百科事典 (ひゃっかじてん, hyakkajiten); 大事典 (だいじてん, dai-jiten)
end	終了 (しゅうりょう, shūryō); 終わり (おわり, owari); 端 (はし, hashi)
enemy	敵 (teki, kataki)
energy	エネルギー (enerugī)
enjoy your meal	頂きます (いただきます, itadakimasu); どうぞめしあがれ (dōzo meshiagare)
enter	入る (はいる, hairu)
epithelium	上皮細胞 (jōhi saibō); 上皮 (じょうひ, jōhi)
equation	方程式 (ほうていしき, hōteishiki)
erbium	エルビウム (erubiumu)
erection	エレクション (erekushon); 勃起 (ぼっき, bokki)
erotic	エロチック (erochikku); 色っぽい (いろっぽい, iroppoi)
etymology	語源 (ごげん, gogen)
euro	ユーロ (yūro)
europium	ユウロピウム (yūropiumu)
euthanasia	安楽死 (あんらくし, anrakushi); オイタナシー (oitanashī)
evening	夕方 (ゆうがた, yūgata); 夜 (よる, yoru)
event horizon	事象の地平面 (じしょうのちへいめん, romaji jishō no chiheimen)
every	あらゆる (arayuru); 全て (すべての, subete-no); それぞれ (sorezore); おのおの (onoono); 毎 (…goto-no); 毎 (まい-, mai-); 各 (かく, kaku)
everybody	皆さん (みなさん, mina-san); みんな (minna)
everyone	皆さん (みなさん, mina-san); みんな (minna)
everything	全て (subete); すべて (subete); 全部 (zenbu); いずれも (izuremo); どれも (doremo)
expensive	高い (たかい, takai)
expression	表情 (ひょうじょう, hyōjō)
eye	目 (め, me); 眼 (め, me)
eye for an eye, a tooth for a tooth	しっぺ返し (しっぺがえし, shippe-gaeshi); 仕返し (しかえし, shikaeshi)
eyebrow	まゆ,眉 (mayu), まゆ毛,眉毛 (まゆげ, mayuge)
eyelash	睫毛 (まつげ, matsuge)
eyelid	瞼; 眼蓋; 目蓋 (まぶた, mabuta)
face	顔 (かお, kao)
falcon	隼 (はやぶさ, hayabusa); ハヤブサ (hayabusa)
fall	落ちる (おちる, ochiru); 崩れる (くずれる, kuzureru); 落下 (らっかする, rakka-suru); 転ぶ (korobu)
family	親戚 (しんせき, shinseki), 親類 (しんるい, shinrui), 親族 (しんぞく, shinzoku)
fan	扇子 (せんす, sensu)
far	遠い (とおい, tōi); 遥か (はるかな, haruka-na)
farm	農場 (のうじょう, nōjō)
farmer	農夫 (のうふ, nōfu); 農家 (のうか, nōka)
fart	おならをする (onara-o surú); 放屁 (ほうひする, hōhi-surú); 屁をひる (へをひる, he-o hiru); 屁をこく (へをこく, he-o koku)
fast	速い; はやい (hayai)
father	義父 (gifu); 岳父 (gakufu)
fear	恐れる (おそれる, osoreru); 怖る (おそる, osoru)
feather	羽 
federation	連邦 (れんぽう, renpō); 連盟 (れんめい, renmei); 同盟 (どうめい, dōmei)
female	雌 (めす, mesu)
feminism	フェミニズム (feminizumu); 女権拡張論 (じょけんかくちょうろん, jokenkakuchōron)
fermium	フェルミウム (ferumiumu)
ferret	フェレット (feretto)
ferry	フェリー (ferī); 渡し船 (わたしぶね, watashi-bune); 渡船 (とせん, tosen)
fever	熱 (ねつ, netsu); 発熱 (はつねつ, hatsunetsu)
fifteen	十五 (じゅうご, jū-go)
fifth	五番目 (ごばんめ, goban-me)
fifty	五十 (go-jū)
fig	イチジク (ichijiku); 無花果
fight	喧嘩する (けんかする, kenka-suru), 対決 (たいけつする, taiketsu-suru), 戦う / 闘う (たたかう, tatakau)
film	映画 (えいが, eiga)
finger	指 (ゆび, yubí)
fir	樅の木 (もみのき, momi no ki), モミ (momi)
fire	火 (ひ, hi)
first	第一 (だいいち, daiichi); 最初 (さいしょ, saishó); 初めて (はじめて, hajímete); 初 (はつ, hatsu); 一番目 (いちばんめ, ichibanmé)
fish	魚 (さかな, sakana); 魚 (うお, uo)
fist	拳 (こぶし, kobushi)
flag	旗 (はた, hata)
flame	炎 (ほのお, honoo), 火炎 (かえん, kaen)
flea	蚤; ノミ (nomi)
floor	階 (かい, kai)
flour	小麦粉 (こむぎこ, komugikó)
flower	咲く (さく, sakú)
fluorine	フッ素 (fusso)
flute	フルート (furūto)
fly	飛ぶ (とぶ, tobu)
fog	霧 (きり, kiri)
food	食べ物 (たべもの, tabemono); 食物 (しょくもつ, shokumotsu); 食料 (しょくりょう, shokuryō); 飯 (めし, meshi); 食品 (しょくひん, shokuhin); 餌 (えさ, esa)
fool	愚か者 (おろかもの, orokamono); 惚け (ぼけ, boke); 馬鹿 (ばか, baka); 愚者 (ぐしゃ, gusha); あほ (aho); (aho)
foot	口蹄疫 (こうていえき, kōteieki)
football	サッカー (sakkā); 蹴球 (しゅうきゅう, shūkyū)
for example	例えば (たとえば, tatoeba)
forefinger	人差し指 (ひとさしゆび, hitosashiyubi)
forehead	額 (ひたい, hitai); おでこ (odeko)
foreign	外国 (がいこくの, gaikoku-no)
foreigner	外国人 (がいこくじん, gaikokujin); 外人 (がいじん, gaijin)
forest	森 (もり, morí); 森林 (しんりん, shinrín)
forget	忘れる (わすれる, wasureru)
fork	フォーク (fōku)
fortress	要塞 (ようさい, yōsai)
forty	四十 (shi-jū, yon-jū)
fountain	噴水 (ふんすい, funsui)
fourteen	十四 (jū-yon)
fourth	四番目 (よんばんめ, yonban-me)
fox	狐 (きつね, kitsune); キツネ (kitsune); フォックス (fokkusu)
francium	フランシウム (furanshiumu)
free	無料 (むりょう, muryō)
freedom	自由 (じゆう, jiyū)
freedom of speech	言論の自由 (げんろんのじゆう, genron-no jiyū)
friend	友達 (ともだち, tomodachi); 友人 (ゆうじん, yūjin)
friendship	友情 (ゆうじょう, yūjō)
frog	蛙 (かえる, kaeru; かわず, kawazu, historical かはづ)
from	から (...kara)
fruit	果実 (かじつ, kajitsu); 果物 (くだもの, kudámono); フルーツ (furūtsu)
fuck	エッチする (étchi-surú); 犯す (おかす, okasu); ファックする (fakku-surú); やる (yaru)
full	一杯 (いっぱい, ippai); 満々 (まんまん, manman)
fungus	菌類 (きんるい, kinrui); きのこ (kinoko)
future	未来 (みらい, mirai); 将来 (しょうらい, shōrai)
gadolinium	ガドリニウム (gadoriniumu)
galaxy	銀河 (ぎんが, ginga); 銀河系 (ぎんがけい, gingakei); 星雲 (せいうん, seiun)
gall bladder	胆嚢 (たんのう, tannō)
gallium	ガリウム (gariumu)
game	遊び (あそび, asobi); 遊戯 (ゆうぎ, yūgi); ゲーム (gēmu)
garbage	(gomi)
garden	庭園 (ていえん, teien); 庭 (にわ, niwa)
garlic	大蒜 (にんにく, ninnikú)
gas	気体 (きたい, kitai); ガス (gasu)
gasoline	ガソリン (gasorin)
genitive	属格 (ぞっかく, zokkakú); 生格 (せいかく, seikakú)
genocide	集団虐殺 (shūdan-gyakusatsu); ジェノサイド (jenosaido)
geography	地理学 (ちりがく, chirigaku)
geometry	幾何学 (きかがく, kikagaku)
germanium	ゲルマニウム (gerumaniumu)
geyser	間欠泉 (かんけつせん, kanketsusen)
ghost	幽霊 (ゆうれい, yūrei); 亡霊 (ぼうれい, bōrei); 化け物 (ばけもの, bakemono); 死霊 (しりょう, shiryo); 妖怪 (ようかい, yōkai); お化け (obake); 怨霊 (おんりょう, onryō); 幽鬼 (ゆうき, yūki); 魂魄 (こんぱく, konpaku); 精霊 (せいれい, seirei); 妖魔 (ようま, yōma); 魂 (こん, kon, たましい tamashii); 霊 (れい, rei); 変化 (へんげ, henge); 物の怪 (もののけ, mononoke); ゴースト (gōsuto)
giant	巨人 (きょじん, kyojin)
gift	贈り物 (おくりもの, okurimono); 寄贈 (きぞう, kizō); プレゼント (purezento); ギフト (gifuto)
ginger	生姜 (しょうが, shōga)
giraffe	麒麟; キリン (kirin); ジラフ (jirafu)
girl	女の子 (おんなのこ, onná-no-ko); 少女 (しょうじょ, shōjo); 乙女 (おとめ, otome)
give	あげる (agéru); 下さる (くださる, kudasaru); 差し上げる; くれる (kureru)
glacier	氷河 (ひょうが, hyōga)
glass	グラス (gurasu); コップ (koppu)
glove	手袋 (てぶくろ, tebukuro)
glue	糊 (のり, nori)
go	行く (いく, ikú); いらっしゃる (irassharu); 参る (まいる, mairu)
goat	やぎ (yagi)
god	神 (かみ, kami)
gold	金 (きん, kin)
golden eagle	イヌワシ (犬鷲, inuwashi)
golf	ゴルフ (gorufu)
gonorrhea	淋病 (りんびょう, rinbyō)
good	善 (ぜん, zen)
good afternoon	こんにちは (konnichi-wa)
good day	今日は (konnichi wa)
good evening	今晩は (こんばんは, konban-wa)
good luck	頑張って (がんばって！, ganbatte!); がんばれ (ganbare!); 健闘 (けんとう, kenkō); 幸運を (こううんを, kōun-o); 頑張って (がんばってください！, ganbatte kudasai!)
good morning	おはようございます (ohayō gozaimásu); おはよう (ohayō)
good night	おやすみなさい (oyasuminasai); おやすみ (oyasumi)
goodbye	さようなら (sayōnara); 失礼します (しつれいします, shitsurei-shimasu); それでは (sore dewa); では (dewa); じゃあ (jā)
goose	鵝鳥 (がちょう, gachō); ガチョウ (gachō); 雁 (かり, kari)
gooseberry	グーズベリー (gūzuberī)
government	政府 (せいふ, séifu)
grammar	文法 (ぶんぽう, bunpō)
grandchild	孫 (まご, mago)
granddaughter	孫娘 (magomusume)
grandfather	お爺さん ({{t+); 祖父 (sofu); (gaisofu)
grandmother	お婆さん ({{t+); 祖母 (sobo); 外祖母 (gaisobo)
grape	葡萄; ブドウ (budō)
grass	草 (くさ, kusa)
grasshopper	飛蝗 (ばった, batta); バッタ (batta); 蝗 (いなご, inago); きりぎりす (kirigirisu)
graveyard	墓 (はか, 'haka'), 墓地 (ぼち, 'bochi'), 霊園, 墓場 (はかば, 'hakaba')
green	緑 (みどり, midori); 緑色 (みどりいろ, midoriiro)
grey	灰色 (はいいろ, hai-iro); 鼠色 (ねずみいろ, nezumi-iro)
grey heron	アオサギ (aosagi)
guest	客人 (きゃくじん, kyakujin); 客 (きゃく, kyaku); 来客 (らいきゃく, raikyaku)
guilt	有罪 (ゆうざい, yūzai)
guinea pig	モルモット (morumotto); ギニアピッグ (giniapiggu); テンジクネズミ (tenjiku-nezumi)
guitar	ギター (gitā)
gull	鴎 (カモメ, kamome)
gunpowder	火薬 (かやく, kayaku)
gypsy	ジプシー (jipushī)
hafnium	ハフニウム (hafuniumu)
hail	雹 (ひょう, hyō)
hair	毛 (け, ke)
hajj	ハッジ (hajji); メッカ巡礼 (Mekka-junrei)
half	半分 (はんぶん, hanbún)
hammer	金槌 (かなづち, kanazuchi); 槌 (づち, zuchi); ハンマー (hanmā)
hammock	ハンモック (hanmokku)
hamster	ハムスター (hamusutā)
hand	手 (て, te)
hangover	二日酔い (ふつかよい, futsukayoi)
happen	起こる (おこる, okoru); 起る (おこる, okoru)
happiness	幸福 (こうふく, kōfuku); 幸せ (しあわせ, shiawasé); 愉快 (ゆかい, yukai)
happy	幸せ (しあわせな, shiawase-na); 幸福 (こうふくな, kōfuku-na)
happy birthday	お誕生日おめでとうございます (o-tanjōbi omedetō gozaimasu); 誕生日おめでとう (tanjōbi omedetō)
hard drive	ハードディスク (hādodisuku)
hare	野兎 (のうさぎ, no-usagi); 野ウサギ (no-usagi); (usagi)
hassium	ハッシウム (hasshiumu)
hat	帽子 (ぼうし, bōshi); ハット (hatto)
hate	憎む (にくむ, nikumu); 嫌う ({{t); いやである (iya dearu); 大嫌い (daikirai)
hatred	憎悪 (ぞうお, zōo)
have	持つ (もつ, motsu); (aru) (いる)
hawk	鷹; タカ (taka)
hay	干草 (ほしくさ, hoshi-kusa)
hazelnut	ハシバミ (hashibami)
he	彼 (かれ, káre); あの人 (あのひと, ano hito); あの方 (ano kata); その奴 (そのやつ, sono yatsu); 奴 (やつ, yatsu); そいつ (soitsu)
head	頭 (あたま, atama)
health	健康 (けんこう, kenkō); 体 (からだ, karada)
hear	聞く (きく, kiku)
heart	心臓 (しんぞう, shinzō); 心 (こころ, kokoro)
heaven	空 (そら, sora); 天 (てん, ten)
heavy	重い (おもい, omoi)
hedgehog	針鼠 (はりねずみ, harinezumi)
heel	踵 (かかと, kakato); ヒール (hīru)
helicopter	ヘリコプター (herikoputā)
helium	ヘリウム (heriumu)
hell	地獄 (じごく, jigoku); 魔界 (まかい, makai); 奈落 
hello	もしもし (móshi-móshi)
help	助けて (tasukete!)
hemp	麻 (asa)
hen	雌鶏 (mendori); めんどり (mendori)
her	彼女 (かのじょの, kanojo-no)
here	こちらへ (kochira e)
hero	英雄 (えいゆう, eiyū); 勇者 (ゆうしゃ, yūsha)
heron	鷺 サギ (sagi), 白鷺 シラサギ (shirasagi)
hi	こんにちは (konnichi wa); やあ (yā); どうも (do-mo)
hill	丘 (おか, oka)
hippopotamus	河馬; カバ (kaba)
his	彼 (かれの, kare-no)
history	歴史 (れきし, rekishi)
holmium	ホルミウム (horumiumu)
home	家 (いえ, ie, うち, uchi); お住まい (おすまい, osumai)
homophobia	ホモフォビア (homofobia); 同性愛嫌悪 (どうせいあいけんお, dōseiai ken'o)
homosexuality	同性愛 
honey	蜂蜜 ({{t+)
hoof	蹄 (ひづめ, hizume)
hope	希望 (きぼう, kibō), 願望 (がんぼう, ganbō)
horn	角 (つの, tsuno)
horse	馬 (うま, uma); うま (uma); ウマ (uma)
hospital	病院 (びょういん, byōin)
hot	熱い (あつい, atsui)
hotel	ホテル (hoteru); 旅館 (りょかん, ryokan)
hour	時 (じ, ji); 時間 (じかん, jikan)
house	家 (いえ, ie, うち, uchi); 建物 (たてもの, tatemono); 家屋 (kaoku); 一戸建て (いっこだて, ikkodate)
how	どのように (dono-yō-ni); どうやって (dō-yatte); どう (dō)
how are you	お元気ですか (おげんきですか？, ogenki desu ka?); ご機嫌いかがですか (ごきげんいかがですか？, go-kigen ikaga desu ka?)
how many	幾つ; いくつ (ikutsu); 何 (なん, nan)
how much	幾ら (いくら, ikura); いくら (ikura)
how much does it cost	これは幾らですか (kore-wa ikura desu ka?); いくらですか (ikura desu ka?)
hug	ハグ (hagu)
human	人間 (にんげん, ningen); 人類 (じんるい, jinrui); 人 (ひと, hito)
human being	人間 (にんげん, ningen); 人類 (じんるい, jinrui); 人 (ひと, hito)
human rights	人権 (じんけん, jinken)
humanism	ヒューマニズム (hyūmanizumu); 人文主義 (じんぶんしゅぎ, jinbunshugi)
hundred	百 (ひゃく, hyakú)
hungry	(うえた, ueta, かつえた, katsueta)お腹が空いている (おなかがすいている, onaka-ga suite iru)
hunt	狩る (かる, karu)
husband	夫 (おっと, otto); 主人 (しゅじん, shujin); 旦那 (だんな, danna); ご主人 (ごしゅじん, go-shujin)
hydrate	水和物 (すいわぶつ, suiwabutsu)
hydrogen	水素 (すいそ, súiso)
hyena	ハイエナ (haiéna)
ice	氷 (こおり, kōri)
ice cream	アイスクリーム (aisukurīmu); アイス (aisu)
iceberg	氷山 (ひょうざん, hyōzan)
idiot	馬鹿 (ばか, baka); あほ (aho); 白痴 (はくち, hakuchi)
if	もし (móshi...); なら (...nára); ならば (...náraba); だったら (...dáttara); と (...dato); ては (...tewa); えば (...eba)
igneous rock	火成岩 (かせいがん, kaseigan)
ill	病気 (びょうき, byōki)
illness	病気 (びょうき, byōki); 疾病 (しっぺい, shippei)
important	重要 (じゅうような, jūyō-na); 大切 (たいせつな, taisetsu-na)
in	に (...-ni); で (...-de); 中 (...-no naka-de)
index	索引 (sakuin), インデックス (indekkusu), 表題 (hyōdai), 指数 (shisū), 指標 (shihyō), 総目録 (sōmokuroku)
indium	インジウム (injiumu)
information	情報 (じょうほう, jōhō)
injury	傷害 (しょうがい) '(shōgai)'
ink	墨 (すみ, sumi), インク (inku)
insect	昆虫 (こんちゅう, konchū); 虫 (むし, mushi)
insulin	インスリン (insurin); インシュリン (inshurin)
intelligence	知力 (ちりょく, chiryokú)
interesting	面白い (おもしろい, omoshiroi)
internal combustion engine	内燃機関 (ないねんきかん, nainen kikan)
international	国際的 (kokusaiteki)
interpreter	通訳 (つうやく, tsūyaku); 通訳者 (つうやくしゃ, tsūyakusha)
iodine	ヨウ素 (yōso)
iridium	イリジウム (irijiumu)
iron	アイロンをかける (airón wo kakéru)
is	です (desu)
island	島 (しま, shimá)
it	それ (soré)
jellyfish	海月; 水母 (くらげ, kurage); クラゲ (kurage); すいぼ (suibo)
jihad	ジハード (jihādo); 遠征 (ensei)
joy	喜び (よろこび, yorokobi)
juice	果汁 (かじゅう, kajū)
juniper	ビャクシン (byakushin)
kangaroo	カンガルー (kangarū)
ketchup	ケチャップ (kechappu)
key	鍵 (かぎ, kagi)
keyboard	キーボード (kībōdo); 鍵盤 (kenban)
kidney	腎臓 (じんぞう, jinzō)
kill	殺す (ころす, korosu)
kilometre	キロメートル (kiromētoru)
king	キング (kingu)
kingdom	王国 (おうこく, ōkoku)
kiss	キスする (kisu-suru); 口付けする (くちづけする, kuchizuke-suru); 接吻する (せっぷんする, seppun-suru); チューする (chū-suru)
kitchen	台所 (だいどころ, daidokoro); 厨房 (ちゅうぼう, chūbō); キッチン (kitchin)
kite	凧 (たこ, tako)
knee	膝 (ひざ, hiza)
knife	ナイフ (naifu); 小刀 (こがたな, kogatana)
knight	ナイト (naito); (けいま, keima)
know	知る'知っている (しっている, shitté-irú)
koala	コアラ (koara)
krypton	クリプトン (kuriputon)
ladybird	テントウムシ (天道虫) (tentoumushi)
ladybug	テントウムシ (天道虫) (tentōmushi)
lake	湖 (みずうみ, mizuúmi); 湖 (こ, ko)
land	土地 (とち, tochí)
language	言語 (げんご, gengo)
lanthanum	ランタン (rantan)
large	大きい (おおきい) (ōkii)
lark	雲雀 (ひばり, hibari)
laser	レーザー (rēzā)
last year	昨年 (sakunen); 去年 (kyonen)
laugh	笑う (わらう, warau)
lava	溶岩 (ようがん, yōgan)
law	法 (ほう, hō)
lawrencium	ローレンシウム (rorenshiumu)
lawyer	弁護士 (べんごし, bengoshi); 法曹 (ほうそう, hōsō)
lazy	ナマケモノ (namakemono); 怠惰 (たいだな, taida-na); ぐうたら (guutara)
lead	鉛 (なまり, namarí)
leaf	葉 (は, ha), 葉っぱ (はっぱ, happá), 木の葉 (このは, konoha)
learn	習う (ならう, narau); 学ぶ (まなぶ, manabu)
leather	皮 (かわ, kawa)
leech	ヒル (hiru)
leek	葱 (ねぎ, 'negi')
left	左 (ひだり, hidarí)
leg	脚 (あし, ashí); 足 (あし, ashí)
lemon	レモン (remon)
length	長さ (nagasa); 全長 (zenchou)
lesbian	レズ (rezu); レズビアン (rezubian); 同性愛の女性 (どうせいあいのじょせい, dōsei'ai-no josei)
lesson	授業 (じゅぎょう, jugyō); 学課 (がっか, gakka); 課 (-か, -ka); レッスン (ressun)
letter	手紙 (てがみ, tegamí)
lettuce	レタス (retasu)
library	図書館 (としょかん, toshokan)
lie	嘘を吐く (うそをつく, uso-o tsuku)
life	生存 (せいぞん, seizon); 命 (いのち, inochi)
light	照らす (てらす, 'terasu')
light year	光年 (こうねん, kōnen)
lighthouse	灯台 (とうだい, tōdai)
lightning	稲妻 (いなずま, inazuma); 雷光 (らいこう, raikō); 雷 (かみなり, kaminari)
like	のように (...no yō-ni)
lily	ユリ (yuri); 百合 (ゆり, yuri)
linguistics	言語学 (げんごがく, gengogaku)
lion	ライオン (raion), 獅子 (しし, shishi)
lip	唇 (くちびる, kuchibirú)
listen	聞く (きく, kiku)
literature	文献 (ぶんけん) '(bunken)'
lithium	リチウム (richiumu)
litre	リットル (rittoru); ㍑
little	小さい (ちいさい, chiisai)
live	住む (すむ, sumu)
liver	肝臓 (かんぞう, kanzō)
lizard	トカゲ (tokage); 蜥蜴 (tokage)
lobster	伊勢海老; イセエビ (ise-ebi); ロブスター (robusutā)
long	長い (ながい, nagai)
look	見る (みる, miru); (みる, miru) (mitemiru)ご覧になる (ごらんになる, go-ran-ni naru); 拝見 (はいけんする, haiken-surú)
look for	探す (さがす, sagasu)
louse	虱 (しらみ, shirami); シラミ (shirami); 寄生虫 (きせいちゅう, kiseichū)
love	恋人 (こいびと, koibito)
low	低い (ひくい, hikui)
lung	肺臓 (はいぞう, haizō); 肺 (はい, hai)
lute	リュート (ryūto)
lutetium	ルテチウム (rutechiumu)
lynx	ヤマネコ (yamaneko); 山猫 (やまねこ, yamaneko)
machine language	機械語 (きかいご, kikai-go); マシン語 (mashin-go)
mackerel	鯖 (さば); saba
mad	気が狂った (きがくるった, ki-ga kurutta); 狂しい (くるおしい, kuruoshii); 頭がおかしい (あたまがおかしい, atama-ga okashii)
magma	マグマ (maguma)
magnesium	マグネシウム (maguneshiumu)
magpie	鵲 (kasasagi)
maize	トウモロコシ (tōmorokoshi)
mammal	哺乳類 (ほにゅうるい, honyūrui)
man	人 (ひと, hito); 人間 (にんげん, ningen)
manganese	マンガン (mangan)
mango	マンゴー (mangō)
many	多く (おおくの, ōkuno); 多い (おおい, ōi); 沢山 (たくさん, takusan)
map	地図 (ちず, chizu)
maple	かえで (楓, 'kaede')
mare	牝馬
marijuana	マリワナ (mariwana); マリファナ (marifana)
market	市場 (いちば, ichiba)
marmot	マーモット 'māmotto'
marten	テン (ten)
masturbation	マスターベーション (masutābēshon); オナニー (onanī); 自慰 (jii)
match	マッチ (matchi)
mathematics	数学 (sūgaku)
maybe	多分 (たぶん, tábun); 若しや (もしや, moshiya); かもしれない (kamo shirenai); でしょう (deshō)
meal	食事 (しょくじ, shokují)
meat	肉 (にく, niku)
medicine	医学 (いがく, igaku)
meet	会う (あう, au); 遭遇する (そうぐうする, sōgū-surú); 遭う (あう, au); お目にかかる (おめにかかる, o-me ni kakaru)
meitnerium	マイトネリウム (maitoneriumu)
melon	メロン (meron)
memory	記憶 (きおく, kioku)
mendelevium	メンデレビウム (menderebiumu)
mercury	水銀 (すいぎん, suigin)
metal	金属 (きんぞく, kinzoku) (1), 金属製のもの (kinzokusei no mono) (2)
microscope	顕微鏡 (けんびきょう, kenbikyō); マイクロスコープ (maikurosukōpu)
midnight	深夜 (shin’ya); 真夜中 (mayonaka)
midwife	助産婦 (じょさんぷ, josanpu); 産婆 (さんば, sanba); 助産師 (josanshi)
milk	牛乳 (ぎゅうにゅう, gyūnyū); ミルク (miruku); お乳 (おちち, ochichi)
milliard	十億 (じゅうおく, jūoku)
million	百万 (ひゃくまん, hyaku-man)
millipede	ヤスデ
mind	心 (こころ, kokoro), 精神 (せいしん, seishin), 知性 (ちせい, chisei)
mine	鉱山 (こうざん, kōzan); マイン (main)
mineralogy	鉱物学 (こうぶつがく, kōbutsugaku)
minute	分 (ふん, fun; ぷん, pun)
mirror	鏡 (かがみ, kagami)
moat	堀
mobile phone	携帯電話 (けいたいでんわ, keitai-denwa); 携帯 (けいたい, keitai); セルホーン (seruhōn); セルフォン (serufon); モバイル (mobairu)
mole	モグラ (mogura)
molecule	分子 (ぶんし, bunshi)
molybdenum	モリブデン (moribuden)
moment	瞬間 (しゅんかん, shunkan)
monarchy	君主制 (くんしゅせい, kunshusei)
monastery	修道院 (しゅうどういん, shūdōin)
money	お金 (おかね, okane); 貨幣 (かへい, kahei)
monk	僧侶 (そうりょ, sōryo); 坊さん (ぼうさん, bōsan); 修道士 (しゅうどうし, shūdōshi); 僧 (そう, sō)
monkey	猿 (さる, サル, saru)
month	月 (つき, tsukí)
moon	衛星 (えいせい, eiséi)
morning	朝 (あさ, ása); 午前 (ごぜん, gozen)
mosque	モスク (mosuku)
mosquito	蚊 (か, ka)
moss	苔; コケ (koke)
moth	蛾 (が, ga)
mother	(gibo)
mother tongue	母語 (ぼご, bogo); 母国語 (ぼこくご, bokokugo)
motorcycle	オートバイ (ōtobai); バイク (baiku)
mouflon	ムフロン (mufuron)
mountain	山 (やま, yamá)
mouse	マウス (mausu)
moustache	口ひげ (くちひげ, kuchí-higé); 口髭 (くちひげ, kuchí-higé)
mouth	口 (くち, kuchi)
movie	映画 (えいが, eiga)
much	沢山 (たくさん, takusan); 多く (おおくの, ōkuno); 多い (おおい, ōi)
mud	泥 (どろ, doro)
murder	殺人 (satsujin)
muscle	筋肉 (きんにく, kinniku)
museum	博物館 (はくぶつかん, hakubutsukan); 美術館 (びじゅつかん, bijutsukan)
mushroom	キノコ; 茸; きのこ 
music	音楽 (おんがく, ongaku)
musician	音楽家 (おんがくか, ongakuka)
mustard	からし (karashi); (masutādo)
my	私 (わたしの, watashi-no); 僕 (ぼくの, boku-no); 我が (わが, wa-ga)
my name is	私は...です (わたしは...です, watashi-wa ... desu); 名前は...です (なまえは...です, namae-wa ... desu); といいます (... to iimasu); と申します (... to mōshimasu)
mystery	ミステリー (misuterī)
mythology	神話学 (しんわがく, shinwagaku)
nail	釘 (くぎ, kugi)
naked	裸 (はだかの, hadaka-no)
name	評判 (ひょうばん, hyōban)
narrow	狭い (せまい, semái)
nature	自然 (しぜん, 'shizen')
navel	臍 (へそ, heso); ネーブル (nēburu)
nebula	星雲
neck	首 (くび, kubí); ネック 
necklace	ネックレス '(nekkuresu)', 首飾り '(kubi-kazari)'
needle	針 (はり, hari)
neighbour	隣人 (りんじん, rinjin); 近所の人 (きんじょのひと, kinjo-no hito)
neodymium	ネオジム (neojimu)
neon	ネオン (neon)
neptunium	ネプツニウム (neputsuniumu)
nest	巣 (す, su); ネスト (nesuto)
neutrino	中性微子 (chūseibishi), ニュートリノ (nyūtorino)
never	決して (けっして, kesshite); 何時でも (いつでも, itsudemo); 曾て (かつて, katsute); 万々 (まんまん, manman, ばんばん, banban)
new	新しい (あたらしい, atarashii)
news	ニュース (nyūsu)
newspaper	新聞; しんぶん (shinbun)
nickel	ニッケル (nikkeru)
niece	姪 (めい, mei)
night	夜 (よる, yoru)
nightingale	鶯 (うぐいす, uguisu)?, 夜鳴き鶯 (よなきうぐいす, yonaki-uguisu)?, 小夜鳴鳥 (サヨナキドリ, sayonakidori)?
nightmare	悪夢 (あくむ, akumu)
nine	(ここのつ, kokonotsu)９
nineteen	十九 (jū-kyū)
ninety	九十 
ninth	九番目 (きゅうばんめ, kyūban-me)
niobium	ニオブ (niobu)
nipple	乳首 (ちちくび, chichikubi); 乳頭 (にゅうとう, nyūtō); ニップル (nippuru)
nitrogen	窒素 (ちっそ, chisso)
no	いいえ (íie); いえ (ie); ううん (uun, n̄n); 違う (chigau)
no smoking	禁煙 (きんえん, kin’en)
nobelium	ノーベリウム (noberiumu)
nobody	だれも (だれも...ない, dare-mo ... nai)
non	非政府組織 (ひせいふそしき, hiseifu-soshiki)
nonkilling	不殺生 (fusesshō)
noon	正午 (しょうご, shōgo); 真昼 (まひる, mahiru)
north	北 (きた, kita)
nose	鼻 (はな, haná)
not	ではない (de wa nai); (nai)ません (...masen)
notebook	帳面 (ちょうめん, chōmen); ノート (nōto); 手帳 (てちょう, techō)
nothing	何も (なにも, nani-mo); 何でもない (なんでもない, nandemonai); 別に (べつに, betsu-ni)
noun	名詞 (meishí)
now	今 (いま, ima)
nude	裸の (はだかの, 'hadaka-no')
number	数 (かず, kazu); 数字 (すうじ, sūji)
nurse	看護師 (かんごし, kangoshi); 看護士 (かんごし, kangoshi); 看護婦 (かんごふ, kangofu); ナース (nāsu)
nut	木の実 (konomí)
oak tree	オーク (ōku)
oar	櫂 (かい, kai)
obedience	従順 (じゅうじゅん) (jūjun)
obesity	肥満 (ひまん, himan); 肥大 (ひだい, hidai)
oboe	オーボエ (ōboe)
ocean	大洋 (たいよう, taiyō); 海洋 (かいよう, kaiyō); 海 (うみ, umi)
octopus	蛸; 章魚 (たこ, tako); タコ (tako)
of	の (...no)
of course	勿論; もちろん (mochiron); 当然 (とうぜん, tōzen)
office	事務所 (じむしょ, jimusho); オフィス (ofisu); 執務室 (しつむしつ, shitsumushitsu); 事務室 (じむしつ, jimushitsu)
often	よく (yoku); 度々 (たびたび, tabitabi); 頻繁 (ひんぱんに, hinpan-ni); しばしば (shibashiba)
oil	石油 (せきゆ, sekiyu); 油 (あぶら, abura)
old	年老いた; 老いた (おいた, oita)
olive	オリーブ (orību, oriibu)
on	上 (…-no ue ni)
once upon a time	昔々, 昔昔 (むかしむかし, mukashi-mukashi), 今は昔 (imawa mukashi)
one	一 (いち, ichí); 一つ (ひとつ, hitótsu); １
onion	玉葱 (たまねぎ, tamanegi)
open	開ける (あけた, aketa)
operating system	オペレーティングシステム (opēretingushisutemu)
opinion	意見 (いけん, iken)
or	または (mata-wa); (arui-wa)か (ka); それとも (soretomo)
orange	オレンジ (orenji)
organ	器官 (きかん, kikan)
organism	有機体 (ゆうきたい, yūkitai)
orgasm	オーガズム (ōgazumu)
orphan	孤児 ({{l)
osmium	オスミウム (osumiumu)
ostrich	ダチョウ (dachō)
other	他 (ほかの, hoka no); 別 (べつの, betsu no)
otter	(freshwater) 獺, 川獺 (カワウソ, kawauso), (marine) 海獺 (ラッコ, rakko)
our	私たち (わたしたちの, watashitachi-no); (われらの, warera-no)我々 (われわれの, wareware-no)
ovary	卵巣 (らんそう, ransō)
owl	フクロウ (fukurō); 梟 (ふくろう, fukurō)
ox	去勢雄牛 (きょせいおうし, kyosei ōshi)
oxygen	酸素 (さんそ, sánso)
page	ページ (pēji); (めん, men)
pain	痛み (いたみ, itami), 苦痛, (くつう, kutsū)
paint	ペンキ (penki)
painter	画家 (がか, gaka); 絵かき (えかき, ekaki)
palace	宮殿 (きゅうでん, kyūden)
palladium	パラジウム (parajiumu)
palm	手のひら (てのひら, te-no hira); 掌 (てのひら, tenohira)
pancreas	膵臓 (すいぞう, suizō)
pants	ズボン (zubon)
papaya	パパイヤ (papaiya)
paper	紙 (かみ, kami)
paradox	逆説 (ぎゃくせつ, gyakusetsu)
park	公園 (こうえん, kōen)
parliament	議会 (ぎかい, gikai)
parrot	オウム (ōmu); インコ (inko)
part	一部 (いちぶ, ichibu); 部分 (ぶぶん, bubun)
partridge	ヤマウズラ (yamauzura); 鷓鴣 (やまうずら, yamauzura)
passport	パスポート (pasupōto)
password	パスワード (pasuwādo)
paternal aunt	おば (oba)
peace	平和 (へいわ, heiwa); 平静 (へいせい, heisei); 平安 (へいあん, heian)
peach	桃 (もも, momo)
peacock	孔雀 (くじゃく, kujaku); ピーコック (pīkokku)
peanut	ピーナツ (pīnatsu); 落花生(らっかせい) (rakkasei)
pear	梨 (なし, nashi)
pen	ペン (pen); ボールペン (bōrupen)
pencil	鉛筆 (えんぴつ, enpitsu)
penguin	ペンギン (pengin)
penicillin	ペニシリン (penishirin)
peninsula	半島 (はんとう, hantō)
penis	陰茎 (inkei); ペニス (penisu); 男根 (dankon); ペニス (penisu)
people	国民 (こくみん, kokumin); 民族 (みんぞく, minzoku); 人民 (じんみん, jinmin)
pepper	胡椒 (こしょう, koshō)
percent	パーセント (pāsento)
peregrine falcon	隼; ハヤブサ (hayabusa)
perestroika	ペレストロイカ (peresutoroika)
perhaps	多分 (たぶん, tábun); 若しや (もしや, moshiya); かもしれない (kamo shirenai); でしょう (deshō)
perineum	会陰 (えいん, ein)
periodic table	周期表 (しゅうきひょう, shūkihyō)
person	人 (ひと, hitó)
petrol	ガソリン (gasorin)
petroleum	石油 (せきゆ, sekiyu)
pharaoh	ファラオ王 (farao-ō); ファラオ (farao)
pharmacy	薬屋 (くすりや, kusuriya); 調剤薬局 (chōzai yakkyoku)
pheasant	キジ (also きじ 'kiji'; in kanji: 雉 or 雉子)
philosopher	哲学者 (tetsugaku-sha)
phoenix	鳳凰 (ほうおう, hōō); 朱雀 (すざく, suzaku); 不死鳥 (ふしちょう, fushichō); 火の鳥 (ひのとり, hinotori); フェニックス (fenikkusu)
phone	電話 (でんわ, denwa)
phosphorus	リン, 燐 (rin)
photograph	写真 (しゃしん, shashin)
photography	写真撮影 (shashin satsuei); 写真術 (shashinjutsu); 撮影 (さつえい, satsuei)
physics	物理学 (ぶつりがく, butsurigaku)
piano	ピアノ (piano)
picture	絵 (え, e); 絵画 (かいが, kaiga)
pie	パイ (pai)
piece	部分 (ぶぶん, bubun); 一切れ (ひときれ, hitokire); 一片 (いっぺん, ippen); 切り身 (きりみ, kirimi)
pig	豚 (ぶた, buta)
pigeon	鳩 (はと, hato)
pillow	枕 (まくら,　makura)
pimple	面皰 (にきび, níkibi); 丘疹 (きゅうしん, kyūshin)
pin	ピン (ぴん, pin); 鋲 (びょう, byō)
pine	(goyou)
pineapple	パイナップル (painappuru)
pink	ピンク (pinku); 桃色 (ももいろ, momoiro)
pirate	海賊 (かいぞく, kaizoku)
pizza	ピザ (piza); ピッツァ (pittsa)
place	場所 (basho); 位置 (ichi); 所 (tokoro); 空間 (kūkan); 余地 (yochi)
planet	惑星 (わくせい, wakusei)
plant	植物 (しょくぶつ, shokubutsu)
plate	皿 (さら, sara)
platinum	プラチナ (purachina), 白金 (はっきん, hakkin)
platypus	カモノハシ (kamonohashi)
play	遊ぶ (あそぶ, asobu)
please	(...kudasái)どうぞ (dōzo); お願いします (o-negai-shimasu)
pleasure	喜び (よろこび) (yorokobi)
plough	鋤 (すき, suki); 鍬 (くわ, kuwa)
plum	セイヨウスモモ (seiyōsumomo); プラム (puramu)
plutonium	プルトニウム (purutoniumu)
pocket	ポケット (poketto); 懐中 (かいちゅう, kaichū)
poem	詩 (し, shi); 詩歌 (しいか, shiika)
poetry	詩 (し, shi); 詩歌 (しいか, shiika)
poison	毒 (どく, doku)
polar bear	ホッキョクグマ (hokkyoku-guma); (shiro-kuma)
police	警察 (けいさつ, keisatsu)
policeman	警察官 (けいさつかん, keisatsukan); 警官 (けいかん, keikan)
polite	丁寧な (ていねいな, teinei-na); 礼儀正しい (れいぎただしい, reigitadashii)
politician	政治家 (せいじか, seijika); 政客 (せいかく, seikaku)
politics	政治 (せいじ, seiji)
polonium	ポロニウム (poroniumu)
polygon	多角形 (たかくけい, takakukei/たかっけい, takakkei); (porigon)
pomegranate	石榴; 柘榴; ザクロ (zakuro)
poor	貧しい (まずしい, mazushii); 貧乏 (びんぼうな, bimbō-na)
pope	法王 (ほうおう, hōō); 教皇 (きょうこう, kyōkō); ローマ教皇 (Rōma kyōkō)
pornography	ポルノグラフィー (porunogurafī); ポルノ (poruno); 猥褻 (waihetsu); 猥本 (waihon)
port	港 (みなと, minato)
post office	郵便局 (ゆうびんきょく, yūbinkyoku)
postage stamp	切手 (きって, kitté)
postcard	葉書 (はがき, hagaki)
postcode	郵便番号 (ゆうびんばんごう, yūbin bangō)
postmodernism	ポストモダン (posutomodan)
potassium	カリウム (kariumu)
pound	ポンド (pondo)
power	力 (chikara)
praseodymium	プラセオジム (puraseojimu)
prayer	祈り (いのり, inori); 祈祷 (きとう, kitō)
pregnancy	妊娠 (にんしん, ninshin)
pregnant	妊娠 (にんしんしている, ninshin-shiteiru); おめでた (omedeta)
preposition	前置詞 (ぜんちし, zenchishi)
prepuce	包皮 (ほうひ, hōhi)
president	大統領 (だいとうりょう, daitōryō)
pretty	きれい (きれいな, kirei-na); プリティ (puriti); 可愛い (かわいい, kawaii)
price	価格 (かかく, kakaku); 値段 (ねだん, nedan)
priest	司祭 (shisai); (bokushi) (sō)
prime minister	首相 (しゅしょう, shushō)
prime number	素数 (そすう, sosū)
prison	監獄 (かんごく, kangoku); 刑務所 (けいむしょ, keimusho)
problem	問題 (もんだい, mondai)
promethium	プロメチウム (puromechiumu)
pronoun	代名詞 (daimeishí)
pronunciation	発音 (はつおん, hatsuon)
property	財産 (ざいさん, zaisan); 資産 (shisan); 所有物 (shoyū-butsu)
prostitute	売春婦 (baishunfu)
protactinium	プロトアクチニウム (purotoakuchiniumu)
protect	守る (まもる, mamoru)
proton	陽子 (ようし, yōshi)
proverb	諺 (ことわざ kotowaza), 格言 (かくげん kakugen)
pumpkin	南瓜 (かぼちゃ, kabocha); カボチャ (kabocha)
purple	紫 (むらさき, murasaki)
pyramid	ピラミッド (piramiddo); 金字塔 (きんじとう, kinjitō)
quail	ヨアロッパウズラ (yoaroppauzura)
quarter	四分の一 (よんぶんのいち, yombun-no-ichi), 四半 (しはん, shihan), 四半分 (shihanbun)
queen	クイーン (kuīn)
question	質問 (しつもん, shitsumon)
rabbit	兎 (うさぎ, usagi); ウサギ (usagi)
radio	ラジオ (rajio)
radon	ラドン (radon)
railway	鉄道 (てつどう, tetsudō)
rain	(Jpan'雨が降る) ((Jpan'あめがふる), ame ga furu)
rainbow	虹 (にじ, niji)
rake	熊手 (くまで, kumade)
ram	牡羊, 雄羊 
rape	強姦 (ごうかん, gōkan); 手込め (tegome); 手篭 (tegome); レイプ (reipu)
raspberry	キイチゴ (kiíchigo); ラズベリー (rázuberī)
rat	鼠 (ねずみ, nezumi) ('also mouse'), ラット (ratto)
raven	渡り鴉 (ワタリガラス, watari-garasu), 大鴉 (オオガラス, oo-garasu)
read	読む (よむ, yomu)
recent	最近 (さいきん, saikin)
rectangle	長方形 (ちょうほうけい, chōhōkei)
red	赤 (あか, aka)
refrigerator	冷蔵庫 (reizōko)
reindeer	トナカイ (tonakai)
relative	親戚 (しんせき, shinseki); 身内 (みうち, miuchi); 関係詞 (かんけいし, kankeishi)
religion	宗教 (しゅうきょう, shūkyō)
remember	思い出す (おもいだす, omoidasu); 覚える (oboeru)
reptile	爬虫類 (hachūrui)
republic	共和国 (きょうわこく, kyōwakoku)
restaurant	レストラン (resutoran); 食堂 (しょくどう, shokudō); 料理屋 (りょうりや, ryōriya); 料理店 (りょうりてん, ryōriten)
revenge	復讐 (ふくしゅう, fukushū); 報復 (ほうふく, hōfuku)
revolution	革命 (かくめい, kakumei); 改革 (かいかく, kaikaku)
rhenium	レニウム (reniumu)
rhinoceros	犀; サイ (sai)
rhodium	ロジウム (rojiumu)
rice	稲 (いね, ine)
rich	裕福 (yūfuku-na); 豊か (ゆたかな, yutaka-na); 富有 (ふゆうな, fuyū-na); 金持 (かねもちの, kanemochi-no)
rifle	(raifuru)
right	正しい (ただしい, tadashíi)
ring	指輪 (ゆびわ, 'yubiwa')
ring finger	薬指 (くすりゆび, kusuriyubi)
river	川 (かわ, kawá)
road	道 (みち, michí)
robot	ロボット (robotto); 人造人間 (jinzō ningen)
roof	屋根 (やね, yane)
rook	ルーク (rūku)
room	部屋 (へや, heya)
root	起源 (きげん, kígen); 元; (こんげん, kongen)
rope	ロープ (rōpu), 綱 (tsuna), 縄 (nawá)
rose	バラ (bara)
rubidium	ルビジウム (rubijiumu)
ruble	ルーブル (rūburu)
run	走る (はしる, hashiru); (はしらせる, hashiraseru)
ruthenium	ルテニウム (ruteniumu)
rutherfordium	ラザホルジウム (razahorujiumu)
rye	ライムギ (raimugi)
saliva	唾 (つばき, tsubakí), 唾液 (だえき, daeki)
salmon	サーモン (sāmon); 鮭 (さけ, sake; しゃけ, shake)
salt	塩 (しお, shio)
samarium	サマリウム (samariumu)
same	同じ (おなじ, onaji)
sand	砂 (すな, suna)
sandwich	サンドイッチ (sandoitchi)
sauce	ソース (sōsu)
sausage	ソーセージ (sōsēji)
saw	鋸 (のこぎり, nokogiri)
say	言う (いう, iu); 語る (かたる, kataru); (ossharu)申す (もうす, mōsu); 申し上げる (もうしあげる, mōshi-ageru)
scandium	スカンジウム (sukanjiumu)
scar	(はんこん, hankon)
schizophrenia	統合失調症 (tōgōshitchōshō)
school	大学 (だいがく, daigaku), 学校 (がっこう, gakkō)
science	科学 
scissors	鋏 (はさみ, hasami)
scorpion	蠍 (さそり, sasori); 蝎 (さそり, sasori); サソリ (sasori)
screech owl	メンフクロウ (menfukurō)
scrotum	陰嚢 (いんのう, innō)
sea	海 (うみ, úmi); 海 (かい, kai)
seaborgium	シーボーギウム (shibōgiumu)
seagull	鴎 (かもめ, kamome)
seal	海豹 (あざらし, azarashi); おっとせい (ottosei)
season	季節 (きせつ, kisetsu)
second	第二 (だいに, daini); 二番目 (にばんめ, niban-me)
secret	秘密 (ひみつ, himitsu)
see	見る (みる, miru); ご覧になる (ごらんになる, go-ran-ni naru); 拝見 (はいけんする, haiken-surú)
seed	種 (たね, táne)
selenium	セレン (seren)
sell	売る (うる, uru)
send	送る (おくる, okuru); 送信する (そうしんする, sōshin-suru)
sentence	文 (ぶん, bun)
service	務め (つとめ, tsutome), サービス (さーびす, sābisu)
seventeen	十七(じゅうなな (juunana) じゅうしち (juushichi))
seventh	７番目 (ななばんめ, nanaban-me; しちばんめ, shichiban-me)
seventy	七十 (ななじゅう, naná-jū; しちじゅう, shichí-jū)
sex	性別 (seibetsu)
sexual orientation	性的指向; せいてきしこう (seitekishikō); せいしこう (seishikō)
shadow	影 (kage), 陰影 (いんえい, in'ei)
shark	鮫 (サメ, same)
she	彼女 (かのじょ, kánojo); あの人 (あのひと, ano hito); あの方 (ano kata); 奴 (やつ, yatsu)
sheep	羊 (ひつじ, hitsují)
shepherd	羊飼い
ship	船 (ふね, fune); 船舶 (せんぱく, senpaku)
shirt	シャツ (shatsu)
shit	大便をする (daiben-o surú); くそをする (kuso-o surú)
shoe	靴 (くつ, kutsu); シューズ (shūzu)
shop	店 (みせ, mise); 商店 (shōten)
shore	岸 (きし, kishi); 海岸 (かいがん, kaigan); 海浜 (かいひん, kaihin); 湖岸 (こがん, kogan); 河岸 (かがん, kagan, かわぎし, kawagishi)
shoulder	肩; かた (kata)
shrew	トガリネズミ (togari-nezumi); 尖鼠
sick	病気 (びょうき, byōki)
sickle	鎌 (かま, kama)
silence	静けさ (shízukesa); 静寂 (seijaku); 黙秘 (mokuhi)
silicon	ケイ素 (keiso); シリコン (shirikon)
silk	絹 (きぬ, kinu); 絹糸 (きぬいと, kinuito)
silver	銀 (ぎん, gin)
simple	簡単 (かんたんな, kantan-na); 単純 (たんじゅんな, tanjun-na); 易い (やすい, yasui)
sin	罪 (つみ, tsumi)
sing	歌う (うたう, utau); 鳴く (なく, naku)
singer	歌手 (かしゅ, kashu)
sister	姉妹 (しまい, shimai); (あね, ane)お姉さん (おねえさん, onēsan); (いもうと, imōto)
sit	座る (すわる, suwaru); 腰掛ける (こしかける, koshikakeru)
sixteen	十六 (じゅうろく, jū-rokú)
sixth	六番目 (ろくばんめ, rokuban-me)
sixty	六十 (rokú-jū)
skeleton	骨格 (kokkaku); (gaikotsu)
skin	皮膚 (ひふ, hifu); 肌 (はだ, hada)
skirt	スカート (sukāto)
skull	頭蓋骨 (zugaikotsu); 頭骨 (tōkotsu)
sky	空 (そら, sora); 大空 (おおぞら, ōzora)
skylark	雲雀 (hibari)
skyscraper	超高層ビル (chōkōsō-biru); 摩天楼 (まてんろう, matenrō)
slave	奴隷 (どれい, dorei)
sleep	眠り (nemuri); 睡眠 (suimin)
slow	遅い (おそい, osoi); ゆっくり (yukkuri); 鈍足 (どんそく, donsoku)
small	小さい (ちいさい, chiisai)
smell	匂い (におい, nioi)
smile	微笑む (ほほえむ, hohoemu); 笑う (わらう, warau)
smoke	タバコを吸う (tabako-o suu)
snail	蝸牛 (カタツムリ, katatsumuri)
snake	蛇 (へび, hébi)
sneeze	くしゃみをする (kushami-o surú); しゃみをする (shami-o surú)
snooker	スヌーカー (sunūkā)
snow	雪 (ゆき, yuki)
snowflake	雪花 (せっか, sekka)
soap	石鹸 (せっけん, sekken)
soccer	サッカー (sakkā); 蹴球 (しゅうきゅう, shūkyū)
socialism	社会主義 (しゃかいしゅぎ, shakai-shugi)
sock	靴下 (くつした, kutsushita); ソックス (sokkusu)
sodium	ナトリウム (natoriumu)
sofa	ソファー (sofā); 長椅子 (ながいす, naga-isu)
software	ソフトウェア (sofutou~ea); ソフト (sofuto)
solar wind	太陽風 (たいようふう, taiyōfū)
soldier	兵士 (hēshi); 軍人 (gunjin); 兵隊 (へいたい, heitai)
someone	誰か (だれか, dare-ka); 或る人 (あるひと, aru hito)
something	何か (nanika)
sometimes	時時; 時々 (ときどき, tokidoki)
son	息子 (むすこ, musuko); 坊っちゃん (ぼっちゃん, botchan)
song	歌 (うた, uta); 歌曲 (かきょく, kakyoku)
soon	すぐに (sugu-ni)
sorry	すみません (sumimasen); ごめんなさい (gomennasai); 失礼しました (shitsurei-shimashita); 申し訳ありません (もうしわけありません, mōshi-wake arimasen)
soul	魂 (たましい, tamashii); 霊 (れい, rei, たま, tama)
sound	音 (oto)
soup	スープ (sūpu); 汁 (shiru)
sour	すっぱい (suppái); 酸っぱい (suppái)
south	南 (みなみ, minamí)
spacecraft	宇宙船 (うちゅうせん, uchūsen), 宇宙機 (うちゅうき, uchūki), 宇宙旅行船 (うちゅうりょこうせん, uchūryokōsen)
spaceship	宇宙船 (うちゅうせん, uchūsen)
spacetime	時空 
spade	鋤 (すき, suki); スペード (supēdo)
sparrow	スズメ (suzume); 雀 (すずめ, zuzume)
speak	話す (はなす, hanasu); 語る (かたる, kataru); 言う (いう, iu); しゃべる (shaberu)
spectacles	眼鏡 (めがね, megane)
sphere	球 (kyū), 球体 (kyūtai)
spice	香辛料 (こうしんりょう, kōshinryō); スパイス (supaisu)
spider	蜘蛛 (くも, kumo); クモ (kumo); スパイダー (supaidā)
spirit	精神 
spit	つばを吐く (つばをはく, tsuba-o haku)
spleen	脾臓 (ひぞう, hizō)
spoon	スプーン (supūn)
sport	運動 (うんどう, undō); スポーツ (supōtsu)
spring	泉 (いずみ, izumi), 温泉 (おんせん, onsen) '(hot spring, spa)'
spruce	トウヒ (touhi); バラモミ (baramomi); マツハダ (matsuhada); エゾマツ (ezomatsu)
spy	間諜 (かんちょう, kanchō); スパイ (supai)
square	広場 (ひろば, hiroba)
squid	イカ (ika); 烏賊 (ika)
squirrel	栗鼠 (りす, risu)
stand	立つ (たつ, tatsu)
star	有名人 (ゆうめいじん, yūmei-jin); 人 (ちょめいじん, chomei-jin); 花形 (はながた, hanagata); スター (すたー, sutā)
starling	ムクドリ (mukudori); 椋鳥
station	駅 (えき, eki)
statue	像 (ぞう, zō)
steel	鋼鉄 (こうてつ, kōtetsu)
stomach	胃 (い, i); お腹 (おなか, o-naka); 腹 (はら, hara)
stone	小石 (こいし, koishi)
stork	コウノトリ (kounotori)
story	物語 (ものがたり, monogatari); 小説 (しょうせつ, shōsetsu); 話し (はなし, hanashi); ストーリー (sutōrī)
strange	変 (へん, hen); 奇妙 (きみょう, kimyō)
strawberry	苺 (イチゴ, ichigo)
street	道 (みち, michi); 道路 (どうろ, dōro); 通り (とおり, tōri)
strength	力 (ちから, chikara)
string	紐 (himo)
strong	強い (つよい, tsuyoi)
strontium	ストロンチウム (sutoronchiumu)
student	学生 (がくせい, gakusei)
submarine	潜水艦 (せんすいかん, sensuikan); サブマリン (sabumarin); サブ (sabu)
suck	吸う (すう, suu); しゃぶる (shaburu)
suddenly	突然 (とつぜん, totsuzen)
sugar	砂糖 (さとう, satō)
suicide	自殺 (jisatsu)
sulfur	硫黄 (いおう, iō)
summer	夏 (なつ, natsu)
sun	太陽 (taiyō); 恒星 (kōsei); 日 (ひ, hi)
sunflower	向日葵 (ひまわり, himawari)
surname	姓 (せい, sei); 名字 (みょうじ, myōji); 苗字 (みょうじ, myōji)
swallow	飲み込む (のみこむ, nomikomu)
swan	鵠 (くぐい, kugui), 白鳥 (はくちょう, hakuchō)
sweet	甘い (amai)
sweet potato	薩摩芋 (サツマイモ, satsumaimo); 甘藷 (かんしょ, kansho)
sweetener	甘味料 (m) (kanmiryõ)
swim	泳ぐ (およぐ, oyogu)
swimming pool	プール (pūru); スイミングプール (suimingupūru)
sword	刀 (かたな, katana), 剣 (劍; つるぎ, tsurugi; けん, ken)
system	系統 (けいとう, keitō); 系 (けい, kei); 制度 (せいど, seido)
table	表 (hyō)
tadpole	おたまじゃくし (otamajakushi)
taiga	タイガ (taiga)
tail	尻尾 (しっぽ, shippo); しっぽ (shippo); 尾 (お, o)
take	取る (toru); つかむ (tsukamu)
talent	才能 (さいのう, sainō)
talk	話す (はなす, hanasu)
tank	戦車 (せんしゃ, sensha)
tantalum	タンタル (tantaru)
tattoo	刺青; 入れ墨; 文身 (いれずみ, irezumi)
taxi	タクシー (takushī)
tea	茶葉 (ちゃば chaba); 茶 (ちゃ cha)
teach	教える (おしえる, oshieru)
teacher	先生 (せんせい, sensei); 教師 (きょうし, kyōshi)
tear	涙 (なみだ, namida)
technetium	テクネチウム (tekunechiumu)
telephone	電話をかける (でんわをかける, denwa-o kakeru)
telescope	望遠鏡 (ぼうえんきょう, bōenkyō); テレスコープ (teresukōpu)
television	テレビジョン (terebijon)
tellurium	テルル (teruru)
temple	神殿 ({{l); ({{l)寺 ({{l); 寺院 ({{l); 神社 ({{l)
ten	十 (じゅう, jū; とお, tō)
tent	テント (tento); 幕屋 (makuya)
tenth	十番目 (じゅうばんめ, jūban-me)
terbium	テルビウム (terubiumu)
territory	領土 (りょうど, ryōdo)
terrorism	テロリズム (terorizumu)
terrorist	テロリスト (terorisuto); テロ (tero)
testicle	睾丸 (こうがん, kōgan); 精巣 (せいそう, seisō)
thallium	タリウム (tariumu)
than	より (yori)
thank you	ありがとう (arigatō); ありがとうございます (arigatō gozaimasu); どうもありがとう (dōmo arigatō); どうも (dōmo); サンキュー (sankyū)
thank you very much	どうもありがとうございます (dōmo arigatō gozaimasu); どうもありがとうございました (dōmo arigatō gozaimashita); どうもすみませんでした (dōmo sumimasen deshita)
thanks	ありがとう (arigatō); どうも (dōmo); サンキュー (sankyū)
that	その (sonó), あの (anó)
the	(sono)
their	彼ら (かれらの, karera-no)
there	そこ (sokó); あそこ (asokó)
there is	いる (iru); ある (aru)
they	彼等; 彼ら (かれら, karéra); それら (sorera); あの人達 (あのひとたち, anohito-tachi); あの方々 (あのかたがた, anokata-gata)
thief	泥棒 (どろぼう, dorobō)
thigh	腿 (もも, momo); 太股 (ふともも, futomomo); 股 (もも, momo)
thimble	指ぬき (yubinuki)
thing	物 (もの, mono)
think	考える (kangaeru); 思考する (shikō suru); 思索する (shisaku suru)
third	三番目 (さんばんめ, sanban-me)
thirst	喉の渇き (のどのかわき, nodo-no kawaki ); 口渇 (こうかつ, kōkatsu); 渇 (かつ, katsu)
thirsty	喉が乾いた (のどがかわいた, nodo-ga kawaita)
thirteen	十三 (じゅうさん, jū-san)
thirty	三十 (san-jū)
this	この (kono)
thorium	トリウム (toriumu)
thorn	刺; 棘; 茨; 荊; とげ (toge)
thou	君 (きみ, kimi); 汝 (なんじ, nanji); お前 (おまえ, omae); あなた (anata)
thought	考え (kangae); 意見 (iken); 考慮 (kōryo); 思考 (shikō); 思索 (shisaku); 意図 (ito)
thousand	千 (せん, sen)
thread	糸 (いと, ito)
throat	喉 (のど, nodo)
thulium	ツリウム (tsuriumu)
thumb	親指 (おやゆび, oyayubi)
thunder	雷 (かみなり, kaminari)
tiger	虎; トラ; とら (torá)
time	回 (かい, kai); 次 (じ, ji)
tin	錫 (スズ); すず (súzu)
tired	疲れる (つかれた, tsukareta)
titanium	チタン (chitan), チタニウム (chitaniumu)
to	へ (...-e); まで (...-made)
toad	ヒキガエル ('hikigaeru'), 蟇蛙 ('hikigaeru'), 蝦蟇 (がま, 'gama')
tobacco	タバコ (tabako); 煙草 (たばこ, tabako)
today	今日 (こんにち, kónnichi)
toe	足指 (ashi-yubi); (tsumasaki)
together	一緒に (issho ni)
toilet	トイレ (toire); お手洗い (おてあらい, otearai); 便所 (べんじょ, benjo); 化粧室 (けしょうしつ, keshōshitsu)
tomato	トマト (tomato)
tomorrow	明日 (あした, ashita; あす, asu)
tongue	舌 (した, shitá), べろ (bero, 'informal')
too	過ぎ (sugi); 過ぎる (sugiru)
tooth	歯 (は, ha)
toothbrush	歯ブラシ (ha-burashi)
tortoise	亀 (かめ, kame), 陸亀 (りくがめ, rikugame)
touch	触る (さわる, sawaru); 触れる (ふれる, fureru); 接触する (せっしょくする, sesshoku-surú)
tourism	観光 (かんこう, kankō); 旅行 (りょこう, ryokō)
tower	塔 (tō); タワー (tawā)
town	街; 町; まち (machi)
toy	おもちゃ (omocha); 玩具 (がんぐ, gangu)
tradition	伝統 (でんとう, dentō)
train	列車 (れっしゃ, ressha); 電車 (でんしゃ, densha); 汽車 (きしゃ, kisha); トレーン (torēn)
tram	市内電車 (shinai-densha); 市電 (shiden); トラム (toramu); 電車 (densha)
translate	訳す (やくす, yakusu); 翻訳する (ほんやくする, honyaku-suru)
translation	訳 (やく, yaku); 訳文 (やくぶん, yakubun); 翻訳 (ほんやく, hon'yaku)
translator	翻訳者 (ほんやくしゃ, hon'yaku-sha)
travel	旅行 (りょこうする, ryokō-surú)
tree	木 (き, ki); 樹木 (じゅもく, jumoku)
triangle	三角形 (さんかくけい, sankakukei)
tribe	民族 (みんぞく, minzoku)
trousers	ズボン (zubon)
truck	トラック (torakku); 貨物自動車 (kamotsu jidōsha)
true	真実 (しんじつの, shinjitsu-no); 本当 (ほんとうな, hontō-na)
trumpet	トランペット (torampetto)
tsar	ツァーリ (tsāri); ツァー (tsā); ツァール (tsāru)
tsunami	津波 (つなみ, tsunamí); 津浪 (つなみ, tsunamí)
tungsten	タングステン (tangusuten)
turkey	七面鳥 (しちめんちょう, shichimenchō); カラクン (karakun); カラクン鳥 (karakun-chō); ターキー (tākī)
turtle	亀 (かめ, káme), 海亀 (うみがめ, umigáme)
turtle dove	コキジバト (kokijibato)
twelve	十二 (じゅうに, jūni)
twenty	二十三 (ni-jū-san)
twin	双子の一人 (ふたごのひとり, futago no hitori)
two	二 (に, ni); 二つ (ふたつ, futatsú); ２
two hundred	二百 
typhoon	台風 (たいふう, taifū); 颱風 (たいふう, taifū)
umbrella	傘 (かさ, kasa)
uncle	(older) 伯父 (oji, hakufu) (humble); 伯父さん (ojisan); (polite); 伯父貴 (ojiki) (honorific) (younger) 叔父 (oji, shukufu) (humble); 叔父さん (ojisan) (polite); 叔父貴 (ojiki) (honorific)
understand	分かる (わかる, wakaru); 理解する (りかいする, rikai-suru)
unemployment	失業 (しつぎょう, shitsugyō)
universe	宇宙 (うちゅう, Uchū)
university	大学 (だいがく daigaku)
uranium	ウラン (uran)
urethra	尿道 (にょうどう, nyōdō)
urine	尿 (にょう, nyō); 小便 (しょうべん, shōben)
use	用いる (もちいる, mochiiru); 使う (つかう, tsukau); 使用する (しようする, shiyō-surú)
useful	役に立つ (やくにたつ, yaku ni tatsu)
vagina	膣 (ちつ, chitsu); ワギナ (wagina)
valley	谷 (たに, tani)
vampire	吸血鬼 (きゅうけつき, kyūketsuki); ヴァンパイア (banpaia, vanpaia)
vanadium	バナジウム (banajiumu)
vegetable	野菜 (やさい, yasai); 青物 (あおもの, aomono)
verb	動詞 (どうし, dōshi)
very	とても (totemó); かなり (kanari); 非常に (ひじょうに, hijōni); 凄く (すごく, sugoku); 大変 (たいへん, taihén); 大分 (だいぶ, daibu); 随分 (ずいぶん, zuibun); ずっと (zutto); めちゃ (mecha); めっちゃ (metcha); (ちょう, chō)ばり (bari); (tsuru tsuru)
victory	勝利 (しょうり, shōri); 勝ち (かち, kachi)
village	村; むら (mura); 田舎 (いなか, inaka)
vinegar	酢 (す, su)
violet	紫色 (むらさきいろ, murasakiiro); 菫色 (すみれいろ, sumireiro)
violin	バイオリン (baiorin)
virus	ウイルス (uirusu)
visa	査証 (さしょう, sashō); ビザ (biza)
vodka	ウォッカ (uokka); ヴォートカ (vōtoka)
voice	声 (koe); 音声 (onsei)
volcano	火山 (かざん, kazan)
volleyball	バレーボール (barēbōru); 排球 (はいきゅう, haikyū)
volt	ボルト (boruto)
vulture	ハゲタカ (hagetaka)
wait	待つ (まつ, matsu)
waiter	ウエーター (uētā); ウエイター (ueitā)
wake up	目覚める (めざめる, mezameru); 目を覚ます (めをさます, me-o samasu); 起きる (おきる, okiru)
walk	歩く (あるく, aruku)
wall	壁 (かべ, kabe)
walrus	セイウチ (seiuchi); 海象 (せいうち, seiuchi, かいぞう, kaizō)
want	欲しい (ほしい, hoshii); 欲する (ほっする, hossuru); 望む (のぞむ, nozomu); たい (...tai); (...tagaru)
war	戦争 (せんそう, sensō); 戦 (いくさ, ikusa)
warm	暖かい (あたたかい, atatakai); 温かい (あたたかい, atatakai)
wart	疣 (いぼ, ibo)
wash	洗う (あらう, arau)
wasp	雀蜂 (suzumebachi); はち (hachi)
watch	腕時計 (うでどけい, udedokei); 懐中時計 (かいちゅうとけい, kaichuu-tokei); 時計 (とけい, tokei)
water	水 (みず, mizú)
waterfall	滝 (たき, taki)
watermelon	スイカ (suika); 西瓜 
wave	波 (なみ, nami)
wax	蝋 (ろう, rō)
way	道 (みち, michi)
we	私達 (わたしたち, watashi-tachí); 我ら (われら, waréra); 我々 (われわれ, wareware); 僕ら (bokura); 俺達 (oretachi); 俺等 (oira); うち (uchi); 僕達 (bokutachi); わたしども (watashi-domo)
weapon	武器 (ぶき, buki); 兵器 (へいき, heiki)
weather	天気 (てんき, tenki)
web site	ウェブサイト (webusaito); サイト (saito)
wedding	結婚式 (けっこんしき, kekkonshiki)
week	週 (しゅう, shū); 週間 (しゅうかん, shūkan)
weekend	週末 (しゅうまつ, shūmatsu)
welcome	ようこそ (yōkoso); いらっしゃいませ (irasshaimase); いらっしゃい (irasshai)
well	良く (yoku)
werewolf	狼男 (おおかみおとこ, ōkamiotoko)
west	西 (nishi)
wet	濡れた (ぬれた, nureta); 湿った (しぬった, shinutta)
whale	sc=Jpan (くじら, kujira); クジラ (kujira); sc=Jpan (いさな, isana)
what	何 
what is your name	あなたのお名前は何ですか (anata-no o-namae-wa nan desu ka?); お名前は (o-namae-wa?)
what time is it	何時ですか (なんじですか？, nanji desu ka?)
wheat	小麦 (こむぎ, komugi)
wheel	車輪 (しゃりん, sharin); 輪 (わ, wa)
when	何時 (itsu); いつ (itsu); 時 (...no toki); とき (...no toki)
where	何処 (どこに, doko-ni); どこ (doko-ni)
where is the toilet	トイレはどこですか (toire-wa doko desu ka?); お手洗いはどこですか (o-tearai-wa doko desu ka?)
whip	鞭 (むち) (muchi)
whiskey	ウィスキー (uisukī)
white	(はくしょく, hakushoku)
who	誰 (だれ, dáre); だれ (dáre); どなた (dónata); どちらさま (dóchira-sama)
whole	全体 (ぜんたいの, zentai-no)
whore	売春婦 (baishunfu); 娼婦 (shōfu); 街娼 (gaishō); 売女 (baita); させ子 (saseko); パンスケ (pansuke)
why	何故 (なぜ, naze); なぜ (naze); なんで (nande); どうして (dōshite)
wide	広い (ひろい, hiroi); 幅広い (はばひろい, habahiroi)
widow	未亡人 (mibōjin); 後家 (goke)
wife	妻 (つま, tsuma); 家内 (かない, kanai); 奥さん (おくさん, okusan)
wild boar	イノシシ (猪, 'inoshishi')
wildcat	山猫
willow	ヤナギ (yanagi)
wind	風 (かぜ, kaze); ウインド (uindo); ウィンド (windo)
window	窓 (まど, mado); 窓口 (まどぐち, madoguchi); ウィンドウ (u~indō)
wine	ワイン (wain); 葡萄酒 (ぶどうしゅ, budōshu)
wing	翼 (つばさ, tsubasa)
winter	冬 (ふゆ, fuyu)
wise	賢い (かしこい, kashikoi); 賢明 (けんめいな, kenmei-na)
wish	(inoru)欲する (hossuru)
witch	魔女 (まじょ majo)
with	と (-to); とともに (...to tomó-ni); 一緒 (-to issho-ni)
without	...なしで (...nashide), ...無し (...なし, ...nashi)
wolf	狼 (おおかみ, ōkami); オオカミ (ōkami); ウルフ (urufu)
woman	女の人 (おんなのひと, onná-no hitó); 女 (おんな, onná); 女性 (じょせい, josei)
wood	木, 木材 (もくざい, mokuzai)
woodpecker	啄木鳥 (キツツキ, kitsutsuki)
wool	ウール (ūru); 羊毛 (ようもう, yōmō)
word	言葉 (ことば, kotoba); 単語 (たんご, tango)
work	働く (はたらく, hataraku)
workers of the world, unite	万国の労働者よ、団結せよ！ (bankoku no rōdōsha yo, danketsu seyo!)
world	(Jpan'世界) ((Jpan'せかい), sekai), ワールド (warudo) (slang)
worm	虫 (むし, mushí); 虫螻 (むしけら, mushikera)
wrist	手首 (てくび, tekubi)
write	書く (かく, kaku)
writer	著者 (ちょしゃ, chósha); 作家 (さっか, sakká); 筆者 (ひっしゃ, hissha)
xenon	キセノン (kisenon)
xenophobia	外国人恐怖症 (がいこくじんきょうふしょう, gaikokujin kyōfushō); 外国人排斥 (がいこくじんはいせき, gaikokujin haiseki); 外国人嫌悪 (がいこくじんけんお, gaikokujin ken'o); 排外主義 (はいがいしゅぎ, haigaishugi); 外国人嫌い (がいこくじんぎらい, gaikokujin-girai)
yawn	欠伸する (あくびする, akubi-suru)
year	年 (ねん, nen; とし, toshí)
yeast	酵母 (kōbo)
yellow	黄色 (きいろ, kiiro)
yes	はい (hai); ええ (ē); うん (un, n̄)
yesterday	昨日 (きのう, kinō); 昨日 (さくじつ, sakujitsu)
yoga	ヨガ (yoga); ヨーガ (yōga)
yoghurt	ヨーグルト (yōguruto)
yolk	(kimi)
you	<!-- Maybe we need a separate article for the case of ja pronouns... perhaps the "horribly insulting" ones should be removed just for sake’s sake... there should probably be a better term than ‘rude’ here too. -->
young	若い (wakai)
your	あなたたちの (anatatachi-no); きみたちの (kimitachi-no)
ytterbium	イッテルビウム (itterubiumu)
yttrium	イットリウム (ittoriumu)
zebra	縞馬; シマウマ (shimauma); ゼブラ (zebura)
zero	零 (れい, rei), ゼロ (zero)
zinc	亜鉛 (あえん, aen)
