English	Faroese
Abel	Ábal
Abraham	Ápran
Adam	Ádam (m)
Aegean Sea	Egeiska havið (n)
Afghan	afganskur
Afghanistan	Afganistan (n)
Africa	Afrika (f)
Agnes	Agnas
Albania	Albania
Alcoholics Anonymous	Anonymir Alkoholikarar
Algeria	Algeria (n)
Alps	Alpurnar (f)
American	amerikanari (m)
American bison	amerikanskur bisonur
Amharic	Amhariskt
Andorra	Andorra (n)
Andrew	Andras
April	apríl
Arab	arábi (m)
Ark of the Covenant	sáttmálaørkin (f)
Armenia	Armenia (n)
Armenian	armenskur (m)
Arne	Arni; Árni
Ash Wednesday	øskudagur (m)
Asia	Asia
August	august
Austria	Eysturríki
Azerbaijan	Aserbajdjan (n)
Baghdad	Bagdad
Baltic	Baltalond (n)
Baltic Sea	Eystrasalt (n)
Beijing	Beijing; Peking
Belarus	Hvítarussland (n)
Belarusian	belarussiskt
Belgium	Belgia
Belorussian	Belarussiskt
Berlin	Berlin
Black Sea	Svartahavið (n)
Bosnia	Bosnia
Bosnia and Herzegovina	Bosnia-Hersegovina
Briton	breti (m)
Brussels	Brussel
Bulgaria	Bulgaria (n)
Bulgarian	bulgarskt
Canada	Kanada
Candlemas	kyndilsmessa (f)
Canute	Knútur
Cape Verde	Grønhøvdaoyggjarnar
Catalan	Katalandskt
Charlemagne	Karlamagnus (m)
Chile	Kili
Chinese	kinverji (m); kinesari (m)
Christ	Kristus (m)
Christmas	jól (n)
Copenhagen	Keypmannahavn (f); Kjøpinhavn (f)
Croatia	Kroatia (f)
Croatian	Kroatiskt
Cyprus	Kýpros (n)
Czech	kekskur (m); keksk (f); kekskt (n)
Czech Republic	Kekkia (f); Kekska lýðveldið (n)
Czechia	Kekkia (n)
Dane	dani (m); danskari (m)
Danish	danskur
Denmark	Danmørk (f); Danmark (f)
Derek	Tíðrikur
Donald Duck	Dunnaldur Dunna
Dorothy	Dorotea (f); Dortea (f); Durita (f); Duruta (f); Tea (f)
Dutch	hálendskt
EU	ES (n)
Earth	jørðin (f)
Easter	páskir (f)
Easter egg	páskaegg (n)
Edmonton	Edmonton
Egypt	Egyptaland (n)
England	Ongland (n)
English	enskur (m); (f) enskt (n)
Eric	Eirikur
Estonia	Estland
Ethiopia	Etiopia (f)
Europe	Evropa (n)
European Union	Evropasamveldið (n)
European bison	evropiskur bisonur
European perch	áburra (f)
Eve	Eva (f)
Faroe Islands	Føroyar (f)
Faroese	(m)
February	februar
Finland	Finnland (n)
Finnish	Finskt
France	Frakland
Frederick	Fríðrikur
French	Franskt
Friday	fríggjadagur (m)
Frisian	vesturfrísiskt (n)
Funen	Fjón (n)
George	Jorgen
Georgia	Georgia (n)
German	germani (m)
Germanic	germanskur
Germany	Týskland (n)
God	Gud (m); Guð (m)
Good Friday	langafríggjadagur (m)
Gothic	gotiskt (n) 
Greece	Grikkaland (n)
Greek	Grikskt
Greenland	Grønland (n)
Greenland shark	hákelling (f)
Greenlander	grønlendingur (m); grønlendari (m)
Greenlandic	grønlendskur (m); grønlendsk (f); grønlendskt (n)
Gunter	Gunnar
Happy New Year	gott nýggjár
Hashemite Kingdom of Jordan	Hasjemitiska kongaríkið Jordan (n)
Hebrides	Suðuroyggjar (f)
Helga	Helga (f)
Hungarian	ungverji (m); ungari (m)
Hungary	Ungarn; Húnaland (n)
I	eg; jeg
I love you	eg elski teg
ID card	samleikaprógv (n)
IP address	IP-adressa
Iceland	Ísland (n)
Icelander	íslendingur (m)
Icelandic	íslendskur
Icelandish	íslendskur
Ingrid	Ingirið (f); Ingrið (f)
Internet	Alnetið (n); internet
Ireland	Írland
Iris	Iris
Irish	íri (m)
Isle of Man	Mann; Man
Istanbul	Istanbul
Italian	Italskt
Italy	Italia (n)
Jacob	Jákup
January	januar (m)
Japan	Japan
Jesus	Jesus (m)
Jesus Christ	Jesus Kristus (m)
Jew	jødi (m); gýðingur (m)
John	Jóhannis, Jóhannes
Joseph	Jósef
July	juli
June	juni
Jutland	Jútland (n)
Kazakhstan	Kasakstan
Latin America	Latínamerika (f)
Latvia	Lettland (n)
Leningrad	Leningrad (m)
Leo	Leo
Liechtenstein	Liktinstein (n)
Lithuania	Litava (n)
Louis	Ludvík (m)
Luxembourg	Luksemburg (n)
Luxembourgish	luksemburgskur
Macedonia	Makedónia (n)
Malta	Malta (f)
March	mars
Mary	Maria
Matthew	Mattias; Mats
Maundy Thursday	skírisdagur (m)
May	mai#Faeroese'mai (m)
Mediterranean Sea	Miðjarðarhav
Megleno	meglenorumenskt (n)
Merry Christmas	gleðilig jól
Mexico	Meksiko (n)
Michael	Mikkjal; Mikal
Middle	Miðgarður (m)
Moldova	Moldova (n)
Monaco	Monako (n)
Monday	mánadagur (m)
Moscow	Moskva
Muslim	muslimur (m)
Neptune	Neptun (m)
Netherlands	Niðurlond (n); Háland (n)
New Year	nýggjár (n)
New Zealand	Nýsæland (m)
Niger	Niger
Nobel Prize	Nobelheiðursløn (f)
Nordic countries	Norðurlond
Normandy	Norðmandíið (n)
Norn	norn (n)
North Africa	Norðurafrika (f)
North America	Norðuramerika (f)
North Sea	Norðsjógvurin (m)
Norway	Noreg (n)
Norwegian	norskur (m)
October	oktober (m); oktobur (m)
Odense	Odense
Odin	Óðin
Olaf	Ólavur (m)
Old Norse	norrønt
Olympic Games	olympiskir leikir (m'p), OL
Orkney Islands	Orknoyggjar (f)
Pacific Ocean	Kyrrahav
Paul	Páll
Persian	persiskt (n)
Peter	Pætur (m)
Phoenix	Føniks (m)
Poland	Póland
Polish	pólskur (m)
Portugal	Portugal
Portuguese	Portogisiskt
Proto	frumnorrønt (n)
Ragnarok	ragnarøk
Ramadan	ramadan (f)
Roger	Róar
Romania	Rumenia (n)
Russia	Russland
Russian	Russiskt
Saami	sámi (m); lappi (m); lapplendingur (m)
Saint Petersburg	St. Pætursborg
San Marino	San Marino (n)
Santa Claus	jólamaður (m)
Saturday	leygardagur (m)
Scandinavia	Skandinavia (f)
Scandinavian	skandinaviskur (m)
Scania	Skáni
Scotland	Skotland (n)
Selma	Selma (f)
September	september (m); septembur (m)
Serbia	Serbia (n)
Serbian	serbiskur
Shetland	Hetland (n)
Shetland Islands	Hetland (n)
Shetlander	hetlendingur (m)
Siberia	Siberia
Sicily	Sikiloy (f)
Sigrid	Sigrið (f); Sirið (f)
Sigurd	Sjúrður
Slovak	slovakskur (m); slovaksk (f); slovakskt (n)
Slovakia	Slovakia (f)
Slovenia	Slovenia (n)
Sound	Oyrarsund (n)
South America	Suðuramerika (n)
Soviet Union	Sovjetsamveldið (n)
Spain	Spania (n)
Spanish	spanskur
Sun	Sólin
Sunday	sunnudagur (m)
Sweden	Svøríki (n)
Switzerland	Sveis (n)
Syria	Sýria (n)
Tallinn	Tallinn
Tanzania	Tansania
Ten Commandments	tey tíggju boðini (n)
Thai	tailendskur; teilendskur
Thing	ting
Thomas	Tummas
Thor	Tórur (m)
Thora	Tóra (f)
Thursday	hósdagur (m); tórsdagur (m)
Torquil	Torkil (m)
Tripoli	Tripolis
Trondheim	Trondheim; Trándheimur (m)
Tuesday	týsdagur (m)
Turkey	Turkaland (n)
Turkish	turkiskt (n)
Turkmen	turkmenskt (n)
Turkmenistan	Turkmenistan (n)
Tyr	Týrur
Ukraine	Ukraina (n)
Ukrainian	Ukrainskt
Urban	Urbanus
Uzbek	usbekskur (m)
Uzbekistan	Usbekistan (n)
Valhalla	Valhøll (f)
Valkyrie	valkyrja (f)
Vatican City	Vatikanið (n)
Venice	Venesia
Venus	Venus
Viking	víkingur (m)
Volga	Volga (f)
Wales	Wales; Kymru
Wednesday	mikudagur (m); ónsdagur (m)
Wikipedia	Wikipedia
Wiktionary:Votes/2007	sigur
William	Vilhjálmur
YMCA	KFUM
Your Majesty	Tygara Hátign
Zealand	Sæland (n)
aa	bøklalava (n)
abbot	abbati (m)
ablative case	ablativ (n)
able	frískur
accusative	hvønnfall (n)
acre	ekra (f)
actinium	actinium
adjective	lýsingarorð (n)
admiral	admirálur (m)
adverb	hjáorð (n)
aeroplane	flogfar (n)
afternoon	seinnapartur (m); seinrapartur (m)
aircraft	flogfar
airport	floghavn (n); flogvøllur (m)
albatross	súlukongur (m)
all the best	alt tað besta
alloy	málmbland
alphabet	stavrað (n)
already	longu
aluminium	aluminium
am	eri
americium	americium
anchovy	ansjós (f)
angel	eingil (m)
angelica	hvonn (f)
anglerfish	havtaska (f)
answer	svara
ant	meyra
anthem	tjóðsangur (m)
anthrax	miltbrandur (m); miltsýki (n); miltisbruni (m)
antimony	antimon
appendicitis	blindgarnarbruni (m); ágarnarbruni (m)
apple	súrepli (n); epli
apricot	abrikos
argent	silvur
argon	argon
ark	ørk (f)
arm	armur (m)
arrogance	hugmóð (f); stórlæti (n); arrogansa (f)
arrow	ørvur (m); pílur (m); ørv (f)
arsenic	arsenikk
ash	øska
astatine	astatan
asterisk	asteriksur (m)
astronomy	stjørnufrøði (f)
at	eftir 
at home	heima
at sign	kurla; hjá; tranta; snápila
atheism	gudloysi
auditor	grannskoðari (m)
auk	svartfuglur (m)
author	rithøvundur (m); høvundur (m)
autumn	heyst (n)
axe	øks (f)
axis	ásur (m)
axle	aksil (m)
azalea	asalea (f)
baa	mæ
backpack	ryggsekkur (m)
bad	illur
badger	grevlingur (m)
bailiff	fúti (m)
banana	banan (f)
bank	banki (m)
barium	barium
bark	børkur (m); bark (n)
barn owl	hjartaugla
basement	kjallari (m)
basketball	kurvabóltur (m)
basking shark	brugda (f); brugða (f)
bat	flogmús (f)
bath	baða
bathe	bað (n)
bay	vík (f)
be	vera; finnast
bean	bøna
bear	bjørn
beautiful	vakur (m); vøkur (f); vakurt (n)
beaver	bævur (m)
bedbug	veggjalús (f)
beer belly	ølkíkur (m)
berkelium	berkelium
berserk	berserkur (m)
beryllium	beryllium
better	betri
bicycle	súkkla (f)
big	stórur
bill	nev (n)
biography	ævisøga (f)
bird	sprund (n)
bishop	bispur (m)
bismuth	vismut
bison	visundur (m); bisonur (m)
bite	bíta
black	øssvartur lómur (m)
black grouse	orri
black guillemot	teisti (m)
blackbird	kvørkveggja
blood	blóð (n)
blue	bláur (m); blá (f); blátt
blue mussel	kræklingur (m)
blue whale	royður (f)
blueberry	bláber (n); aðalbláber (n)
bluethroat	blákriki (m)
boathouse	neyst (n)
bone	bein (n)
book	bók (f)
boron	bor
bouquet	blómutyssi (n)
bow	bogi (m)
bowhead	grønlandsslættibøka (f)
boy	drongur (m); piltur (m)
brain	heili (m)
brambling	fjallígða (f)
brave	djarvur (m)
breakfast	morgunmatur
breathe	anda
bridge	bridge (n)
bromine	brom
brooch	bringuprýði (n); brossja (f)
brook	løkur (m)
brown	brúnur
brown trout	síl (n); eyrriði (m); eyrriða (f); egriði (m); egriða (f)
browser	kagari (m)
buffalo	búffil
bull	tarvur (m)
bullfinch	prýðisígða (f)
bunion	vírikur (m)
but	men
butter	smør (n)
butterfly	firvaldur; summarfuglur (m); fiðrildi (n)
buzzard	músvákur
by the Grace of God	av Guðs/Guds náði
cadmium	kadmium
caesium	cæsium
cairn	varði (m)
calcium	kalsium
californium	kalifornium
calligraphy	fagurskrift (f); skreytskrift (f)
camel	kamelur (m)
canary	kanarjufuglur
cancer	krabbamein (n)
candidate	valevni (n)
capon	geldur hani
car	bilur (m)
carboxylic	carboxyl-
carboxylic acid	carboxylsýra
carrot	gularót (f)
cartouche	skreytramma (f)
cash desk	kassi (m)
cash register	kassi (m)
cast	kasta
cat	ketta (f); húsketta (f); køttur (m); húskøttur (m)
caviar	kaviar (n)
caw	krá (n)
cell	kykna (f)
cellar	kjallari (m)
cement	sement (n)
center	miðja (f)
century	øld
cerium	cerium
chaffinch	bókígða (f)
chain reaction	ketureaktión (f)
chamois	gemsa
cherub	kerúbur (m)
chicken	høsn
child	barn (n)
chlorine	klor
chlorophyll	blaðgrøni (m)
choir	kór (n)
chromium	krom
church	gudstænasta (f); kirkjugongd (f); messa (f)
cigar	sigar (f)
cigarette	sigarett (f)
circa	umleið 
civil war	borgarakríggj (n)
clean	reinur
clientele	viðskiftafólk (n)
clitoris	galipinnur (m); háatrýni (n); purrifinna (f)
clog	tufla (f)
cloud	skýggj (n)
coast	strond
cobalt	kobolt
cocaine	kokain (n)
cock	kakkulárakó
cockroach	grótlús (f); kakkulakkur (m)
cod	toskur (m)
coffee	kaffi (f)
cold	kaldur; kølin
color	litur (m)
colt	koltur (n)
columbine	akkuleya
column	stólpi (m)
combat	bardagi
commit suicide	taka lívið av sær
common eider	æða (f)
common goldeneye	súgont (f)
common gull	skatumási
common noun	felagsnavn (n)
common snipe	mýrisnípa (f)
communism	kommunisma
comparative	miðstig (n)
comprehensive	umfatandi
computer	telda (f)
computer game	telduspæl (n)
concrete	betong (n)
condom	hít (f)
conference	ráðstevna (f)
confused	ørkymlaður (m)
congratulations	til lukku
conjunction	sambindingarorð (n)
conscience	samvitska (f)
continent	heimspartur (m)
continental drift	meginlandarák
copper	kopar
cormorant	hiplingur (m)
corn bunting	kornspurvur (m)
corpus luteum	øksl (n)
counselor	ráðgevi (m)
count	greivi (m)
country	land
cow	kúgv (f)
crab	krabbi (m)
crab louse	flatlús (f)
crisis	kreppa (f)
crow	kráka (f)
crowbar	kúbein (n); kleyv (f)
crowberry	svartber (n); svarber (n)
cruel	grimmur
cuckoo	geykur
cum	spin (n)
curium	kurium
curriculum vitae	ævilýsing (f)
cute	søtur (m)
daisy	summardái (m)
dale	dalur (m)
dance	dansur (m)
dative	hvørjumfals-
dative case	hvørjumfall (n)
day	dagur (m)
dead	deyðu (n)
death	deyði (m)
deer	hjørtur
defense	verja
demonstrative pronoun	ávísingarfornavn (n)
depth	dýpi (n)
dew	døgg (f)
diamond	diamantur (m)
diarrhea	lívsýki (n); búklop (n); skitja (f); skærpusótt (f); myrra (f); gorlop (n)
dictionary	orðabók (f)
die	terningur (m)
difficult	torførur
dildo	dildo (f); vibratorur (m)
diocese	biskupsdømi (n)
diver	lómur (m)
do you speak English	tosar tú enskt? (italbrac'informal), tosa tygum enskt? (italbrac'very formal)
dog	hundur (m)
dollar	dollari (m)
donkey	asni
door	dyr; hurð
dormouse	heslimús
dragon	dreki (m); lindormur (m)
dress	kjóli (m)
dromedary	dromedarur
drosera	sóldøgg (f)
dry	turrur
duchy	hertugadømi (n)
duck	dunna
dysprosium	dysprosium
e	teldubræv (n); teldupostur (m)
e.g.	t.d. 
eagle	ørn
ear	oyra (n)
earthquake	Jarðskjálvti
east	eystan-
eider	æða (f)
einsteinium	einsteinium
either	antin ... ella
elbow	albogi
electoral district	valdømi (m)
electricity	ravmagn (n)
elephant	fílur (m)
eleven	ellivu
elsewhere	aðrastaðni
embassy	sendistova (f)
empty	tøma
encyclopedia	Alfrøðibók
erbium	erbium
ermine	roysikøttur
eruption	gos (n)
etc.	o.s.fr. 
euro	evra (f)
europium	europium
everywhere	allastaðni
evil	óndur; óreinur
ewe	ær (f)
exception	undantak (n)
excuse me	ha#Faroese'ha?
eye	eyga (n)
face	andlit (n)
falcon	falkur (m); smyril (m)
fall	fella
fallow deer	dádýr
family	ætt (f)
farrow	leggja
fast	fast
father	faðir (m); pápi (m); babba (m)
fatherland	móðurland (n), føðiland (n), heimland (n), fosturland (n)
fathom	favnur (m)
feather	fjøður (f)
fermium	fermium
fetus	fostur (n)
fifth	fimti
finch	ígða (f)
finger	fingur (m)
first aid	fyrstahjálp (f)
first and foremost	fyrst og fremst
fish	fiskur (m)
five	fimm
fjord	fjørður (m)
flashlight	lummalykt (f)
flavorless	smakkleysur
floor	gólv (n)
floppy disk	diskil (m)
flour	mjøl (n)
flower	blóma; blomstur
fluorine	flúr
fly	flýggja
foam	skúm (n)
fog	toka (f)
foot	fótur (m)
footballer	fótbóltsspælari (m)
for	tí
for example	til dømis
forefinger	fremstifingur (m)
forest	skógur (m); skógvur (m)
former	fyrrverandi
forty	fjøruti
fosterage	fostur (n)
fox	revur (m)
francium	francium
freedom	frælsi (n)
friend	vinur
frog	froskur (m)
fuck	mogga
fulmar	havhestur (m)
fungus	soppur
furniture	innbúgv (n); húsgøgn (n)
gadolinium	gadolinium
gadwall	sutlont (f)
gallium	gallium
garage	bilhús (n)
garbage truck	ruskbilur (m)
garganey	teymont (f)
garlic	hvítleykur (f)
gas	gass (n)
gas station	bensinstøð (f)
gasoline	bensin (n)
gate	portur (n)
gelding	geldingur (m)
gender	kyn (n)
genitive	hvørsfall (n)
gentleness	góðska (f)
germanium	germanium
ghost	dreygur; andi
giant	risi (m)
gift	gáva (f)
girl	genta (f)
give birth	eiga
glacier	jøkul (m)
glad	glaður (m); glað (f)
glue	líma (f)
goal	mál
goat	geit
gold	gull
golden eagle	kongaørn
good morning	góðan morgun
goose	gás (f)
goshawk	høsnaheykur
grammar	mállæra (f)
grandfather	abbi
grandmother	omma (f)
grass	gras (n)
grasshopper	eingispretta (f); ongspretta (f)
gratitude	takksemi
great auk	gorfuglur (m); geirfuglur (m)
great northern diver	havgás (f)
great spotted woodpecker	stór flekkuspæta
great tit	stórtíta
greater scaup	grábøkut ont (f); grábøka (f)
green woodpecker	spónspæta
greeting	heilsa (f); heilsan (f); kvøða (f)
grey heron	hegri
grey partridge	akurhøna (f)
greylag goose	grágás
griffon vulture	gammur
growth	vøkstur (m)
guillemot	lomviga (f); lomvigi (m)
guinea fowl	perluhøna
guinea pig	marsvín
gull	mási; máur (m); mávur (m)
haddock	hýsa (f)
hafnium	hafnium
half	helvt (f)
halibut	kalvi
hamster	hamstari
hand	handa
happiness	gleði (f)
happy birthday	til lukku við føðingardegnum, til lukku við degnum
hard disk	harðdiskur (m)
hardly	neyvan
hare	hara
harebell	bláklokka (f)
harlequin duck	brimont (f)
harpoon	skutla
hash	hassj (n)
hate	hata
have	hevur; hava
hay	hoyggj (n)
haystack	sáta (f); hoysáta (f); des (f)
hazel grouse	jarpi (m)
he	hann (m)
head	høvd (n); høvur (n)
hear	hoyra
heart	hjørtu (n)
heat wave	hitabylgja (f)
heavy	tungur
heavy water	tungt vatn (n)
hedgehog	tindasvín (n)
helicopter	tyrla (f)
helium	helium
hell	helviti (n)
hello	hey; halló
helmsman	stýrimaður (m)
herb	urt (f)
here you are	ger so væl
heron	hegri
hi	hey; halló
hiatus	ljóðglopp (n)
hiccup	hist (n); histi (m); histan (f)
high	skeivur
hinder	aftastur; aftari; afturi
hip	hjúpa (f); rósuber (n)
hither	higar
hitherto	higartil
holmium	holmium
home country	heimland (n)
homeland	heimland (n)
homicide	dráp (n); morð (n)
homosexual	samkyndur
hoof	hógvur (m)
hook	krókur
hope	vóna
horn	horn (n)
horny	graður; gessigur
horse	hestur; ross
hospital	sjúkrahús (n)
hospitality	gestablídni (n), gestablíðskapur (m)
hound	hundur
house	hús (n)
how are you	hvussu gongur 
how much does it cost	hvat kostar tað?
hug	klemma; kroysta
human being	menniskja (f)
hydrogen	hydrogen; vatnevni; vetni (n)
hydrogen peroxide	vetnisovursúrni (n)
hydrology	vatnfrøði (f)
hyssop	ýsopur (m)
ibex	steingeit
ice	ísur (m)
iceberg	ísfjall (n)
icicle	glerpípa (f)
illness	sjúka
imperative mood	boðsháttur (m)
inch	tummi (m)
indefinite pronoun	óbundið fornavn (n)
indium	indium
inhabitant	íbúgvi (m)
injury	sár
insect	skordýr
instrumental case	verkførisfall
intelligence	fregnartænasta (f)
interactive	samvirkin
international	altjóða
interrogative pronoun	spurnarfornavn (n)
iodine	jod
ionosphere	háhválv (n); jónhav (n)
iridium	iridium
iris	mækja (f)
iron	jarn (n)
is	er
island	oyggj (f)
islander	oyggjarbúgvi (m), oyggjarskeggi (m)
isthmus	eiði (n); eið (n)
italic	skákskrift (f); skráskrift (f)
ivory	fílabein (n)
jackdaw	rókur
jay	gnelliskjóra
jurisprudence	løgfrøði (f)
kayak	kajakk (f)
kestrel	falkur (m); smyril (m)
keyboard	knappaborð (n)
kidney	nýra (n)
kill	drepa
king	kongur (m)
kingdom	kongsríki (n)
knight	riddari (m)
krypton	krypton
labial	varra-
lake	vatn; tjørn (f)
land	land (n)
language	mál (n); tungumál (n)
lanthanum	lanthan
last	síðstur (m); síðst (f)
laundry	vaskarí (n)
lawrencium	lawrencium
lead	blýggj
leap year	leypár (n)
learn	læra
leek	purra (f)
length	longd (f)
lesser spotted woodpecker	dvørgspæta
letter	bræv (n)
leukemia	blóðkrabbi (m)
library	bókasavn (n)
lick	sleikja
life	lív (n)
lift	lyfta (f)
like	dáma; hóva; líka; falla 
lingonberry	vínbláber (n)
linguist	málfrøðingur (m)
linguistics	málfrøði
lion	leyva (f); ljón (n); løva (f)
lip	vørr (f)
listen	hoyra
lithium	lithium
litre	litur (m)
live	búgva
lizard	flogdreki (m); edla (f); ødla (f)
load	løða
locative case	staðarfall (n)
loneliness	einsemi (f)
long	kattúla
look	leita
loon	lómur (m)
louse	lús
lumpsucker	grárognkelsi, reyðrognkelsi, rognkelsi
lutetium	lutetium
lynx	geypa
lysergic acid diethylamide	lysergsýra diethylamid
mad	óður
maelstrom	malstreymur
magnesium	magnesium
magnetism	magnetisma (f)
magpie	skjóra
mainland	meginland (n); fastland (n)
make the bed	reiða song
mallard	villdunna
mammal	súgdjór
man	manna
manganese	mangan
manslaughter	manndráp (n)
many thanks	manga takk; takk fyri
map	landkopt (f)
maple	lynur (m); ahorn (n)
mare	ryssa (f)
market	marknaður (m)
marmot	múrmildýr
marten	márur
mask	gríma (f); gekkaskortur (m); maska (f)
mast	mastur (f)
match	dystur (m)
maternal grandfather	abbi, móðirfaðir (m)
mathematics	støddfrøði (f)
maybe	kanska
mead	mjøður (m)
meat	kjøt (n)
mendelevium	mendelevium
meow	mjarra; mjavma; mjavva; mjóma
mercury	kviksilvur
merlin	smyril (m)
mew	mási (m); mávur (m)
middle finger	longutong (f)
milk	mjólka
milliard	milliard#Faeroese'milliard
mine	nám (n)
mole	moldvørpa (f)
molecule	mýl (n)
molybdenum	molybden
money	gjaldoyra (n)
monk	munkur (m)
monkey	apa (f)
month	mánaður (m)
moo	mø
moon	mánaður (m)
morning	morgun
morphine	morfin (n)
mosque	moska (f)
moth	húsvætti (n)
mother	móðir (f); mamma (f)
motherland	móðurland (n)
motorboat	motorbátur (m)
mountain	fjall (n)
mourn	syrgja
mug	gron (f)
municipality	kommuna (f)
muskrat	moskusrotta
my name is	eg eiti 
nail	negl (f)
naked	nakin
name	navn (n)
nape	nakki (m)
narwhal	náhvalur (m)
necktie	slips (n)
necromancy	andamaning (f)
neighbour	granni (m); nábúgvi (m)
neodymium	neodym
neologism	nýggjyrði (n)
neon	neon
nephew	bróðursonur (m); (m)
neptunium	neptunium
ness	nes (n)
net	net (n)
nettle	nota (f); brenninota (f)
nickel	nikkul
night	nátt (f)
nightingale	suðurnáttargali
nine	níggju
niobium	niobium
nitrate	nitrat (n)
nitrogen	køvievni
no	nei
no smoking	royking bannað
nobelium	nobelium
nobody	eingin
nominative	hvørfall'hvørfals-
nominative case	hvørfall (n)
northern lapwing	vípa (f)
northern lights	norðlýsi (n)
northwest	útnyrðingur (m)
not	ikki
noun	navnorð
now	nú
nowhere	ongastaðni
nuclear power	kjarnorka (f)
nun	nunna (f)
nut	nøt (f)
oak	eik (f)
oak tree	eikitræ (n)
oat	havri (m)
oath	eiður (m); illbøn (f)
ocean	hav (n)
octave	oktavur (m)
of course	sjálvandi
office	skrivstova (f)
ombudsman	umboðsmaður
omnibus	bussur (m)
one	einoygdur
onion	leykur (m)
onomatopoeia	ljóðorð (n)
onomatopoeic	ljóðhermandi
or	ella
orca	bóghvítuhvalur (m); mastrarhvalur (m); mastrarfiskur (m); æðuhvalur (m); rovhvalur (m); steyrhvalur (m)
orgasm	orgasma (f)
orphan	foreldraloysingur
osmium	osmium
osprey	fiskiørn (f)
ostrich	strutsur
otter	otur
over	yvir
owl	ugla; ugli (m); úla (f)
own	eiga
owner	eigari (m)
ox	oksi (m)
oxygen	súrevni (n); ilt (n)
oystercatcher	tjaldur (n)
pair of eyeglasses	brillur (f)
pair of glasses	brillur (f)
pair of specs	brillur (f)
pair of spectacles	brillur (f)
palladium	palladium
paper	pappír
parents	foreldur (n)
parrot	pappageykur (m)
part	lutur (m); partur (m)
partridge	akurhøna
password	loyniorð
past participle	tátíðar lýsingarháttur (m)
pastry	baksturvøra (f)
paternal grandfather	abbi, faðirfaðir (m)
patriarch	ættfaðir (m)
patriarchal	ættfaðirligur
peacock	páfuglur
peanut	jarðnøt (f)
pear	pera (f)
penalty area	brotsteigur (m)
penalty kick	brotsspark (n)
pencil	blýantur (m)
penicillin	penicillin
people	tjóð
peregrine falcon	ferðafalkur
person	persónur; einstaklingur (m)
petrol	bensin (n)
pheasant	fasánur
phonetics	ljóðfrøði (f); ljóðlæra (f)
phosphorus	fosfor
photograph	ljósmynd (f)
phylum	fylki (n)
pig	svín (n)
pigeon	dúgva (f)
pilot whale	grindahvalur
pine	furu
pink	ljósareyður
pirate	piratur (m)
planet	gongustjørna (f)
plant	plantur; planta
platinum	platin
plotter	teknari (m)
plutonium	plutonium
poison	eitra
police	løgreglan
polonium	polonium
polygon	marghyrningur
poplar	øsp (f)
population	fólkatal (n)
porridge	greytur (m)
position	støða (f)
possessive pronoun	ognarfornavn (n)
postage stamp	frímerki (n)
postcard	postkort
potassium	kalium
potato	epli (n); epl (n)
pound	pund (n)
praseodymium	praseodymium
preacher	prædikari (m); prædikumaður (m)
pregnant	við barn; upp á vegin; tvílívað (f)
present participle	nútíðar lýsingarháttur (m)
president	forseti (m)
pride	erni (n)
priest	prestur
print	prenta
printer	prentari (m)
prison	fongsul (n)
promethium	promethium
pronoun	fornavn
proper noun	sernavn (n)
property	ogn (f); landsogn (f)
protactinium	protaktinium
psalm	sálmur
ptarmigan	fjallarýpa (f); rýpa (f)
puberty	kynsbúning (f); pubertetur (m)
puddle	hylur (m); trygil (m)
puffin	lundi (m)
pupil	sjónop (n)
quack	gvagg; kvagg
quail	vaktil
queen	drotning (f); frúgv (f)
rabbit	kanin
radioactive	geislavirkin
radon	radon (n)
rain	regna
rainbow	ælabogi (m)
ram	veðrur (m); veður
rape	neyðtaka
rat	rotta
raven	ravnur; krunkur; gorpur
razorbill	álka (f)
read	lesa
recent	feskur
red	reyðtítlingur (m)
red admiral	admirálur (m)
red cabbage	reyðkál (n)
red deer	krúnhjørtur
red wine	reyðvín (n)
reflexive pronoun	afturbent fornavn (n)
refrigerator	køliskáp (n)
relative pronoun	afturbeint fornavn (n)
reptile	skriðdýr; skriðdjór (n)
republic	lýðveldi (n)
result	úrslit (n)
rhenium	renium
rhodium	rodium
rhubarb	rabarba (f)
rock	grót
rock dove	bládúgva
rock pipit	grátítlingur (m)
roe	rogn (n)
roe deer	rádýr
rook	rókur
rose	rósa (f)
rough horsetail	vetrarbjølluvísa (f)
rowing	róður (m)
rubidium	rubidium
rucksack	ryggsekkur (m)
rune	rún (f)
ruthenium	ruthenium
rye	rugur (m)
rye bread	rugbreyð (n)
sack	sekkur (m)
saga	søga (f)
salmon	laksur (m)
salt	saltkendur
samarium	samarium
sand	sandur (m)
sandpiper	grælingur (m)
save	bjarga
scandium	skandium
sceptre	veldisstavur (m)
sciatica	iskias (n); lærmønuverkur (m)
science	vísindi (n)
scissors	saksur (m)
scorpion	sporðdreki (m); skorpión (f)
scout	skóti (m)
scum	skúm (n)
sea	hav (n); sjógvur (m)
sea lion	sjóljón (n); sjóløva (f)
seagull	mási (m)
seal	kópur (m)
season	árgangur (m)
second	sekund
second cousin	trímenningur (m)
see	skilja; fata
seed	fræ
seldom	sjáldan
selenium	selen
semen	sáð (n); spin (n)
serenade	aftansongur (m)
seven	sjey
seven deadly sins	tær sjey deyðssyndirnar
sewing machine	seymimaskina (f)
sexual intercourse	samlega (f)
shade	skuggi (m)
shadow	skuggi (m)
share	partabræv (n)
shark	hávur (m)
she	hon
sheep	seyður
ship	skip (n)
shit	skræpa (f)
shoulder	øksl (f)
shoulder blade	herðablað (n)
shrew	trantmús (f)
shrimp	rækja (f)
signature	undirskrift (f)
silence	tøgn (f)
silicon	silicium
silver	silvur
silver nitrate	silvurnitrat (n)
sin	synd (f)
siskin	grønígða (f)
sit	sita
six	seks
skeleton	beinagrind (f)
ski	skíð (f)
skinflint	kargapisa (f); nábalsklógv (f)
skirt	skjúrt 
skua	kjógvi
skull	skøltur (m); heysur (m); skalli (m); skróvbein (n)
small	lítil
smile	smíla; brosa
smoke	roykur (m)
snipe	snípa (f)
snow	kavi (m); snjógvur (m)
socialism	sosialisma
sodium	natrium
soldier	hermaður (m)
somewhere	einastaðni; onkustaðni
son	sonur
song	sangur (m); songur (m)
soon	skjótt; brátt
sound	ljóð (n)
soup	súpan (f)
southwest	útsynningur (m)
spark	neisti (m)
sparrow	spurvur (m)
sparrow hawk	spurvaheykur
spear	spjót (n)
spectacles	brillur (f)
spice	krydd (n); kryddarí (n)
spider	eiturkoppur (m)
spinning wheel	rokkur (m)
spleen	milti (n); milt (n)
spoon	skeiđ (f); spónur (m)
spotted dragonet	blettutur floyfiskur
squirrel	íkorni (m)
star	stjørna (f)
starfish	krossfiskur
starling	stari
steam	guva (f)
step	stjúk-
stepfather	stjúkfaðir (m)
stone	steina
stork	storkur
storm petrel	drunnhvíti (m)
street	gøta (f)
strip	strippa
strontium	strontium
subjunctive	hugsháttur (m)
submarine	kavbátur (m)
sulfur	svávul (n)
summer	summar (n)
sun	sól (f)
sundew	sóldøgg (f)
surname	eftirnavn (n)
swaddle	reiva
swallow	svala
swan	svanur (m)
swear	svørja
sweet	søtur
swim	svimja
swine	svín (n)
sword	svørð (n); mæki (m)
talk	tala
tandem	tvísúkkla (f)
tantalum	tantal
tawny owl	músagjóð
tea	temunnur (m); tedussur (m); temuður (m)
tear	tár (n)
technetium	technetium
teenager	tannáringur (m)
telephone	telefon
television	sjónvarpstól (n)
tellurium	tellur
terbium	terbium
tern	terna (f)
testicle	eista (n)
thallium	thallium
thanks	takk
that	ið; sum
theoretical	ástøðiligur
there	har
they	teir (m); tær (f); tey (n)
thief	tjóvur (m)
thirst	tysta
this	hesin (m); henda (f); hetta (n)
thither	hagar
thorium	thorium
thorn	torn (m)
thou	tú
thousand	túsund
throw	kasta
thulium	thulium
thunderstorm	toruveður
ticket	atgongumerki (n)
tiger	tikari (m)
time	tíð (f)
tin	tin
tit	bróst (n); boppa (f)
titanium	titan
to	til
toe	tá (f)
tongue	tunga (f)
tooth	tonn (f); tenn (f)
topic	evni (m)
tower	torn (n)
tractor	traktorur (m)
train	tog
translator	týðari (m); tolkur (m); umsetari (m)
trawler	trolari (m)
tree	træ
trip	ferð; reisa
troposphere	lághválv (n)
trousers	buksur (f)
tufted duck	trøllont (f)
tulip	tulipan (f)
tungsten	wolfram
turkey	kalkun
turnip	mairót (f)
turtle dove	turtildúgva
twelve	tólv
twin	tvíburi
twite	íriskur (m)
two	tveydollaraseðil (m)
udder	júgur (n)
un	ó-
underwear	undirklæði (n)
universe	alheimur (m)
university	fróðskaparsetur (n)
uranium	uran (n)
useful	nýttigur
vacuum cleaner	dustsúgvari (m)
vanadium	vanadium
velvet scoter	spegilsont (f)
verb	sagnorð (n)
vigilante	sjálvrættarmaður
village	bygd (f)
virus	virus
vocative case	vokativ (n)
voice	rødd (f); reyst (f)
volcano	gosfjall
volt	volt (n)
vulture	gammur
wake	vøka (f)
wall	veggur (m)
walrus	roysningur (m)
war	kríggj (n)
watch	ur (n)
water	vatn (n)
waterfall	fossur (m)
watt	watt (n)
wave	vágur (m); bylgja (f)
waxwing	reyðstapi (m)
way	vegur (m)
weak	veikur
weapon	vápn (n)
weather	veður (n)
weave	spinna
week	vika (f)
weekend	vikuskifti (n)
weight	vekt (f); massi (m)
welcome	vælkoma
werewolf	varúlvur
wether	geldingur (m)
whale	hvalur (m)
what	hvat
what is your name	hvussu eita tygum 
wheat	hveiti
when in Rome, do as the Romans do	sær er siður á landi
whimbrel	spógvi (m)
whip	píska
white	hvítur (m); hvít (f); hvítt (n)
white wine	hvítvín (n)
who	sum; ið
whore	hora (f)
why	hví
why not	hví ikki?
widow	einkja (f)
wife	kona (f); vív (n)
wild boar	villsvín
wildcat	villkøttur
willow	pílur (m)
window	vindeyga (n)
windowpane	rútur (m)
wine	vínreyður
winter	vetur (m)
wisent	evropiskur bisonur
wish	ynskja
wolf	úlvur (m)
woman	kona (f); kvinna (f)
woodpecker	spæta
woof	voff
word	orð (n)
words	orð
world	verøld; heimur (m); verð (f)
world record	heimsmet (n)
wren	mortítlingur; músabróðir
write	rita; skriva
xenon	xenon
year	ár (n)
yeast	ger (f)
yell	rópa
yellow	gulur
yes	jú
yesterday	í gjár
yew	takstræ (n)
yolk	reyði (m); eggjareyði (m)
ytterbium	ytterbium
yttrium	yttrium
zinc	sink
