English	Portuguese
AIDS	SIDA (m); AIDS (f); síndrome da imunodeficiência adquirida (f)
Abidjan	Abidjan (Abijão / Abijã)
Abkhaz	abcaz; abecásio; abecázio; abcázio; abcásio
Abkhazia	Abecásia (f)
Abraham	Abraão
Adam	Adão
Afghanistan	Afeganistão (m)
Africa	África (f)
Afrikaans	africâner; africânder 
Alaska	Alasca (f)
Albania	Albânia (f)
Alberta	Alberta
Alexander	Alexandre (m)
Algeria	Argélia (f)
Algiers	Argel (m)
Allah	Alá (m)
Alps	alpes (m)
America	América (f)
American	estado-unidense (m); norte-americano (m)
American bison	bisão-americano (m), bisonte americano
Amsterdam	Amesterdão (f); Amsterdã (f) 
Amur	Amur (m)
Andorra	Andorra
Andrew	André
Anglo	língua inglesa antiga (f)
Angola	Angola
Ankara	Ancara (f)
Antarctica	Antártica
Antigua and Barbuda	Antígua e Barbuda
April	abril (m)
Arabic	árabe (m)
Arctic Ocean	Oceano Ártico (m)
Argentina	Argentina
Argonaut	Argonautas
Armenia	Arménia (f); (f)
Armenian	arménio (m)
Asclepius	Esculápio
Asia	Ásia (f)
Athena	Atena (f)
Athens	Atenas (f)
Atlantic Ocean	Atlântico (m); oceano Atlântico (m)
August	agosto (m)
Australia	Austrália (f)
Austria	Áustria (f)
Aymara	língua aimará
Azerbaijan	Azerbaijão (m)
Azeri	azerbaijano
Bahamas	Bahamas (f'p)
Bahrain	Bahrein; Barém
Baku	Bacu
Balearic Islands	Baleares (p)
Baltic Sea	mar Báltico (m)
Bambara	bambara (m)
Bangkok	Banguecoque (m)
Bangladesh	Bangladeche; Bangladesh (m)
Barbados	Barbados
Bashkir	bachquir (m)
Beijing	Pequim (m)
Beirut	Beirute
Belarus	Bielorrússia (f); Belarus
Belarusian	belorusso (m); bielo-russo (m)
Belgium	Bélgica
Belgrade	Belgrado
Belize	Belize
Belorussian	belorusso, bielo-russo
Berlin	Berlim
Bermuda	Bermudas
Bhutan	Butão
Bible	Bíblia (f)
Black Sea	Mar Negro (m)
Bolivia	Bolívia
Bosnia	Bósnia
Bosnia and Herzegovina	Bósnia e Herzegovina (f); Bósnia-Herzegóvina (f)
Bosphorus	Bósforo (m)
Botswana	Botsuana (f)
Brazil	Brasil (m)
Breton	bretão
Brunei	Brunei
Brussels	Bruxelas
Bucharest	Bucareste
Buddha	Buda (m)
Bulgaria	Bulgária (f)
Bulgarian	búlgaro (m)
Burkina Faso	Burquina Faso
Byzantine Empire	Império Bizantino (m)
Cambodia	Camboja (f)
Cameroon	Camarões
Canada	Canadá (m)
Cape Verde	Cabo Verde
Carthage	Cartago (m)
Caspian Sea	Mar Cáspio (m)
Catalan	catalão
Caucasus	Cáucaso (m)
Central African Republic	República Centro-Africana
Chad	Chade
Chile	Chile
China	China (f)
Chinese	os chineses (m'p)
Chisinau	Chișinău
Christ	Cristo (m)
Christian	cristão (m); cristã (f)
Christianity	cristianismo
Christmas	Natal (m)
Christopher	Cristóvão
Coca	Coca-Cola (f)
Colombia	Colômbia (f)
Commonwealth of Independent States	Comunidade de Estados Independentes (f); CEI (f)
Constantinople	Constantinopla
Copenhagen	Copenhague
Costa Rica	Costa Rica
Croatia	Croácia
Croatian	croata
Cuba	Cuba (f)
Cyprus	Chipre (m)
Cyrillic	cirílico (m)
Cyrillic alphabet	cirílico (m)
Czech	tcheco (Brazil), checo
Czech Republic	República Tcheca
Czechia	Chéquia (f)
Czechoslovakia	Tchecoslováquia (f); Checoslováquia (f)
Danish	dinamarquês (m)
Danube	Danúbio (m)
Dead Sea	Mar Morto (m)
December	dezembro (m)
Denmark	Dinamarca (f)
Djibouti	Jibuti
Dominican Republic	República Dominicana
Dutch	holandês; neerlandês
Earth	Terra (f)
East Timor	Timor Leste
Easter	Páscoa
Easter Island	Ilha de Páscoa (f)
Eastern Europe	Leste Europeu (f)
Edmonton	Edmonton
Egypt	Egipto (m); Egito (m) 
England	Inglaterra (f)
English	inglês (m); inglesa (f); ingleses
Esperanto	(l'pt'esperanto) (m)
Estonia	Estónia; Estônia 
Ethiopia	Etiópia (f)
Eurasia	Eurásia (f)
Europe	Europa (f)
European Union	União Europeia (f)
European bison	auroque (m), bisão-europeu (m), bisonte europeu
Far East	Extremo Oriente (m)
Faroe Islands	(f) Ilhas Faroé (f); Ilhas Feroe (f)
Faroese	faroês
February	fevereiro (m)
Fiji	Fiji
Finland	Finlândia
Finnish	finlandês
France	França (f)
French	franceses (m)
Friday	sexta-feira (f)
GDP	PIB
Ganges	Ganges
Gaza Strip	faixa de Gaza (f)
Geneva	Genebra
George	Jorge
Georgia	Geórgia (f)
Georgian	georgiano (m)
German	alemão (m); (f) (m)
Germany	Alemanha (f)
Ghana	Gana
Ghent	Gante
Gibraltar	Gibraltar (m)
Goa	Goa
Great Britain	Grã-Bretanha (f)
Great Pyramid of Giza	Pirâmide de Quéops (f)
Greece	Grécia (f)
Greek	grego (m), grega (f), gregos (m'p), gregas (f'p)
Greenland	Groenlândia (f); Gronelândia (f)
Guatemala	Guatemala
Guinea	Guiné
Gujarati	gujarati (m)
Gulf of Finland	golfo da Finlândia (m)
Guyana	Guiana
Haiti	Haiti
Happy New Year	Feliz Ano Novo
Hebrew	hebraico (m); hebreu (m)
Hezbollah	Hizbollah
Hindi	hindi
Hokkaido	Hokkaido
Holland	Holanda (f)
Holocaust	Holocausto (m)
Holy Spirit	Espirito Santo
Honduras	Honduras
Hong Kong	Hong Kong
Hungarian	húngaro (m); húngara (f)
Hungary	Hungria (f)
I	eu
I am English	eu sou inglês (m); eu sou inglesa (f)
I have a question	eu tenho uma pergunta; tenho uma pergunta
I love you	eu amo você
I need an interpreter	eu preciso de um intérprete; preciso de um intérprete
Iceland	Islândia (f)
India	Índia (f)
Indian Ocean	Oceano Índico (m)
Indonesia	Indonésia (f)
Interlingua	interlíngua (f)
International Phonetic Alphabet	alfabeto fonético internacional (m)
Internet	Internet (f)
Iran	Irã (m)
Iraq	Iraque
Ireland	Irlanda (f)
Irish	Irlandês (m), Gaélico (m)
Islam	Islã (m); Islão (m); Islame (m)
Israel	Israel
Italian	italiano (m)
Italy	Itália (f)
Jamaica	Jamaica
January	janeiro (m)
Japan	Japão (m)
Japanese	nipônico (m); nipônica (f)
Jerusalem	Jerusalém (f)
Jesus	Jesus (m)
Jesus Christ	Jesus Cristo (m)
Jew	judeu (m); judia (f)
Jewish	judaico
John	João
Jordan	Jordânia (f)
Joseph	José
Judaism	judaísmo (m)
July	julho (m)
June	junho (m)
Jupiter	Júpiter (m)
Kannada	canará (m); canarês (m)
Karnataka	Karnataka
Kazakhstan	Cazaquistão (m)
Kenya	Quénia (f)
Khartoum	Cartum (m)
Khmer	khmer (m)
Khrushchev	Khrushchov
Kiev	Kiev (m)
Korea	Coreia (f)
Korean	coreano (m)
Kosovo	Kosovo
Kurdish	curdo (m)
Kuwait	Kuwait
Kyrgyzstan	Quirguizistão
Laos	Laos
Latin	latim (m)
Latvia	Letónia
Lebanon	(m)
Liberia	Libéria
Libya	Líbia
Liechtenstein	Liechtenstein; Listenstaine (m)
Lisbon	Lisboa (f)
Lithuania	Lituânia
London	Londres (f)
Luxembourg	Luxemburgo (m)
Lyons	Lyon
Macedonia	Macedónia (Portugal) (f), Macedônia (Brazil) (f)
Magna Carta	Magna Carta (f)
Malayalam	malaiala
Malaysia	Malásia (f)
Maldives	Maldivas (f)
Malta	Malta (f)
Man	homem (m); ser humano (m); humano
Manchuria	Manchúria (f)
Maoism	maoísmo (m)
March	março (m)
Mars	Marte (m)
Marshall Islands	Ilhas Marshall
Mary	Maria
Matthew	Mateus
Mauritius	Maurícia
May	maio (m)
Mediterranean Sea	Mediterrâneo (m)
Mercury	(o planeta) Mercúrio (m)
Merry Christmas	Feliz Natal
Mexico	México (m)
Michael	Miguel (m); (m)
Middle East	Oriente Médio
Minsk	Minsk (m)
Miss	senhorita (f) 
Moldova	Moldávia (f)
Monaco	Mónaco (m)
Monday	segunda-feira (f)
Mongolia	Mongólia (f)
Morocco	Marrocos
Moscow	Moscou (f); Moscovo (f)
Moses	Moisés (m)
Mount Everest	Monte Everest (m)
Mozambique	Moçambique
Mrs	Sra
Muhammad	Maomé (m)
Mumbai	Bombaim
Munich	Munique (m)
Muslim	muçulmano (m)
Myanmar	Mianmar (m); Birmânia (f)
Namibia	Namíbia
Naypyidaw	Naypyidaw
Nepal	Nepal
Neptune	Netuno (m)
Netherlands	Holanda (f); Países Baixos; Neerlândia (f)
New Delhi	Nova Deli (f)
New York City	Nova Iorque (f)
New Zealand	Nova Zelândia (f)
Nicaragua	Nicarágua
Nicholas	Nicolau
Niger	Níger
Nigeria	Nigéria (f)
North America	América do Norte (f)
North Korea	Coreia do Norte (f)
Northern Europe	Europa setentrional (f)
Northern Ireland	Irlanda do Norte
Norway	Noruega (f)
November	novembro (m)
Occitan	occitano
Oceania	Oceania (f)
October	outubro (m)
Olympic Games	Jogos Olímpicos 
Oman	Omã
Ottoman Empire	Império Otomano (m)
Pacific Ocean	Oceano Pacífico (m)
Pakistan	Paquistão (m)
Palestine	Palestina (f)
Panama	Panamá
Papua New Guinea	Papua-Nova Guiné
Paris	Paris (m)
Paul	Paulo
Persian	persa (m)
Peru	Peru (m)
Philippines	Filipinas (f)
Pisces	#Portuguese'Pisces (m'p) (Portugal), Peixes (m'p) (Brazil)
Pleiades	Plêiades
Pluto	Plutão (m)
Poland	Polónia (f); Polônia (f) 
Polish	polonês (m); polaco (m)
Portugal	Portugal (m)
Portuguese	português (m)
Prague	Praga
Pythagoras	Pitágoras
Red Sea	mar Vermelho
Reykjavik	Reiquijavique (m); Reykjavik (m)
Roman	Romano
Romania	Roménia (f)
Romanian	romeno (m)
Rome	Roma (f)
Russia	Rússia (f)
Russian	russo (m); russa (f)
Russian Federation	Federação Russa (f)
Rwanda	Ruanda
Saint Petersburg	São Petersburgo (m)
San Marino	São Marinho; São Marino (m); San Marino (m)
Sanskrit	sânscrito (m)
Santa Claus	Pai Natal (m), Papai Noel (m) (Brazil)
Satan	Satanás (m); Satã
Saturday	sábado (m)
Saturn	Saturno (m)
Saudi Arabia	Arábia Saudita (f)
Scotland	Escócia (f)
Senegal	Senegal
Seoul	Seul
September	setembro (m)
Serb	sérvio (m)
Serbia	Sérvia
Serbia and Montenegro	Sérvia e Montenegro
Serbian	sérvio (m)
Shanghai	Xangai
Siberia	Sibéria (f)
Sicily	Sicília
Slovakia	Eslováquia
Slovene	esloveno (m)
Slovenia	Eslovénia (f)
Snow White	Branca de Neve (f)
Sochi	Sóchi (m)
Sofia	Sófia
Solar System	sistema solar (m)
Somalia	Somália
South Africa	África do Sul (f)
South America	América do Sul (f)
South Asia	Ásia do Sul (f); Ásia Meridional (f)
South Korea	Coreia do Sul (Portugal), Coréia do Sul (Brazil)
South Ossetia	Ossétia do Sul (f)
South Sudan	Sudão do Sul (m)
Southeast Asia	Sudeste asiático (m)
Soviet Union	União Soviética (f)
Spain	Espanha (f)
Spanish	espanhol (m); espanhola (f)
Sparta	Esparta
Sri Lanka	Sri Lanka
Sudan	Sudão (m)
Suez Canal	Canal de Suez
Sunday	domingo (m)
Suriname	Suriname
Sweden	Suécia (f)
Swedish	sueco (m); língua sueca; linguagem sueca (f)
Switzerland	Suíça (f)
Syria	Síria
Taipei	Taipé (m)
Taiwan	Taiwan (f)
Tajikistan	Tajiquistão (m)
Tallinn	Tallinn
Tanganyika	Lago Tanganica
Tanzania	Tanzânia (f)
Tbilisi	Tbilisi
Tehran	Teerã (m); Teerão (m)
Tel Aviv	Tel Aviv-Yafo
Ten Commandments	Dez Mandamentos (m'p)
Thai	tailandês (m)
Thailand	Tailândia
The Hague	a Haia (f)
Thursday	quinta-feira (f)
Transnistria	Transnístria (f)
Transylvania	Transilvânia (f)
Tuesday	terça-feira (f)
Tunisia	Tunísia
Turkey	Turquia (f)
Turkish	turco (m)
Turkmenistan	Turquemenistão (m)
USA	EUA (m)
USSR	URSS (f)
Uganda	Uganda
Ukraine	Ucrânia (f)
Ukrainian	ucraniano (m)
United Arab Emirates	Emiratos Árabes Unidos (m)
United Kingdom	Reino Unido (m)
United States	Estados Unidos (m)
United States of America	Estados Unidos da América (m); (m) EUA
Uranus	Urano (m)
Uzbekistan	Usbequistão (m)
Valkyrie	valquíria (f)
Vatican City	Vaticano
Venezuela	Venezuela (f)
Venus	Vénus 
Victory Day	Dia da Vitória (m)
Vienna	Viena (f)
Vietnam	Vietname (m); Vietnã (m) 
Vishnu	Vixnu
Wales	País de Gales (m)
Warsaw	Varsóvia (f)
Wednesday	quarta-feira (f)
Western Europe	Europa Ocidental (f)
Western Sahara	Saara Ocidental (m)
White House	Casa Branca (f)
White Sea	Mar Branco (m)
Wikipedia	Wikipédia
Wiktionary	Wikcionário
Wiktionary:Usability/flag	bandeira (f)
William	Guilherme
Wroclaw	Wrocław
Yangon	Yangum (m)
Yangtze	rio Yangtzé (m)
Yaoundé	Yaoundé (m)
Yellow Sea	Mar Amarelo (m)
Yemen	Iémen (m)
Yerevan	Erevan (m)
Yugoslavia	Jugoslávia (f); (f)
Zambia	Zâmbia (f)
Zoroastrianism	Zoroastrismo
aardvark	oricterope; porco-da-terra (m); jimbo (m); porco-formigueiro (m); timba (f); timbo (m); aardwark (m)
abacus	ábaco (m)
abandon	abandonar
abbot	abade
abbreviation	abreviatura (f); abreviação (f)
abdomen	abdómen (m), abdômen (m) (Brazil)
accordion	acordeão
acid	ácido (m)
acorn	bolota (f)
actinium	actínio (m)
actor	actor#Portuguese'actor (m), actriz (f) (Portugal); ator (m), atriz (f) (Brazil)
address	endereço (m)
adjective	adjectivo (Portugal), adjetivo (Brazil)
admiration	admiração (f)
adverb	advérbio (m)
advertisement	anúncio (m); publicidade (f); reclame (m); propaganda (f)
aeroplane	avião (m); aeroplano (m)
after	depois de
afternoon	tarde (f)
again	de novo, outra vez, novamente
age	idade, rarely edade (f)
aggressive	agressivo
agriculture	agricultura (f)
air	ar (m)
aircraft	aeronave (f); avião (m); aeroplano (m)
airplane	avião (m); aeroplano (m)
airport	aeroporto (m)
al	al-Qaeda
alcohol	álcool (m)
algorithm	algoritmo (m)
alive	vivo
all	todo (m); toda (f); todos; todas (f)
all rights reserved	todos os direitos reservados
alligator	jacaré (m)
almond	amêndoa (f)
almost	quase
alphabet	alfabeto (m)
already	já
also	também
aluminium	alumínio (m)
always	sempre
am	sou; estou
amber	âmbar (m)
ambulance	ambulância
americium	amerício (m)
ampersand	e comercial (m)
an	um (m); uma (f)
anal sex	sexo anal (m)
anarchism	anarquismo (m)
anchor	âncora (f)
and	e
angel	anjo (m)
anger	ira (f); raiva (f); cólera (f)
angry	bravo
animal	animal (m); besta (f)
anime	animé; animê (m)
ankle	tornozelo (m)
answer	resposta (f)
ant	formiga (f)
anthrax	carbúnculo
antimony	antimónio (Portugal), antimônio (Brazil) (m)
antonym	antónimo (m); antônimo (m) 
anus	ânus (m)
anvil	bigorna (f)
apple	maçã (f)
apple tree	macieira (f)
apricot	damasco (m) (italbrac'Brazil), abricó
archaeology	arqueologia (f)
architect	arquiteto (m), arquiteta (f)
architecture	arquitectura (f); arquitetura (f) 
argent	prata (f)
argon	argônio (m)
arm	braço (m)
armpit	axila (f)
army	exército (m)
arrow	flecha (f); seta (f)
arsenic	arsênio (m)
artichoke	alcachofra, alcachofra de comer, alcachofra hortense
article	artigo (m)
ash	cinza (f)
ask	pedir
ass	cu (m); bunda (f)
astatine	astato (m)
asteroid	asteroide (m)
astronomical unit	unidade astronômica (f)
astronomy	astronomia (f)
astrophysics	astrofísica (f)
at	a; em
at sign	arroba (f)
atom	átomo (m)
aubergine	berinjela (f)
aunt	tia (f)
autumn	outono (m)
avalanche	avalanche (f)
axe	machado (m)
axis	eixo (m)
babysitter	babá (m)
back	costas (f); lombo
bad	ruim; mau
badger	texugo (m)
bag	sacola; saco
bagpipes	gaita de foles (f)
bakery	padaria (f)
balcony	sacada (f); balcão (m)
bald	calvo; careca (m)
balloon	balão (m)
banana	banana (f)
bank	banco (m)
barcode	código de barras (m)
barium	bário
bark	casca (f)
barley	cevada (f)
barn owl	coruja-das-torres (f)
basalt	basalto (m)
basket	cesto (m); cesta (f)
basketball	basquete (m); basquetebol (m); bola-ao-cesto (f)
bat	morcego (m)
bathroom	banheiro (m)
battery	pilha (f); bateria (f)
battle	batalha (f)
bay	baía
be	ser
beach	praia (f)
beak	bico (m)
bean	feijão (m)
bear	urso (m)
beard	barba (f)
beautiful	belo (m); bela (f); bonito (m); bonita (f)
beauty	beleza (f)
beaver	castor (m)
because	porque; já que
become	tornar-se, virar, transformar-se em
bed	cama (f); leito (m)
bedroom	quarto (m); dormitório (m)
bee	abelha (f)
beech	faia
beef	bife (m)
beer	cerveja (f)
beetle	escaravelho (m); besouro (m)
before	antes de
begin	começar
behind	atrás
bell	sino (m)
belly	barriga (f)
belt	cinto (m)
berkelium	berquélio (m)
berry	baga (f)
beryllium	berílio (m)
better	melhor
bicycle	bicicleta (f)
big	grande
bill	bico (m)
billion	bilhão (m)
biochemistry	bioquímica (f)
biology	biologia (f)
bipolar disorder	transtorno bipolar (m)
birch	bétula (f)
bird	pássaro (m); ave (f)
birth	nascimento
birthday	aniversário (m)
biscuit	biscoito
bishop	bispo (m)
bismuth	bismuto (m)
bitch	cadela (f); cachorra (f); loba 
bite	morder
bitter	amargo
black	preto (m)
black grouse	galolira
black hole	buraco negro (m)
black woodpecker	peto preto
blackberry	amora (f)
blackbird	melro
blanket	cobertor (m); manta (f)
bleed	sangrar
bless you	saúde; santinho 
blind	cego
blog	blog (m)
blood	sangue
blue	azul (m)
boar	javali (m)
boat	barco (m)
body	corpo (m)
bomb	bomba (f)
bon appétit	bom apetite
bon voyage	boa viagem
bone	osso (m)
book	livro (m)
bookshop	livraria (f)
boot	bota (f)
boron	boro (m)
bottle	garrafa (f)
bow	arco (m)
box	caixa (f)
boy	garoto (m), garotinho (m), menino (m), petiz (m), guri (m), infante, pueril (child); moço (m), mocinho (m), rapaz (m), rapazote (m), rapazinho (m), mancebo (m), jovem (adolescent, lad, young male); pequerrucho (m), piquiticu (m), petitinho (m), catatau (m), baixinho (m), moleque (m), pivete (m), fedelho (m) (informal); putinho (m) (child / Portugal)
bra	sutiã (m)
brain	cérebro (m)
branch	galho (m); ramo
brave	bravo (m); brava (f)
bread	pão (m)
break	quebrar, partir, romper (if flexible material)
breakfast	café da manhã (m); desjejum (f); pequeno-almoço (m)
breast	seio (m); peito (m)
breathe	respirar; espirar
brick	tijolo
bride	noiva
bridge	ponte (f)
bromine	bromo (m)
broom	vassoura (f)
brother	irmão (m)
brown	castanho; marrom
brush	brocha (f); escova (f) 
bucket	balde (m)
buffalo	búfalo (m)
building	construção (f); edificação (f)
bull	touro (m); toiro (m)
bullet	bala (f)
bumblebee	zangão (m), mamangaba (f)
burn	arder; queimar; pirar
bus	ônibus (m); (m)
busy	ocupado
but	embora
butcher	talhante (m) and (f) (Portugal); açougueiro (m), açougueira (f) (Brazil)
butter	manteiga (f)
butterfly	borboleta (f)
buy	comprar; adquirir
buzzard	águia de asa redonda (f), milhafre (m)
cabbage	repolho (m); couve
cactus	cacto (m); cactus
cadmium	cádmio (m)
caesium	césio
café	café (m)
cake	bolo (m)
calcium	cálcio (m)
calendar	calendário (m)
calf	bezerro (m)
californium	califórnio (m)
camel	camelo (m)
can	poder, ser capaz, conseguir
canal	canal (m)
canary	canário (m)
cancer	câncer (m)
candle	vela (f)
canyon	canhão (m); desfiladeiro (m)
capercaillie	tetraz, galomontês
capital	capital (f)
capital city	capital (m'f)
capitalism	capitalismo (m)
car	carro (m); viatura (f); automóvel (m)
carbon	carbono (m)
carpenter	marceneiro (m); (m)
carpet	carpete (m); tapete (m); alcatifa
carrot	cenoura (f)
carry	carregar; levar
castle	castelo (m)
cat	felino (m); felina (f)
caterpillar	lagarta (f)
cave	caverna (f)
cedar	cedro (m)
ceiling	teto (m)
cell	célula (f)
cell phone	telefone celular (m)
center	centro (m)
centimetre	centímetro (m)
centipede	centopeia (f); quilópode
century	século (m)
cerium	cério (m)
chain	cadeia (f); corrente (f)
chair	cadeira (f); assento
chamois	camurça
change	mudança (f); modificação (f)
chaos	caos (m)
chapter	capítulo (m)
chase	caçar; perseguir
cheap	barato
cheek	bochecha (f)
cheers	saúde; tim tim
cheese	queijo (m)
cheetah	guepardo (m); chita (f)
chemistry	química (f)
cheque	cheque (m)
cherry	cereja (f)
chess	xadrez (m)
chest	tórax (m); peito (m)
chestnut	castanha (f)
chew	mastigar
chicken	frango (m); galinha (f)
child	criança (f); menino (m); menina (f)
chimpanzee	chimpanzé (m)
chin	queixo (m)
chlorine	cloro (m)
chocolate	chocolate (m)
choice	escolha (f)
choir	coro (m); coral (m)
choose	escolher
chord	acorde
chromium	cromo (m); crómio (m)
church	igreja (f)
cigarette	cigarro (m)
cinema	cinema (f)
circle	círculo (m)
city	cidade (f)
clarinet	clarinete (m)
clay	argila (f)
clean	limpo
clitoris	clitóris (m)
clock	relógio (m)
close	fechar; cerrar
clothes	roupa (f); vestuário (m)
cloud	nuvem (f)
coast	costa; beira
cobalt	cobalto (m)
cock	galo (m)
cockroach	barata (f)
coconut	coco (m)
coffee	café (m)
coffin	caixão (m)
coin	moeda (f); prata (f)
cold	resfriado (m); constipação (f); gripe (f); gripa (f)
cold war	guerra fria (f)
color	cor (f)
columbine	aqüilegio (m); aquilégia
comb	pente (m)
come	vir
common gull	gaivota-parda; gaivota
communism	comunismo (m)
company	companhia (f)
compass	bússola (f)
computer	computador (m)
computer language	linguagem de computador (f); linguagem de programação (f)
comrade	camarada (m)
concrete	betão (m); concreto (m)
condom	preservativo (m); camisa-de-vênus (f); camisinha (f)
conjunction	conjunção (f)
connective tissue	tecido conjuntivo (m)
conscience	consciência (f)
continent	continente (m)
conversation	conversa (f)
copper	cobre (m)
corn	milho (m)
corpse	cadáver (m)
cotton	algodão (m)
cough	tossir
count	contar
country	campo (m)
courage	coragem (f)
cow	vaca (f)
crab	caranguejo (m); siri (m)
crane	grou
cream	creme (m); nata (f)
cricket	grilo (m)
crime	crime (m)
crocodile	crocodilo (m)
cross	cruz (f)
crossword	palavras cruzadas (f'p)
crow	corvo (m)
cruel	cruel
cry	chorar
crystal	cristal (m)
cube	cubo (m)
cuckoo	cuco (m)
cucumber	pepino (m)
culture	cultura (f)
cunt	boceta
cup	xícara; taça
curium	cúrio (m)
current	corrente (f)
curse	maldição (f)
cycling	ciclismo (m)
dance	dançar
dangerous	perigoso (m); perigosa (f)
dark	escuro
dark matter	matéria escura (f)
darkness	escuridão (f); trevas (f)
data	dados
date	encontro 
date palm	tamareira (f)
daughter	nora (f)
day	dia (m)
dead	morto
deaf	surdo
dear	caro (m); caro (f)
death	morte (f)
decade	década (f); decênio (m)
deer	veado (m); cervo (m)
delicious	delicioso (m)
democracy	democracia (f)
demon	demónio, demônio
dentist	dentista (m)
desert	deserto (m)
devil	diabo (m)
dew	orvalho (m); riço (m)
dialect	dialeto (m); dialecto (m) 
diary	diário
dick	caralho (m); picha (f); pica (f); jeba (f); verga (f); pau (m); pinto (m); cacete (m); vara (f); rola (f); piroca
dictionary	dicionário (m)
die	dado (m)
difficult	difícil
dig	cavar; escavar
dining room	sala de jantar (f)
dinosaur	dinossauro (m)
dirty	sujo (m); suja (f)
discussion	discussão (f)
disease	doença (f)
do	fazer
do you speak English	fala inglês?, falam inglês?
doctor	doutor (m), doutora (f)
documentation	documentação
dog	cão (m); cadela (f); cachorro (m); cachorra (f)
doll	boneca (f)
dollar	dólar (m)
dolphin	golfinho (m)
donation	doação (f)
donkey	asno (m); jerico (m); jegue (m); jumento (m); burro (m)
door	porta (f)
dormouse	arganaz (m)
doubt	dúvida (f); incerteza (f)
dove	pombo (m); pomba (f)
dozen	dúzia (f)
dragon	dragão (m)
dragonfly	libélula (f)
dream	sonhar
dress	vestido (m)
drink	bebida (f); drinque (m)
dromedary	dromedário (m)
drop	gota (f)
drum	tambor (m)
drunk	bêbado
dry	seco (m)
dubnium	dúbnio (m)
duck	pato (m); pata (f)
dust	pó (m); poeira (f)
duty	dever (m); obrigação (f)
dynamite	dinamite
dyslexia	dislexia
dysprosium	disprósio (m)
e	correio eletrônico; e-mail
e.g.	p. ex., ex. (por exemplo)
each	cada
eagle	águia (f)
eagle owl	bufo-real (m); corujão (m)
ear	orelha (f)
early	cedo
earthquake	terramoto (m); terremoto (m)
earthworm	minhoca (f)
east	este (m); leste (m)
easy	fácil (m)
eat	comer
echo	eco (m)
eco	eco-
ecology	ecologia (f)
economics	economia (f)
education	educação (f); ensino (m)
eel	enguia (f)
egg	ovo (m)
eight	oito
eighteen	dezoito
eighth	oitavo (m), oitava (f) ('abbreviations' 8º (m), 8ª (f))
eighty	oitenta
einsteinium	einstânio (m)
ejaculation	ejaculação (f)
elbow	cotovelo (m)
electricity	eletricidade
electromagnetism	electromagnetismo (m)
electron	electrão (m); elétron (m)
electronics	eletrônica
elephant	elefante (m); elefanta (f)
eleven	onze
elf	elfo (m)
embassy	embaixada (f)
emperor	imperador (m)
empty	vazio
encyclopedia	enciclopédia (f)
end	fim; cabo (m); término (m)
enemy	inimigo (m)
energy	energia (f)
enjoy your meal	bom apetite
enter	entrar
epithelium	epitélio
equation	equação (f)
erbium	érbio (m)
erection	ereção (f)
ermine	arminho (m)
erotic	erótico
etymology	etimologia (f)
euro	euro
europium	európio (m)
euthanasia	eutanásia (f)
evening	tarde; anoitecer
event horizon	horizonte de eventos (m)
every	cada
everybody	todos (m'p), todo o mundo (m), toda a gente (f)
everyone	todos (m'p), todo o mundo (m), toda a gente (f)
everything	tudo
evil	mau (m), má (f), maléfico (m), maléfica (f), ruim (m'f) (1,2)
expression	expressão (f)
eye	olho (m)
eye for an eye, a tooth for a tooth	olho por olho, dente por dente
eyebrow	sobrancelha (f)
eyelash	cílio (m); pestana (f)
eyelid	pálpebra (f)
face	face (f); rosto (m)
falcon	falcão (m)
fall	cair
fallow deer	gamo
family	família (f)
fan	leque (m)
far	longe; distante
farm	fazenda (f); sítio (m); granja (f)
farmer	fazendeiro (m); agricultor
fart	peidar
fast	jejum (m)
fat	gordo
father	sogro (m)
fear	temer; ter medo de
feather	pluma (f); pena (f)
federation	federação (f)
female	fêmea (f) (1,3); feminino (m) (1,2)
feminism	feminismo (m)
fermium	férmio (m)
ferret	furão (m)
ferry	balsa (f)
fever	febre (f)
fifteen	quinze
fifth	quinto (m), quinta (f) ('abbreviations' 5º(m), 5ª(f))
fifty	cinquenta (Portugal), cinqüenta (Brazil)
fig	figo (m)
fight	lutar 
film	filme (m)
finger	dedo (m)
fir	abeto (m)
fire	incêndio (m)
first	primeiro (m); primeira (f)
fish	peixe (m)
fist	punho (m)
five	cinco
flag	bandeira (f)
flame	chama (f); flama (f)
flea	pulga (f)
floor	andar (m)
flour	farinha (f)
flower	florir; florescer
fluorine	flúor (m)
flute	flauta (f)
fly	voar
fog	nevoeiro (m), névoa (f); (in Brasil:) neblina (f)
food	comida (f); alimento (m)
fool	bobo (m); tolo (m); idiota (m)
foot	febre aftosa
football	futebol (m)
for example	por exemplo
forefinger	dedo indicador (m), indicador (m), índice (m) (Portugal), dedo índex (m) (Portugal), índex (m) (Portugal)
forehead	testa (f)
foreign	estrangeiro
foreigner	estrangeiro (m); estrangeira (f)
forest	floresta (f); selva; bosque
forget	esquecer
fork	garfo (m)
fortress	fortaleza
forty	quarenta
fountain	fonte; chafariz
four	quatro
fourteen	catorze; quatorze
fourth	quarto (m), quarta (f) ('abbreviations' 4º, 4ª)
fox	raposa (f); raposa-vermelha
francium	frâncio (m)
free	livre
freedom	liberdade (f)
freedom of speech	liberdade de expressão (f)
friend	amigo (m); amiga (f)
friendship	amizade (f)
frog	rã (f)
from	de#Portuguese'de ('which see for forms of "de" before a definite article')
fruit	fruta ('collective') (f), fruto (m)
fuck	foder, montar, pinar, comer, transar, trepar
full	cheio
fungus	fungo (m)
future	futuro
gadolinium	gadolíneo (m)
galaxy	galáxia (f)
gall bladder	vesícula biliar (f)
gallium	gálio (m)
game	jogo (m)
garbage	lixo (m)
garden	jardim (m)
garlic	alho (m)
gas	gás (m)
gasoline	gasolina (f)
genitive	caso genitivo (m)
genocide	genocídio (m)
geography	geografia (f)
germanium	germânio (m)
geyser	géiser (m)
ghost	fantasma (m); espectro (m); espírito (m); aparição (f); assombração (f); (f) sombra (f); alma (f)
giant	gigante (m)
gift	presente (m); doação (f)
ginger	gengibre (m)
giraffe	girafa (f)
girl	menina (f); garotinha (f); meninota (f); menininha (f); puela (f); (f) moça (f); rapariga (f); jovem (f); mocinha (f); moçoila (f) 
give	dar
glacier	glaciar (m) (italbrac'Portugal), geleira (f) (italbrac'Brazil)
glass	copo (m)
glove	luva (f)
glue	cola (f)
go	ir
goat	bode (m); cabra (f)
god	deus (m)
gold	ouro (m)
golden eagle	águia-real (f)
golf	golfe (m)
gonorrhea	gonorreia (f)
good	bem (m)
good afternoon	boa tarde
good day	bom dia
good evening	boa noite
good luck	boa sorte 
good morning	bom dia
good night	boa noite
goodbye	adeus; até-logo; passe-bem; tchau
goose	ganso (m); gansa (f)
gooseberry	groselha (f)
goshawk	açor (m)
government	governo (m)
grammar	gramática (f)
grandchild	neto (m); neta (f)
granddaughter	neta (f)
grandfather	avô (m)
grandmother	avó (f)
grape	uva (f)
grass	erva (f); grama (f); relva (f)
grasshopper	gafanhoto (m)
graveyard	cemitério (m)
great spotted woodpecker	pica pau malhado grande
great tit	chapim
green	verde (m)
green woodpecker	peto verde
grey	cinza; cinzento (m); cinzenta (f); gris (m)
griffon vulture	grifo (m)
guest	hóspede (m)
guilt	culpa
guinea fowl	galinha d'angola (f)
guinea pig	cobaia (f), porquinho-da-índia (m), preá-da-índia (m)
guitar	guitarra (f); violão (m)
gull	gaivota (f)
gunpowder	pólvora (f)
gypsy	cigano (m); cigana (f)
hafnium	háfnio (m)
hail	granizo (m); saraiva
hair	pelo (m)
hajj	hajj (m); hadj (m)
half	metade (f)
hammer	martelo (m)
hammock	rede (f)
hamster	hamster (m)
hand	mão (f)
hangover	ressaca (f)
happen	acontecer; suceder
happiness	felicidade (f); alegria (f)
happy	feliz
happy birthday	feliz aniversário; parabéns
hard drive	disco rígido (m); disco duro (m)
hare	lebrão (m); lebre (f)
hassium	hássio (m)
hat	chapéu (m)
hate	odiar; odeiam (m)
hatred	ódio (m)
have	ter
hawk	gavião (m)
hay	feno (m); relva (f); forragem (f)
hazelnut	avelã (f)
he	ele
head	cabeça (f)
health	saúde
hear	ouvir
heart	coração (m)
heaven	céu (m)
heavy	pesado (m); pesada (f)
hedgehog	porco-espinho (m); ouriço (m)
heel	calcanhar (m)
helicopter	helicóptero (m)
helium	hélio (m)
hell	inferno (m)
hello	alô
help	socorro!, ajuda!
hemp	cânhamo; maconha
hen	galinha (f)
her	seu, dela (lit. "of hers", placed after the noun)
here	para aqui; para cá
hero	herói (m); heroína (f)
heron	garça (f)
hi	olá; oi; alô
hill	monte (m); colina (f); morro (m); (f) (m)
hippopotamus	hipopótamo (m)
his	seu
history	história (f)
holmium	hólmio (m)
home	lar (m); casa (f)
homophobia	homofobia (f)
homosexuality	homossexualidade (f)
honey	mel (m)
hoof	casco (m); pata (f); pezunho (m)
hope	esperar
horn	chifre (m); corno (m)
horse	cavalo (m); égua (f)
hospital	hospital (m)
hot	(muito) quente (m'f)
hotel	hotel (m)
hour	hora (f)
house	casa (f)
how	como
how are you	como vai; como estás; como você vai; tudo bem
how many	quantos (m); quantas (f)
how much	quanto
how much does it cost	quanto custa
how old are you	quantos anos você tem 
hug	abraço (m)
human	humano (m), humana (f); ser humano (m)
human being	ser humano (m)
human rights	direitos humanos (m)
humanism	humanismo
hundred	cem; cento
hunt	caçar
husband	marido (m); esposo (m)
hydrate	hidrato (m)
hydrogen	hidrogénio (m); (m)
hyena	hiena (f)
ibex	cabra alpina, cabra brava
ice	gelo (m)
ice cream	gelado (m); sorvete (m) 
iceberg	icebergue (m)
idiot	idiota (m)
if	se; caso
igneous rock	rocha ígnea (f)
ill	doente (m)
important	importante
in	em
index	índice (m)
indium	índio (m)
information	informação (f)
injury	dano (m)
ink	tinta (f)
insect	inseto (m) (1,3)
insulin	insulina (f)
intelligence	inteligência (f)
interesting	interessante
internal combustion engine	motor a explosão (m)
international	internacional
iodine	iodo
iridium	irídio (m)
iron	passar a ferro
is	é; está
island	ilha (f)
it	ele (m); ela (f); isso
jackdaw	gralha de nuca cinzenta
jay	gralha (f); gaio (m)
jellyfish	medusa (f); aguá-viva (f)
jihad	jihad (m)
joy	alegria (f)
juice	sumo (m); suco (m)
kangaroo	canguru (m)
kestrel	peneireiro-vulgar (m)
ketchup	catchup (m)
key	chave (f)
keyboard	teclado (m)
kidney	rim (m)
kill	matar
kilometre	quilômetro (m)
king	rei (m)
kingdom	reino (m)
kiss	beijar
kitchen	cozinha (f)
kite	papagaio (m); pipa (f); pandorga (f) 
knee	joelho (m)
knife	faca (f)
knight	cavalo (m)
know	conhecer
koala	coala (m)
krypton	crípton (m); criptônio (m)
ladybird	joaninha (f)
ladybug	joaninha (f)
lake	lago (m)
lamb	anho (m); cordeiro (m)
land	terra (f)
language	linguagem (de programação) (f)
lanthanum	lantânio (m)
large	grande
lark	cotovia (f)
last year	ano passado (m)
laugh	rir
lava	lava (f)
law	lei (f)
lawrencium	laurêncio (m)
lawyer	advogado (m); advogada (f)
lazy	preguiçoso
lead	chumbo (m)
leaf	folha (f)
learn	aprender
least weasel	doninha
leather	couro (m)
leech	sanguessuga (f)
leek	porro (m); alho-porro (m); alho-poró (m) 
left	esquerdo
leg	perna (f)
lemon	limão (m)
length	comprimento (m); extensão (f)
lesbian	lésbica (f)
lesser spotted woodpecker	pica pau malhado pequeno
lesson	lição (f)
letter	carta (f)
lettuce	alface (f)
library	biblioteca
lie	mentir
life	vida (f)
light	iluminar
light year	ano-luz (m) 
lighthouse	farol (m) 
lightning	relâmpago (m)
like	como
lily	lírio (m)
linguistics	lingüística (f)
lion	leão (m)
lip	lábio (m)
listen	escutar; ouvir
literature	literatura
lithium	lítio (m)
litre	litro (m)
little owl	mocho galego (m)
live	viver; morar
liver	fígado (m)
lizard	lagarto (m)
lobster	lagosta (f)
long	longo
look	olhar
look for	pesquisar; procurar
louse	piolho (m)
love	amor (m)
low	baixo (m); baixa (f)
lung	pulmão (m)
lute	alaúde (m)
lutetium	lutécio (m)
lynx	lince (m)
machine language	código de máquina (m)
mackerel	cavala (f)
mad	louco; maluco
magma	magma (m); lava (m)
magnesium	magnésio (m)
magpie	gralha (f); pega (f)
maize	milho (m)
mallard	pato-real (m)
mammal	mamífero (m)
man	homem (m); varão (m)
manganese	manganês (m) (Brazil), manganésio (Portugal)
mango	manga (f)
many	muitos
map	mapa (m), carta (f) ,carta geográfica (f)
maple	bordo
mare	égua (f)
marijuana	maconha (f) 
market	feira (f)
marmot	marmota
marten	marta
masturbation	masturbação, punheta (slang)
match	palito de fósforo (m)
maternal grandfather	avô maternal
mathematics	matemática (f)
mattress	colchão (m)
maybe	talvez
meal	refeição (f)
meat	carne (f)
medicine	medicina (f)
meet	encontrar
meitnerium	meitnério (m)
melon	melão (m)
memory	memória (f)
mendelevium	mendelévio (m)
mercury	mercúrio (m)
metal	metal (m)
microscope	microscópio (m)
midnight	meia-noite (f)
midwife	parteira (f)
milk	ordenhar
milliard	mil milhões
million	milhão (m)
millipede	centopéia (f); lacraia (f)
mind	mente (f)
mine	mina (f)
mineralogy	mineralogia (f)
mint	menta (f); hortelã
minute	minuto (m)
mirror	espelho (m)
moat	fosso (m)
mobile phone	telefone móvel (m), telefone celular (m), celular (m)
mole	toupeira (f); topeira (f)
molecule	molécula (f)
molybdenum	molibdénio (Portugal), molibdênio (m) (Brazil)
moment	instante (m); momento (m)
monarchy	monarquia (f)
monastery	mosteiro (m); monastério (m)
money	dinheiro (m)
monk	monge (m)
monkey	macaco (m)
month	mês (m)
moon	satélite (m); lua (f)
morning	manhã (f)
mosque	mesquita
mosquito	mosquito (m)
moss	musgo (m)
moth	mariposa (f)
mother	sogra (f)
mother tongue	língua materna (f)
motorcycle	motocicleta (f); moto (f)
mouflon	muflăo
mountain	montanha (f); monte (m)
mouse	rato (m); mouse (m)
moustache	bigode (m)
mouth	boca (f)
movie	filme (m) (1); cinema (m) (2)
much	muito(s), muita(s), um monte de
mud	lama (f)
mule	mula (m)
murder	assassínio (m); homicídio (m) 
muscle	músculo (m)
museum	museu (m)
mushroom	cogumelo (m)
music	música (f)
musician	músico (m)
muskrat	rato almiscareiro
mustard	mostarda (f)
my	meu (m); minha (f); meus (m); minhas (f)
mysterious	misterioso (m); misteriosa (f)
mystery	misterio (m)
mythology	mitologia (f)
nail	prego (m)
naked	nu
name	nome (m); fama (f); reputação (f)
narrow	estreito (m); estreita (f)
nature	natureza (f)
navel	umbigo (m)
nebula	nebulosa (f)
neck	pescoço (m)
necklace	colar (m)
needle	agulha (f)
neighbour	vizinho (m)
neodymium	neodímio (m)
neon	néon (m); neônio (m) 
neptunium	neptúnio (m)
nest	ninho (m)
nettle	urtiga (f)
neutrino	neutrino (m)
never	nunca; jamais
new	novo (m); nova (f)
news	noticiário (m)
newspaper	jornal (m)
nickel	níquel (m)
niece	sobrinha (f)
night	noite (f)
nightingale	rouxinol
nightmare	pesadelo (m)
nine	nove
nineteen	dezanove (Portugal), dezenove (Brazil)
ninety	noventa
ninth	nono (m), nona (f) ('abbreviation' 9º (m), 9ª (f))
niobium	nióbio (m)
nipple	mamilo (m), bico do seio (m) (1), chupeta (f), chupadouro (m), bico de mamadeira (m) (2)
nitrogen	nitrogénio (m); (m)
no	não
no smoking	é proibido fumar
nobelium	nobélio (m)
nobody	ninguém
non	organização não governamental (f)
nonkilling	não matar (m)
noon	meio-dia (m)
north	norte (m)
nose	nariz (m)
not	não
notebook	caderno (m)
nothing	nada
noun	substantivo (m)
now	agora
nude	nu
number	número (m)
nurse	enfermeira (f)
nut	noz (f)
oak tree	carvalho (m)
oar	remo (m)
obedience	obediência (f)
obesity	obesidade
oboe	oboé (m)
ocean	oceano (m)
octopus	polvo (m)
of	de
of course	claro; naturalmente
office	escritório (m)
often	freqüentemente
oil	petróleo (m); óleo (m)
old	velho
olive	azeitona (f); oliva (f)
on	na; no; sobre
once upon a time	era uma vez
one	um (m); uma (f)
onion	cebola (f)
open	aberto
operating system	sistema operativo (m); sistema operacional (m)
opinion	opinião (f)
or	ou
orange	laranjeira (f)
organ	órgão
organism	organismo (m)
orgasm	orgasmo (m)
orphan	órfão
osmium	ósmio (m)
ostrich	avestruz
other	outro
otter	lontra
our	nosso (m) 
ovary	ovário (m)
owl	coruja (f); estrige (f)
ox	boi (m)
oxygen	oxigénio (m); (m)
page	página (f)
pain	dor (m)
paint	tinta (f)
painter	pintor (m); pintora (f)
palace	palácio (m)
palladium	paládio (m)
palm	palma (f), palma da mão (f)'
pancreas	pâncreas (m)
pants	calças (f)
papaya	mamão (Brazil)
paper	papel (m)
paradox	paradoxo (m)
park	parque (m)
parliament	parlamento (m)
parrot	papagaio (m)
part	parte (f); pedaço (m)
partridge	perdiz (f)
passport	passaporte (m)
paternal aunt	tia (f)
paternal grandfather	(m)
peace	paz (f)
peach	pêssego (m)
peacock	pavão real, pavão
peanut	amendoim (m)
pear	pêra (f)
pen	caneta (f)
pencil	lápis (m)
penguin	pinguim / pingüim (m)
penicillin	penicilina (f)
peninsula	península (f)
penis	pénis (m); (m) membro (m)
people	povo (m)
pepper	pimenta (f)
percent	percento
peregrine falcon	falcão peregrino (m)
perestroika	perestroika (f)
perhaps	talvez
perineum	períneo (m)
periodic table	tabela periódica (f)
person	pessoa (f)
petrol	gasolina (f)
petroleum	petróleo (m)
pharaoh	faraó (m)
pharmacy	farmácia (f); drogaria (f)
pheasant	faisão
philosopher	filósofo (m)
phoenix	fênix (f); fénix (f) 
phone	telefone (m)
phosphorus	fósforo (m)
photograph	fotografia (f); foto (f); retrato (m)
photography	fotografia (f)
physics	física (f)
piano	piano (m)
picture	figura (f); imagem (f)
pie	torta (f)
piece	peça (f)
pig	porco (m)
pigeon	pombo (m); pomba (f)
piglet	porquinho (m); leitão (m)
pillow	travesseiro (m)
pimple	borbulha (f); espinha (f)
pin	alfinete (m)
pine	pinheiro (m)
pineapple	ananás (m); (m)
pink	cor-de-rosa; rosa
pirate	bucaneiro (m)
pizza	pizza (f)
place	lugar (m); local (m); posição (f)
planet	planeta (m)
plant	planta (f); plantas (f)
plate	prato (m)
platinum	platina (f)
platypus	ornitorrinco (m)
play	jogar
please	por favor; faça favor
pleasure	prazer (m)
plough	arado (m)
plum	ameixa (f)
plutonium	plutónio (m)
pocket	bolso (m)
poem	poema (m); poesia (f)
poetry	poesia (f)
poison	veneno (m); peçonha (f); tóxico (m)
polar bear	urso-polar (m), urso-branco (m)
polecat	toirăo
police	polícia (f)
policeman	policial (m)
polite	polido; cortês; educado
politician	político (m)
politics	política (f)
polonium	polónio (m)
polygon	polígono
pomegranate	romã (f)
poor	pobre
pope	papa (m)
pornography	pornografia (f)
port	porto (m)
post office	estação de correios (f); correio (m)
postage stamp	selo (m)
postcard	cartão-postal (m)
postcode	código postal (m); código de endereçamento postal (m); CEP (m)
postmodernism	pós-moderno (m)
potassium	potássio (m)
potato	batata (f), batatinha (f), marmêndoa (f)
pound	libra (f)
power	força (f); potência (f)
praseodymium	praseodímio (m)
prayer	oração
pregnancy	gravidez (f)
pregnant	grávida; prenha (f)
preposition	preposição (f)
prepuce	prepúcio (m)
president	presidente (m)
pretty	bonito
price	preço (m)
priest	padre (m); (m) presbítero (m)
prime minister	primeiro ministro (m)
prime number	número primo (m)
prison	prisão (f)
problem	problema (m)
promethium	promécio (m)
pronoun	pronome (m)
pronunciation	pronúncia; pronunciação (f); prolação (f)
property	propriedade (f)
prostitute	prostituta (f); mulher da vida (f)
protactinium	protactínio (m)
protect	proteger
proton	próton (m)
proverb	provérbio (m)
pumpkin	abóbora (f); jerimum (m) 
purple	roxo; púrpura
pyramid	pirâmide (f)
quail	codorna (f), codorniz (f)
quarter	quarto (m), quarta parte (f)
queen	dama (f); rainha (f)
question	questão (f); pergunta (f)
quotation marks	aspas (f)
rabbit	coelho (m)
radio	rádio (m)
radon	rádon (m)
railway	ferrovia
rain	chover
rainbow	arco-íris (m)
rake	ancinho (m); rastelo (m); rastel (m)
ram	carneiro (m); aríete (m)
rape	estupro (m)
raspberry	framboesa (f)
rat	rato (m); rata (f); ratazana (f)
raven	corvo (m)
read	ler
recent	recente
rectangle	rectângulo
red	vermelho, rubro (m), vermelha, rubra (f), encarnado (m), escarlate (n),
red deer	veado; cervo
refrigerator	refrigerador (m); geladeira (f)
reindeer	rena (f), rangífer (m), rangífero (m)
relative	parente (m)
religion	religião (f)
remember	lembrar-se, recordar-se
reptile	réptil (m)
republic	república (f)
restaurant	restaurante (m)
revenge	vingança (f)
revolution	revolução (f)
rhenium	rénio (m)
rhinoceros	rinoceronte (m)
rhodium	ródio (m)
rice	arroz (m)
rich	rico
rifle	fuzil (m); espingarda (f); rifle (m); refle (m)
right	correto; justo; certo
ring	anel (m)
ring finger	dedo anular (m); anular (m)
river	rio (m)
road	estrada (f); caminho (m); via (f)
robot	robot (m); robô (m)
roe deer	corço
roof	telhado (m)
rook	torre (f)
room	sala (m); aposento (m); quarto (m); câmara (f)
rooster	galo (m)
root	raiz (f)
rope	corda (f)
rose	rosa (f)
rubidium	rubídio (m)
ruble	rublo (m)
run	correr
ruthenium	ruténio (Portugal), rutênio (Brazil) (m)
rutherfordium	ruterfórdio (m)
rye	centeio (m)
saliva	saliva (f)
salmon	salmão (m)
salt	sal (m)
samarium	samário (m)
same	mesmo (m); o mesmo
sand	areia (f)
sandwich	sanduíche (m); sandes (f) 
sauce	molho (m)
sausage	salsicha (f); lingüiça (f)
saw	serra (f); serrote (m)
say	dizer
scandium	escândio (m)
scar	cicatriz (f)
schizophrenia	esquizofrenia (f)
school	faculdade (f)
science	ciência (f)
scissors	tesoura (f)
scorpion	escorpião (m); lacrau (m)
screech owl	coruja-das-torres (f)
scrotum	escroto (m)
sea	mar (m)
seaborgium	seabórgio (m)
seagull	gaivota (f)
seal	foca (f)
season	estação (f); sazão (f)
second	segundo (m)
secret	secreto (m)
see	ver
seed	semente (f)
selenium	selénio (m) (Portugal), selênio (m) (Brazil)
sell	vender
semen	sêmen (m)
send	enviar, emitir; coloq. mandar
sentence	frase (f)
service	serviço (m)
seven	sete
seventeen	dezassete, dezessete
seventh	sétimo (m), sétima (f) ('abbreviations' 7º (m), 7ª (f))
seventy	setenta
sex	sexo (m)
sexual orientation	orientação sexual (f)
shadow	sombra (f)
shark	tubarão (m)
she	ela
sheep	ovelha (f)
shepherd	pastor (m); pegureiro (m)
ship	navio (m)
shirt	camisa (f)
shit	cagar
shoe	calçado (m); sapato (m)
shop	loja (f)
shore	praia (f); costa (f); margem (f)
shoulder	ombro (m)
shrew	musaranho (m)
sick	doente (m)
sickle	foice (f)
silence	silêncio (m)
silicon	silício (m)
silk	seda (f)
silver	prata (f)
simple	simples
sin	pecado (m)
sing	cantar
singer	cantor (m); cantora (f)
sister	irmã (f)
sit	estar sentado
six	seis
sixteen	dezasseis, dezesseis
sixth	sexto (m), sexta (f) ('abbreviations' 6º, 6ª)
sixty	sessenta
skeleton	esqueleto (m)
skin	pele (f)
skirt	saia (f)
skull	caveira
sky	céu (m)
skyscraper	arranha-céu (m)
slave	escravo (m); escrava (f)
sleep	sono (m)
slow	lento; devagar
small	pequeno
smell	cheiro (m)
smile	sorrir
smoke	fumar
snail	caramujo (m); caracol (m)
snake	cobra (f)
sneeze	espirrar
snooker	sinuca (f)
snow	neve (f)
snowflake	floco de neve (m)
soap	sabão (m)
soccer	futebol (m)
socialism	socialismo (m)
sock	meia (f)
sodium	sódio (m)
sofa	sofá (m)
software	software (m); programa (m)
solar wind	vento solar (m)
soldier	soldado (m)
someone	alguém
something	algo, alguma coisa
sometimes	às vezes
son	filho (m)
song	canção (f)
soon	logo; cedo
sorry	desculpa; perdão; foi mal
soul	alma (f)
sound	som
soup	sopa (f)
sour	azedo
south	sul (m)
spacecraft	nave espacial; astronave
spaceship	espaçonave (f); nave espacial (f)
spacetime	espaço-tempo
spade	pá (f)
sparrow	pardal (m)
speak	falar
spectacles	óculos 
sphere	esfera (f)
spice	especiaria (f)
spider	aranha (f)
spirit	espírito (m)
spit	cuspir
spleen	baço (m)
spoon	colher (f)
sport	esporte (m) (Brazil), desporto (m) (Portugal)
spring	mola (f)
spruce	pícea; espruce
spy	espião (m)
square	praça (f)
squid	lula (f)
squirrel	esquilo (m)
stand	permanecer, ficar, estar ('de pé') ('em pé')
star	estrela (f); astro (m)
starling	estorninho (m)
station	estação (f)
statue	estátua (f)
steel	aço (m)
stomach	estômago (m)
stone	pedra (f); rocha; calhau; seixo (m)
stork	cegonha
story	estória (f); história, conto
strange	estranho (m)
strawberry	morango (m)
street	rua (f)
strength	força (f)
string	barbante (m); corda (f); fio (m)
strong	forte
strontium	estrôncio (m)
student	estudante
submarine	submarino (m)
suck	chupar; sugar
suddenly	de repente; repentinamente; subitamente
sugar	açúcar (m)
suicide	suicídio (m)
sulfur	enxofre (m)
summer	verão (m)
sun	sol (m)
sunflower	girassol (m)
surname	sobrenome (m); nome de família (m); último nome (m) 
swallow	engolir, deglutir, ingurgitar
swan	cisne (m)
sweet	doce
sweet potato	batata-doce (f)
sweetener	adoçante (m)
swim	nadar
swimming pool	piscina (f)
sword	espada (f)
system	sistema (m)
table	tabela (f)
tadpole	girino (m)
taiga	taiga
tail	rabo (m); cauda (f)
talent	talento (m)
talk	falar; conversar
tank	carro de combate (m); tanque (m)
tantalum	tântalo (m)
tattoo	tatuagem
tawny owl	coruja-do-mato (f)
taxi	táxi (m)
tea	folha de chá (f)
teach	ensinar
teacher	professor (m); professor (f); docente (m)
tear	lágrima (f)
technetium	tecnécio (m)
telephone	telefonar
telescope	telescópio (m)
television	televisor (m); televisão (f)
tellurium	telúrio (m)
temple	templo (m)
ten	dez
tent	tenda (f) 
tenth	décimo (m), décima (f) ('abbreviations' 10º (m), 10ª (f))
terbium	térbio (m)
territory	território (m)
terrorism	terrorismo (m)
terrorist	terrorista (m)
testicle	testículo (m)
thallium	tálio (m)
than	que 
thank you	obrigado (said by male); obrigada (said by female); bem haja
thank you very much	muito obrigado ('said by a male'), muito obrigada ('said by a female')
thanks	obrigado (m); obrigada (f)
that	esse (m), essa (f), esses (p), essas 'f/pl' (near); aquele (m), aquela (f), aqueles (p), aquelas 'f/pl' (far)
the	o (m); a (f); os (m); as (f)
their	seu; seus
there	aí; ali; lá
there is	existe; tem
they	eles (m); elas (f)
thief	ladrão (m); ladra (f)
thigh	coxa (f)
thimble	dedal (m)
thing	coisa (f)
think	pensar; refletir
third	terceiro (m), terceira (f), 'rarely:' terço (m), terça (f) ('abbreviations' 3º, 3ª)
thirst	sede (f)
thirsty	sequioso; sedento; com sede
thirteen	treze
thirty	trinta
this	este (m); esta (f); isto; estes (m); estas (f)
thorium	tório (m)
thorn	espinho; acúleo
thou	tu
thought	pensamento (m)
thousand	mil
thread	fio (m)
three	três
throat	garganta (f)
thulium	túlio (m)
thumb	dedo polegar (m); polegar (m)
thunder	trovão (m)
tiger	tigre (m)
time	vez (f)
tin	estanho (m)
tired	cansado (m); cansada (f)
titanium	titânio (m)
to	a; para
toad	sapo (m)
tobacco	tabaco (m)
today	hoje; hoje em dia; atualmente
toe	dedo (m) 
together	junto (m); junta (f)
toilet	banheiro (m) (Brazil), casa de banho (f) (Portugal)
tomato	tomate (m)
tomorrow	amanhã (m)
tongue	língua (f)
too	demais
tooth	dente (m)
toothbrush	escova de dentes (f)
tortoise	tartaruga (f); jabuti (m)
touch	tocar
tourism	turismo (m)
tower	torre (f)
town	vila (f); aldeia (f); povoado (m); arraial (m)
toy	brinquedo (m)
tradition	tradição (f)
train	trem (m); comboio (m)
tram	elétrico; bonde 
translate	traduzir
translation	tradução (f); obra traduzida (f)
translator	tradutor (m); tradutora (f)
travel	viajar
tree	árvore (f)
triangle	triângulo (m)
tribe	tribo (f)
trousers	calça (f); calças (f)
truck	caminhão (m)
true	verdadeiro
trumpet	trompete (m); trombeta (f)
tsar	tsar
tsunami	tsunami (m)
tungsten	tungstênio (m); tungsténio (m); volfrâmio (m)
turkey	peru (m)
turtle	tartaruga (f)
turtle dove	rola
twelve	doze
twenty	vinte e três (m)
twin	gêmeo (m)
two	dois (m); duas (f)
two hundred	duzentos (m); duzentas (f)
typhoon	tufão (m)
umbrella	guarda-chuva (m); sombrinha (f)
uncle	tio
understand	compreender; entender
unemployment	desemprego (m)
universe	universo (m)
university	universidade (f)
uranium	urânio (m)
urethra	uretra (f)
urine	urina (f)
use	usar; utilizar
useful	útil
vagina	vagina (f)
valley	vale (m)
vampire	vampiro (m)
vanadium	vanádio (m)
vegetable	verdura (f); hortaliça (f); legume (m)
verb	verbo (m)
very	muito
victory	vitória (f)
village	aldeia (f); vila; povoado
vinegar	vinagre (m)
violet	violeta (m); lilás (m)
violin	violino
virus	vírus (m)
visa	visto (m)
vodka	vodca (f)
voice	voz
volcano	vulcão (m)
volleyball	voleibol (m)
volt	volt (m)
vulture	abutre (m); urubu (m)
wait	esperar; aguardar
waiter	garçom (m)
wake up	acordar; despertar
walk	andar; caminhar
wall	muralha (f); muro (m)
walrus	morsa (f)
want	querer; desejar
war	guerra (f)
warm	quente (m'f)
wart	verruga (f)
wash	lavar
wasp	vespa
watch	relógio (m); relógio de pulso (m); (m)
waterfall	cascata (f)
watermelon	melancia (f)
wave	onda (f); vaga (f)
wax	cera (f)
way	caminho (m); via (f)
we	nós
weapon	arma (f)
web site	sítio (m); site (m); website (m) 
wedding	casamento (m)
week	semana (f)
weekend	final de semana; fim de semana
welcome	bem-vindo! (m), bem-vinda! (f), bem-vindos! (p), bem-vindas! (f'p)
well	bem
werewolf	lobisomem (m); licantropo
west	oeste (m); ocidente (m); poente (m)
wet	molhado
whale	baleia (f)
what	o que
what is your name	qual é o teu nome? como te chamas?
what time is it	que horas são? (Brazil)
wheat	trigo (m)
wheel	roda (f)
when	quando
where	onde; de onde 
where is the toilet	onde fica o banheiro? (Media:Onde fica o banheiro.ogg'hear it), onde fica o toalete? (Media:Onde fica o toalete.ogg'hear it) (Brazil); onde fica a casa de banho?, onde fica o quarto de banho? (Portugal)
whip	chicote (m); açoite (m)
whiskey	uísque (m)
white	branco (m); alvo (m); cândido (m)
who	quem
whole	inteiro
whore	puta (f), prostituta, meretriz, messalina, rameira, garota de programa, mulher de vida fácil, mulher da vida, cortesã, rapariga (Brasil), quenga, roda bolsinha, faz trottoir, peripatética, mulher da zona (de baixo meretrício).
why	por que
wide	largo; amplo
widow	viúva (f)
wife	esposa (f); mulher (f)
wild boar	javali
wildcat	gato-bravo (m), gato-selvagem (m), gato-montês (m)
willow	salgueiro (m)
wind	vento (m)
window	janela (f)
wine	vinho (m)
wing	asa (f)
winter	inverno (m)
wise	sábio
wisent	bisăo europeu, bisonte europeu
wish	desejar
witch	bruxa (f); bruxo (m)
with	com
without	sem
wolf	lobo (m); loba (f)
woman	mulher (f)
wood	madeira (f)
woodpecker	pica-pau (m)
wool	lã (f)
word	palavra (f); vocábulo (m)
work	trabalhar
workers of the world, unite	trabalhadores do mundo, uni-vos!; or proletários de todos os paí­ses, uni-vos!
world	mundo (m)
worm	verme (m)
wrist	pulso (m)
write	escrever; redigir
writer	escritor (m); escritora (f)
xenon	xenônio (m) (Brazil), xenónio (m) (Portugal)
xenophobia	xenofobia (f)
yawn	bocejar
year	ano (m)
yeast	fermento
yellow	amarelo (m)
yes	sim
yesterday	ontem
yoga	ioga
yoghurt	iogurte (m)
yolk	gema (f)
you	vós; vocês; os senhores (m); as senhoras (f) 
young	jovem
your	vosso (m); vossa (f) 
ytterbium	itérbio (m)
yttrium	ítrio (m)
zebra	zebra (f)
zero	zero (m)
zinc	zinco (m)
