English	Polish
0 (number)	0 (liczba)
1	1
1 (number)	1 (liczba)
10	10
10 (number)	10 (liczba)
100	100
1000	1000
1000 (number)	1000 (liczba)
101	101
105	105
11	11
11 (number)	11 (liczba)
110	110
115	115
12	12
12 (number)	12 (liczba)
120	120
125	125
13	13
13 (number)	13 (liczba)
130	130
135	135
14	14
14 (number)	14 (liczba)
140	140
144	144
145	145
15	15
15 (number)	15 (liczba)
150	150
155	155
16	16
16 (number)	16 (liczba)
160	160
165	165
17	17
17 (number)	17 (liczba)
170	170
1728	1728
175	175
1750s	Lata 50. XVIII wieku
1760s	Lata 60. XVIII wieku
1770s	Lata 70. XVIII wieku
1780s	Lata 80. XVIII wieku
1790s	Lata 90. XVIII wieku
18	18
18 (number)	18 (liczba)
180	180
1820s	Lata 20. XIX wieku
1830s	Lata 30. XIX wieku
1840s	Lata 40. XIX wieku
1850s	Lata 50. XIX wieku
1860s	Lata 60. XIX wieku
1870s	Lata 70. XIX wieku
1880s	Lata 80. XIX wieku
1890s	Lata 90. XIX wieku
19	19
19 (number)	19 (liczba)
190	190
1900s	Lata 1900-1909
1920s	Lata 20. XX wieku
1930s	Lata 30. XX wieku
1940s	Lata 40. XX wieku
1950s	Lata 50. XX wieku
1960s	Lata 60. XX wieku
1970s	Lata 70. XX wieku
1980s	Lata 80. XX wieku
1990s	Lata 90. XX wieku
2	2
2 (number)	2 (liczba)
20	20
20 (number)	20 (liczba)
200	200
21	21
21 (number)	21 (liczba)
22	22
22 (number)	22 (liczba)
23	23
23 (number)	23 (liczba)
24	24
24 (TV series)	24 godziny
24 (number)	24 (liczba)
25	25
25 (number)	25 (liczba)
26	26
26 (number)	26 (liczba)
27	27
27 (number)	27 (liczba)
28	28
28 (number)	28 (liczba)
29	29
29 (number)	29 (liczba)
3	3
3 (number)	3 (liczba)
30	30
30 (number)	30 (liczba)
300	300
31	31
31 (number)	31 (liczba)
32	32
32 (number)	32 (liczba)
33	33
33 (number)	33 (liczba)
34	34
34 (number)	34 (liczba)
35	35
35 (number)	35 (liczba)
36	36
36 (number)	36 (liczba)
37	37
37 (number)	37 (liczba)
38	38
38 (number)	38 (liczba)
39	39
39 (number)	39 (liczba)
4	4
4 (number)	4 (liczba)
40	40
40 (number)	40 (liczba)
400	400
41	41
41 (number)	41 (liczba)
42	42
42 (number)	42 (liczba)
43	43
43 (number)	43 (liczba)
44	44
45	45
45 (number)	45 (liczba)
46	46
46 (number)	46 (liczba)
47	47
48	48
49	49
49 (number)	49 (liczba)
5	5
5 (number)	5 (liczba)
50	50
50 (number)	50 (liczba)
500	500
51	51
52	52
53	53
54	54
55	55
56	56
57	57
58	58
59	59
6	6
6 (number)	6 (liczba)
60	60
60 (number)	60 (liczba)
61	61
62	62
63	63
64	64
65	65
66	66
67	67
68	68
69	69
7	7
7 (number)	7 (liczba)
70	70
71	71
72	72
73	73
74	74
75	75
76	76
77	77
78	78
79	79
8	8
8 (number)	8 (liczba)
80	80
80 (number)	80 (liczba)
81	81
82	82
83	83
84	84
85	85
86	86
87	87
88	88
89	89
9	9
9 (number)	9 (liczba)
90	90
91	91
92	92
93	93
94	94
95	95
96	96
97	97
98	98
99	99
A (Cyrillic)	А (cyrylica)
A cappella	A cappella
ABC	ABC
AIDS	Zespół nabytego niedoboru odporności
ALGOL	Algol (język programowania)
ATP	ATP (ujednoznacznienie)
AZ (football club)	AZ Alkmaar
Aachen	Akwizgran
Aalborg	Aalborg
Aar	Aare
Aardvark	Mrównik
Aarhus	Århus
Aaron	Aaron (postać biblijna)
Abacus	Abakus (liczydło)
Abadan	Abadan
Abbot	Opat
Abbreviation	Skrót
Abdomen	Odwłok
Abel Tasman	Abel Tasman
Abelian group	Grupa przemienna
Aberdeen	Aberdeen
Abidjan	Abidżan
Abkhazia	Abchazja
Abkhazia	Kategoria:Abchazja
Abolitionism	Abolicjonizm
Abortion	Aborcja
Abraham	Abraham (postać biblijna)
Abraham Lincoln	Abraham Lincoln
Absinthe	Absynt
Absolute magnitude	Absolutna wielkość gwiazdowa
Absolute value	Wartość bezwzględna
Absolute zero	Zero bezwzględne
Absolutism (European history)	Absolutyzm władzy
Abstract art	Abstrakcjonizm
Abstract expressionism	Ekspresjonizm abstrakcyjny
Abstraction	Abstrakcja (filozofia)
Abu Dhabi	Abu Zabi
Abu Dhabi (emirate)	Abu Zabi
Abuja	Abudża
Acacia	Akacja
Academy Award	Nagroda Akademii Filmowej
Acapulco	Acapulco
Acceleration	Przyspieszenie
Accipitridae	Jastrzębiowate
Accordion	Akordeon
Accountancy	Rachunkowość
Accountancy	Kategoria:Rachunkowość
Accra	Akra (Ghana)
Accusative case	Biernik
Acetaldehyde	Aldehyd octowy
Acetic acid	Kwas octowy
Acetone	Aceton
Acetylcholine	Acetylocholina
Acetylene	Etyn
Acheron	Acheron
Achillea millefolium	Krwawnik pospolity
Achilles	Achilles
Acid	Kwasy
Acid rain	Kwaśny deszcz
Acne vulgaris	Trądzik młodzieńczy
Aconcagua	Aconcagua
Acorn	Żołądź (botanika)
Acoustics	Akustyka
Acoustics	Kategoria:Akustyka
Acre	Akr
Acre	Akka
Acre (state)	Acre
Acropolis	Akropol
Actinide	Aktynowce
Actinium	Aktyn
Actor	Aktor
Acts of the Apostles	Dzieje Apostolskie
Acupuncture	Akupunktura
Ad hominem	Argumentum ad hominem
Ada (programming language)	Ada (informatyka)
Adam Smith	Adam Smith
Adana	Adana
Adansonia	Baobab
Addiction	Uzależnienie
Addis Ababa	Addis Abeba
Addition	Dodawanie
Adelaide	Adelajda
Aden	Aden
Adenine	Adenina
Adenosine triphosphate	Adenozynotrifosforan
Adiabatic process	Przemiana adiabatyczna
Adige	Adyga
Adjective	Przymiotnik
Admiral	Admirał
Adolescence	Dojrzewanie
Adolf Eichmann	Adolf Eichmann
Adolf Hitler	Adolf Hitler
Adonis	Adonis (mitologia grecka)
Adoption	Adopcja
Adrenal gland	Nadnercze
Adriatic Sea	Morze Adriatyckie
Adsorption	Adsorpcja
Adult	Dorosłość
Advent	Adwent
Adverb	Przysłówek
Advertising	Reklama
Aegean Sea	Morze Egejskie
Aeneas	Eneasz (mitologia)
Aeneid	Eneida
Aeolus	Eol
Aerodynamics	Aerodynamika
Aerosol	Aerozol
Aeschylus	Ajschylos
Aesop	Ezop
Aesthetics	Estetyka
Affix	Zrostek
Afghanistan	Afganistan
Afghanistan	Kategoria:Afganistan
Africa	Afryka
Africa	Kategoria:Afryka
African American	Afroamerykanin
Afrikaans	Język afrikaans
Agamemnon	Agamemnon
Agar	Agar-agar
Agate	Agat
Agatha Christie	Agatha Christie
Aggression	Agresja (psychologia)
Agnatha	Bezżuchwowce
Agnosticism	Agnostycyzm
Agora	Agora
Agoraphobia	Agorafobia
Agra	Agra
Agriculture	Rolnictwo
Agriculture	Kategoria:Rolnictwo
Agrigento	Agrigento
Aikido	Aikido
Ain	Ain (departament)
Air force	Wojska lotnicze
Airbus	Airbus
Aircraft	Statek powietrzny
Aircraft	Kategoria:Samoloty
Aircraft carrier	Lotniskowiec
Airline	Linie lotnicze
Airport	Lotnisko
Ajax	Ajax
Ajax (mythology)	Ajaks Wielki
Ajax (programming)	AJAX
Akhenaten	Echnaton
Akira Kurosawa	Akira Kurosawa
Al Capone	Al Capone
Al Gore	Al Gore
Al-Qaeda	Al-Kaida
Alabama	Alabama
Alabama	Kategoria:Alabama
Alan Shepard	Alan Shepard
Alan Turing	Alan Mathison Turing
Alanine	Alanina
Alaska	Alaska
Alaska	Kategoria:Alaska
Alban Berg	Alban Berg
Albania	Albania
Albania	Kategoria:Albania
Albany	Albany (Nowy Jork)
Albatross	Albatrosy
Albedo	Albedo
Albert Abraham Michelson	Albert Abraham Michelson
Albert Camus	Albert Camus
Albert Einstein	Albert Einstein
Albert Schweitzer	Albert Schweitzer
Albert Speer	Albert Speer (ojciec)
Alberta	Alberta (prowincja Kanady)
Albinism	Albinizm
Albite	Albit
Album	Album (wydawnictwo muzyczne)
Albuquerque	Albuquerque (Nowy Meksyk)
Alchemy	Alchemia
Alchemy	Kategoria:Alchemia
Alcohol	Alkohole
Alcoholic beverage	Napój alkoholowy
Alcoholism	Alkoholizm
Aldebaran	Aldebaran
Aldehyde	Aldehydy
Alder	Olsza
Aldous Huxley	Aldous Huxley
Alec Guinness	Alec Guinness
Aleksandr Solzhenitsyn	Aleksander Sołżenicyn
Aleppo	Aleppo
Aleutian Islands	Aleuty
Alexander	Alexander
Alexander Fleming	Alexander Fleming
Alexander Graham Bell	Alexander Graham Bell
Alexander Hamilton	Alexander Hamilton
Alexander Pope	Alexander Pope
Alexander Pushkin	Aleksander Puszkin
Alexander the Great	Aleksander Macedoński
Alexandre Dumas	Aleksander Dumas (ojciec)
Alexandre Dumas	Aleksander Dumas (syn)
Alexandria	Aleksandria
Alexis de Tocqueville	Alexis de Tocqueville
Alfred Dreyfus	Alfred Dreyfus
Alfred Hitchcock	Alfred Hitchcock
Alfred Nobel	Alfred Nobel
Alfred North Whitehead	Alfred North Whitehead
Alfred Russel Wallace	Alfred Russel Wallace
Alfred the Great	Alfred Wielki
Algae	Glony
Algebra	Algebra
Algebra	Kategoria:Algebra
Algebraic number	Liczby algebraiczne
Algeria	Algieria
Algeria	Kategoria:Algieria
Algiers	Algier
Algorithm	Algorytm
Alhambra	Alhambra
Ali	Ali ibn Abi Talib
Alkali metal	Metale alkaliczne
Alkaloid	Alkaloidy
Alkane	Alkany
Alkene	Alkeny
Alkyne	Alkiny
Allah	Allah
Allegory	Alegoria
Allele	Allel
Allen Ginsberg	Allen Ginsberg
Allergy	Alergia
Alliteration	Aliteracja
Allophone	Alofon
Allosaurus	Allozaur
Allotropy	Alotropia
Alloy	Stop metali
Almanac	Almanach
Almaty	Ałma-Ata
Almond	Migdałowiec zwyczajny
Aloe	Aloes
Alpha (letter)	Alfa
Alpha Centauri	Alfa Centauri
Alpha particle	Promieniowanie alfa
Alphabet	Alfabet
Alps	Alpy
Alps	Kategoria:Alpy
Alsace	Alzacja
Altair	Altair
Altar	Ołtarz
Altay Mountains	Ałtaj
Alternating current	Prąd przemienny
Alternative medicine	Kategoria:Medycyna niekonwencjonalna
Alternative medicine	Medycyna niekonwencjonalna
Altruism	Altruizm
Aluminium	Glin
Aluminium oxide	Tlenek glinu
Alvar Aalto	Alvar Aalto
Alzheimer's disease	Choroba Alzheimera
Amanita muscaria	Muchomor czerwony
Amanita phalloides	Muchomor zielonawy
Amaryllidaceae	Amarylkowate
Amaterasu	Amaterasu
Amazon River	Amazonka (rzeka)
Ambassador	Ambasador
Amber	Bursztyn
Ambrose	Święty Ambroży
Amedeo Avogadro	Amadeo Avogadro
Amelia Earhart	Amelia Earhart
American Bison	Bizon
American Black Bear	Baribal
American Civil War	Wojna secesyjna
American Revolutionary War	Wojna o niepodległość Stanów Zjednoczonych
American Samoa	Samoa Amerykańskie
American Standard Code for Information Interchange	ASCII
American football	Futbol amerykański
American football	Kategoria:Futbol amerykański
Americium	Ameryk
Amerigo Vespucci	Amerigo Vespucci
Amethyst	Ametyst
Amharic	Język amharski
Amide	Amidy
Amine	Aminy
Amino acid	Aminokwasy
Amish	Amisze
Amman	Amman
Ammeter	Amperomierz
Ammonia	Amoniak
Amnesia	Amnezja organiczna
Amnesty	Amnestia
Ampere	Amper
Amphetamine	Amfetamina
Amphibian	Płazy
Amphitheatre	Amfiteatr
Amphora	Amfora
Amplitude	Amplituda
Amsterdam	Amsterdam
Amsterdam	Kategoria:Amsterdam
Amun	Amon (bóg egipski)
Amur	Amur (rzeka)
Anabaptist	Anabaptyzm
Anagram	Anagram
Anaheim	Anaheim
Anal sex	Seks analny
Analytic geometry	Geometria analityczna
Anarchism	Anarchizm
Anarchism	Kategoria:Anarchizm
Anarchy	Anarchia
Anatidae	Kaczkowate
Anatole France	Anatole France
Anatomy	Kategoria:Anatomia
Anatomy	Anatomia
Anaxagoras	Anaksagoras
Anaximander	Anaksymander
Anchor	Kotwica
Anchorage	Anchorage (Alaska)
Ancient Greek	Język grecki klasyczny
Ancient history	Kategoria:Starożytność
Andalusia	Andaluzja
Andaman Sea	Morze Andamańskie
Anders Celsius	Anders Celsius
Andes	Andy
Andhra Pradesh	Andhra Pradesh
Andorra	Andora
Andorra	Kategoria:Andora
Andrea Palladio	Andrea Palladio
Andrei Sakharov	Andriej Sacharow
Andrei Tarkovsky	Andriej Tarkowski
Andrew Jackson	Andrew Jackson
Andrew Johnson	Andrew Johnson (prezydent USA)
Andrew Lloyd Webber	Andrew Lloyd Webber
Android	Android
Andromeda	Andromeda
Andromeda (constellation)	Andromeda (gwiazdozbiór)
Andromeda (mythology)	Andromeda (mitologia)
Andromeda Galaxy	Galaktyka Andromedy
Andy Warhol	Andy Warhol
Anemia	Niedokrwistość
Anemometer	Anemometr
Anesthesia	Znieczulenie
Angara River	Angara
Angel	Anioł
Angel Falls	Salto del Angel
Angle	Kąt płaski
Anglicanism	Anglikanizm
Angola	Angola
Angola	Kategoria:Angola
Anguilla	Anguilla
Angular momentum	Moment pędu
Angular velocity	Prędkość kątowa
Anicius Manlius Severinus Boethius	Anicius Manlius Severinus Boethius
Aniline	Anilina
Animal	Zwierzęta
Animal husbandry	Chów
Anime	Anime
Anime	Kategoria:Anime
Animism	Animizm
Anise	Biedrzeniec anyż
Ankara	Ankara
Annapolis	Annapolis
Annapurna	Annapurna
Anne Boleyn	Anna Boleyn
Annelid	Pierścienice
Anno Domini	N.e.
Annunciation	Zwiastowanie
Anode	Anoda
Anseriformes	Blaszkodziobe
Ant	Mrówkowate
Antakya	Antiochia
Antalya	Antalya
Antananarivo	Antananarywa
Antarctica	Antarktyda
Antarctica	Kategoria:Antarktyda
Antares	Antares
Antenna (radio)	Antena
Anthony Hopkins	Anthony Hopkins
Anthrax	Wąglik
Anthropology	Antropologia (nauka)
Anthropology	Kategoria:Antropologia
Anthroposophy	Antropozofia
Antibiotic	Antybiotyki
Antibody	Przeciwciało
Antichrist	Antychryst
Anticyclone	Antycyklon
Antigen	Antygen
Antigone	Antygona (córka Edypa)
Antigua and Barbuda	Antigua i Barbuda
Antigua and Barbuda	Kategoria:Antigua i Barbuda
Antimatter	Antymateria
Antimony	Antymon
Antioxidant	Przeciwutleniacze
Antipope	Antypapież
Antisemitism	Antysemityzm
Antisemitism	Kategoria:Antysemityzm
Antlia	Pompa (gwiazdozbiór)
Antofagasta	Antofagasta
Antoine Lavoisier	Antoine Lavoisier
Anton Bruckner	Anton Bruckner
Anton Chekhov	Anton Czechow
Antonio Stradivari	Antonio Stradivari
Antonio Vivaldi	Antonio Vivaldi
Antonym	Antonim
Antwerp	Antwerpia
Antwerp (province)	Prowincja Antwerpia
Anubis	Anubis
Anus	Odbyt
Aorta	Aorta człowieka
Apache	Apacze
Apatite	Apatyt
Ape	Małpy człekokształtne
Aphasia	Afazja
Aphorism	Aforyzm
Aphrodite	Afrodyta
Apia	Apia
Apiaceae	Selerowate
Apocrypha	Apokryf
Apodiformes	Jerzykowe
Apollo	Apollo (mitologia)
Apollo (disambiguation)	Apollo
Apollo program	Program Apollo
Apollo program	Kategoria:Program Apollo
Apoptosis	Apoptoza
Appalachian Mountains	Appalachy
Appendicitis	Zapalenie wyrostka robaczkowego
Applied mathematics	Matematyka stosowana
Apricot	Morela
April	Kwiecień
April 14	14 kwietnia
April Fools' Day	Prima aprilis
Apse	Apsyda (architektura)
Apulia	Apulia
Apus	Ptak Rajski (gwiazdozbiór)
Aqaba	Akaba
Aqua regia	Woda królewska
Aquamarine	Akwamaryn
Aquarium	Akwarium
Aquarius (constellation)	Wodnik (gwiazdozbiór)
Aqueduct	Akwedukt
Aquila (constellation)	Orzeł (gwiazdozbiór)
Aquitaine	Akwitania
Ara (constellation)	Ołtarz (gwiazdozbiór)
Arab	Arabowie
Arab League	Liga Państw Arabskich
Arabian Peninsula	Półwysep Arabski
Arabian Sea	Morze Arabskie
Arabic alphabet	Alfabet arabski
Arabic language	Język arabski
Araceae	Obrazkowate
Arachnid	Pajęczaki
Arafura Sea	Morze Arafura
Aragon	Aragonia
Aral Sea	Jezioro Aralskie
Aram Khachaturian	Aram Chaczaturian
Arcadia	Arkadia (kraina historyczna)
Arcangelo Corelli	Arcangelo Corelli
Arch	Łuk (architektura)
Archaeology	Archeologia
Archaeology	Kategoria:Archeologia
Archaeopteryx	Praptak
Archangel	Archanioł
Archbishop	Arcybiskup
Archean	Archaik
Archetype	Archetyp (psychologia)
Archimedes	Archimedes
Archipelago	Archipelag
Architect	Architekt
Architecture	Architektura
Architecture	Kategoria:Architektura i budownictwo
Archosaur	Gady naczelne
Arctic	Arktyka
Arctic Circle	Koło podbiegunowe
Arctic Ocean	Ocean Arktyczny
Arctic fox	Lis polarny
Ardennes	Ardeny
Ardennes (department)	Ardennes
Are	Ar (jednostka miary)
Area	Powierzchnia
Arecaceae	Arekowate
Ares	Ares (bóg)
Argentina	Argentyna
Argentina	Kategoria:Argentyna
Argon	Argon
Argos	Argos
Aria	Aria
Ariadne	Ariadna
Arianism	Arianizm
Aries (constellation)	Baran (gwiazdozbiór)
Aristarchus of Samos	Arystarch z Samos
Aristocracy	Arystokracja
Aristophanes	Arystofanes
Aristotle	Arystoteles
Arithmetic	Arytmetyka
Arithmetic	Kategoria:Arytmetyka
Arithmetic progression	Ciąg arytmetyczny
Arius	Ariusz
Arizona	Arizona
Arizona	Kategoria:Arizona
Ark of the Covenant	Arka Przymierza
Arkansas	Arkansas
Arkansas	Kategoria:Arkansas
Arles	Arles
Armadillo	Pancerniki
Armenia	Armenia
Armenia	Kategoria:Armenia
Armenian language	Język ormiański
Arminius	Arminius
Armour	Zbroja
Army	Armia
Arnhem	Arnhem
Arno River	Arno (rzeka)
Arnold Schoenberg	Arnold Schönberg
Aromatic hydrocarbon	Węglowodory aromatyczne
Arquebus	Arkebuz
Arras	Arras (Pas-de-Calais)
Arrow	Strzała
Arsenic	Arsen
Art	Sztuka
Art Deco	Art déco
Art Nouveau	Secesja (sztuka)
Art history	Kategoria:Historia sztuki
Art history	Historia sztuki
Artemis	Artemida
Artemisia (plant)	Bylica
Artemisia absinthium	Bylica piołun
Artery	Tętnica
Arthritis	Zapalenie stawów
Arthropod	Stawonogi
Arthur Compton	Arthur Holly Compton
Arthur Conan Doyle	Arthur Conan Doyle
Arthur Miller	Arthur Miller
Arthur Rimbaud	Arthur Rimbaud
Arthur Schopenhauer	Arthur Schopenhauer
Arthur Wellesley	Arthur Wellesley, 1. książę Wellington
Artificial intelligence	Sztuczna inteligencja
Artificial intelligence	Kategoria:Sztuczna inteligencja
Artillery	Artyleria
Artillery	Kategoria:Artyleria
Artist	Artysta
Arts	Kategoria:Sztuka
Arturo Toscanini	Arturo Toscanini
Aruba	Aruba
Aruba	Kategoria:Aruba
Asbestos	Azbest
Asclepius	Asklepios
Asexuality	Aseksualizm
Asgard	Asgard
Ash Wednesday	Popielec
Ashurbanipal	Aszurbanipal
Asia	Azja
Asia	Kategoria:Azja
Asmara	Asmara
Aspartame	Aspartam
Asphalt	Asfalt
Aspirin	Kwas acetylosalicylowy
Assam	Assam
Assassination	Zamach
Association of Southeast Asian Nations	Stowarzyszenie Narodów Azji Południowo-Wschodniej
Assyria	Asyria
Assyria	Kategoria:Asyria
Astana	Astana
Astatine	Astat
Asteraceae	Astrowate
Asteraceae	Kategoria:Astrowate
Asteroid	Planetoida
Asteroid belt	Pas planetoid
Asthenosphere	Astenosfera
Asthma	Astma oskrzelowa
Astigmatism (eye)	Astygmatyzm (oko)
Astrakhan	Astrachań
Astrobiology	Astrobiologia
Astrolabe	Astrolabium
Astrology	Astrologia
Astrology	Kategoria:Astrologia
Astrometry	Astrometria
Astronaut	Astronauta
Astronomer	Astronom
Astronomical unit	Jednostka astronomiczna
Astronomy	Astronomia
Astronomy	Kategoria:Astronomia
Astronomy	Portal:Astronomia
Astrophysics	Astrofizyka
Astrophysics	Kategoria:Astrofizyka
Aswan	Asuan
Asymptote	Asymptota
Asynchronous Transfer Mode	Asynchronous Transfer Mode
Atacama Desert	Atakama
Aten	Aton
Atheism	Kategoria:Ateizm
Athena	Atena
Athens	Ateny
Athletics	Kategoria:Lekkoatletyka
Athletics (track and field)	Lekkoatletyka
Atlanta	Atlanta
Atlantic Ocean	Ocean Atlantycki
Atlantic Ocean	Kategoria:Ocean Atlantycki
Atlantis	Atlantyda
Atlas (disambiguation)	Atlas
Atlas (moon)	Atlas (księżyc)
Atlas (mythology)	Atlas (mitologia)
Atlas Mountains	Atlas (góry)
Atmosphere (unit)	Atmosfera fizyczna
Atmospheric pressure	Ciśnienie atmosferyczne
Atoll	Atol
Atom	Atom
Atomic clock	Zegar atomowy
Atomic mass	Masa atomowa
Atomic mass unit	Jednostka masy atomowej
Atomic number	Liczba atomowa
Atomic physics	Kategoria:Fizyka atomowa
Atomic physics	Fizyka atomowa
Atreus	Atreus
Atropine	Atropina
Attica	Attyka (kraina historyczna)
Attila the Hun	Attyla
Au	Au
Auckland	Auckland
Auction	Aukcja (forma przetargu)
August	Sierpień
August 1	1 sierpnia
August 15	15 sierpnia
August 6	6 sierpnia
August Strindberg	August Strindberg
Augusta	Augusta (Maine)
Auguste Comte	Auguste Comte
Auguste Rodin	Auguste Rodin
Augustine of Hippo	Augustyn z Hippony
Augustus	Oktawian August
Auriga (constellation)	Woźnica (gwiazdozbiór)
Aurora	Aurora
Aurora (astronomy)	Zorza polarna
Austin	Austin (Teksas)
Australasia	Australazja
Australia	Australia
Australia	Kategoria:Australia
Australian dollar	Dolar australijski
Australopithecus	Australopiteki
Austria	Austria
Austria	Kategoria:Austria
Austria-Hungary	Austro-Węgry
Author	Autor
Authority	Autorytet
Autism	Autyzm dziecięcy
Auto racing	Wyścig samochodowy
Autobiography	Autobiografia
Automated teller machine	Bankomat
Automobile	Samochód
Autonomic nervous system	Autonomiczny układ nerwowy
Autotroph	Samożywność
Autumn	Jesień
Auvergne (region)	Owernia
Avalanche	Lawina
Avant-garde	Awangarda (sztuka)
Avatar	Awatara
Avena	Owies
Averroes	Awerroes
Avesta	Awesta
Aviation	Kategoria:Lotnictwo
Aviation	Lotnictwo
Avicenna	Awicenna
Avignon	Awinion
Avocado	Smaczliwka
Avogadro's law	Prawo Avogadra
Axe	Topór
Axiom	Aksjomat
Axon	Neuryt
Ayatollah	Ajatollah
Ayn Rand	Ayn Rand
Azerbaijan	Azerbejdżan
Azerbaijan	Kategoria:Azerbejdżan
Azimuth	Azymut
Azores	Azory
Aztec	Aztekowie
Azurite	Azuryt
B	B
BASIC	BASIC
Baal	Baal
Baboon	Pawian
Babylon	Babilon
Babylonia	Babilonia
Backgammon	Tryktrak
Bacteria	Bakterie
Bacteria	Kategoria:Bakterie
Bacteriophage	Bakteriofag
Bactrian Camel	Baktrian
Badminton	Badminton
Baffin Bay	Morze Baffina
Baffin Island	Ziemia Baffina
Baghdad	Bagdad
Bahamas	Kategoria:Bahamy
Bahrain	Bahrajn
Bahrain	Kategoria:Bahrajn
Baja California	Kalifornia Dolna
Baklava	Bakława
Baku	Baku
Balalaika	Bałałajka
Balance sheet	Bilans (rachunkowość)
Baldr	Baldur
Balearic Islands	Baleary
Baleen whale	Fiszbinowce
Bali	Bali (wyspa)
Balkan Mountains	Stara Płanina
Balkan Wars	Wojny bałkańskie
Balkans	Półwysep Bałkański
Ball	Piłka
Ballet	Balet
Ballet	Kategoria:Balet
Ballistic missile	Rakietowy pocisk balistyczny
Ballpoint pen	Długopis
Baltic Sea	Morze Bałtyckie
Baltimore	Baltimore
Bamako	Bamako
Bamboo	Bambus
Banana	Banan
Banana republic	Republika bananowa
Bangalore	Bangalore
Bangkok	Bangkok
Bangladesh	Bangladesz
Bangladesh	Kategoria:Bangladesz
Bangui	Bangi
Banjul	Bandżul
Bank	Bank
Banknote	Banknot
Banks	Kategoria:Banki
Baptism	Chrzest
Baptist	Baptyzm
Bar (unit)	Bar (jednostka)
Barbados	Barbados
Barbados	Kategoria:Barbados
Barbarian	Barbarzyńca
Barbra Streisand	Barbra Streisand
Barcelona	Barcelona
Barcelona	Kategoria:Barcelona
Barents Sea	Morze Barentsa
Bari	Bari
Barium	Bar (pierwiastek)
Barley	Jęczmień
Barn Owl	Płomykówka
Barn Swallow	Jaskółka dymówka
Barometer	Barometr
Baron	Baron
Baroque	Barok
Barranquilla	Barranquilla
Barrel (unit)	Baryłka
Baryon	Bariony
Basalt	Bazalt
Base (chemistry)	Zasady
Baseball	Baseball
Baseball	Kategoria:Baseball
Basel	Bazylea
Bash	Bash
Basidiomycota	Grzyby podstawkowe
Basil	Bazylia pospolita
Basil of Caesarea	Bazyli Wielki
Basilica	Bazylika
Basilicata	Basilicata
Basiliscus	Bazyliskus
Basilisk	Bazyliszek (stworzenie mityczne)
Basketball	Koszykówka
Basketball	Kategoria:Koszykówka
Basra	Al-Basra (miasto)
Bass guitar	Gitara basowa
Basse-Normandie	Dolna Normandia
Basseterre	Basseterre
Bassoon	Fagot
Bast (mythology)	Bastet
Bastille	Bastylia
Bat	Nietoperze
Bath	Bath (Anglia)
Batman	Batman
Baton Rouge	Baton Rouge
Bats	Kategoria:Nietoperze
Battalion	Batalion
Battery (electricity)	Bateria ogniw
Battle of Austerlitz	Bitwa pod Austerlitz
Battle of Britain	Bitwa o Anglię
Battle of Hastings	Bitwa pod Hastings
Battle of Lepanto (1571)	Bitwa pod Lepanto (1571)
Battle of Marathon	Bitwa pod Maratonem
Battle of Midway	Bitwa o Midway
Battle of Thermopylae	Bitwa pod Termopilami
Battle of Trafalgar	Bitwa pod Trafalgarem
Battle of Verdun	Bitwa pod Verdun
Battle of Waterloo	Bitwa pod Waterloo
Battle of the Bulge	Ofensywa w Ardenach
Battle of the Somme	Bitwa nad Sommą
Battleship	Pancernik
Bauhaus	Bauhaus
Bauxite	Boksyt
Bavaria	Bawaria
Bavaria	Kategoria:Bawaria
Bay Laurel	Wawrzyn szlachetny
Bay of Bengal	Zatoka Bengalska
Bay of Biscay	Zatoka Biskajska
Bayer	Bayer AG
Bayonet	Bagnet
Bayonne	Bayonne
Beach	Plaża
Beagle	Beagle (rasa psów)
Beak	Dziób (zoologia)
Bear	Niedźwiedziowate
Beaufort Sea	Morze Beauforta
Beaufort scale	Skala Beauforta
Beaver	Castor
Bebop	Bebop
Becquerel	Bekerel
Bed	Łóżko
Bede	Beda Czcigodny
Bedouin	Beduin
Bee	Pszczoły
Beech	Buk
Beekeeping	Kategoria:Pszczelarstwo
Beer	Piwo
Beer	Kategoria:Piwo
Beetle	Chrząszcze
Behaviorism	Behawioryzm
Beijing	Pekin
Beirut	Bejrut
Belarus	Białoruś
Belarus	Kategoria:Białoruś
Belfast	Belfast
Belgium	Belgia
Belgium	Kategoria:Belgia
Belgrade	Belgrad
Belisarius	Belizariusz
Belize	Belize
Belize	Kategoria:Belize
Bell (instrument)	Dzwon (instrument)
Bellerophon	Bellerofont
Belly dance	Taniec brzucha
Belo Horizonte	Belo Horizonte
Beluga	Białucha (waleń)
Benelux	Benelux
Bengal	Bengal
Benghazi	Bengazi
Benin	Benin
Benin	Kategoria:Benin
Benito Mussolini	Benito Mussolini
Benjamin Britten	Benjamin Britten
Benjamin Disraeli	Benjamin Disraeli, 1. hrabia Beaconsfield
Benjamin Franklin	Benjamin Franklin
Benjamin Harrison	Benjamin Harrison
Benny Goodman	Benny Goodman
Beowulf	Beowulf
Bergen	Bergen
Bering Sea	Morze Beringa
Bering Strait	Cieśnina Beringa
Berkelium	Berkel
Berkshire	Berkshire (Anglia)
Berlin	Berlin
Berlin	Kategoria:Berlin
Bermuda	Bermudy
Bermuda	Kategoria:Bermudy
Bermuda Triangle	Trójkąt Bermudzki
Bernardo Bertolucci	Bernardo Bertolucci
Berne	Berno
Bernhard Riemann	Bernhard Riemann
Berry	Jagoda (botanika)
Bertolt Brecht	Bertolt Brecht
Bertrand Russell	Bertrand Russell
Beryl	Beryl (minerał)
Beryllium	Beryl (pierwiastek)
Beta (letter)	Beta
Beta decay	Rozpad beta
Betelgeuse	Betelgeza
Bethlehem	Betlejem
Bette Davis	Bette Davis
Beverly Hills	Beverly Hills (Kalifornia)
Bey	Bej
Bhutan	Bhutan
Bhutan	Kategoria:Bhutan
Bible	Biblia
Bible	Kategoria:Biblia
Bibliography	Bibliografia
Bicycle	Rower
Big Bang	Wielki Wybuch
Bihar	Bihar
Bikini	Bikini
Bile	Żółć
Bill Clinton	Bill Clinton
Bill Gates	Bill Gates
Billy Wilder	Billy Wilder
Binary star	Gwiazda podwójna
Binoculars	Lorneta
Biochemistry	Biochemia
Biochemistry	Kategoria:Biochemia
Biodiversity	Różnorodność biologiczna
Biogeography	Biogeografia
Biography	Biografia
Biography	Portal:Biografie
Biological warfare	Broń biologiczna
Biology	Biologia
Biology	Kategoria:Biologia
Biology	Portal:Biologia
Biomass	Biomasa
Biome	Biom
Biometrics	Biometria
Biophysics	Biofizyka
Biopsy	Biopsja
Biosphere	Biosfera
Biotechnology	Biotechnologia
Biotechnology	Kategoria:Biotechnologia
Biotin	Biotyna
Bipolar disorder	Choroba afektywna dwubiegunowa
Birch	Brzoza
Bird	Ptaki
Birmingham	Birmingham (Alabama)
Birth control	Antykoncepcja
Bisexuality	Biseksualizm
Bishkek	Biszkek
Bishop	Biskup
Bishop (chess)	Goniec (szachy)
Bismarck	Bismarck (Dakota Północna)
Bismarck (disambiguation)	Bismarck
Bismuth	Bizmut
Bissau	Bissau
Bit	Bit
Bithynia	Bitynia
Bivalvia	Małże
Black	Barwa czarna
Black Death	Czarna śmierć
Black Forest	Schwarzwald
Black Kite	Kania czarna
Black Sea	Morze Czarne
Black Stork	Bocian czarny
Black body	Ciało doskonale czarne
Black hole	Czarna dziura
Black pepper	Pieprz czarny
Blackbird	Kos
Blaise Pascal	Blaise Pascal
Blender (software)	Blender (program)
Blindness	Ślepota
Blitzkrieg	Blitzkrieg
Bloemfontein	Bloemfontein
Blog	Blog
Blood	Krew
Blood plasma	Osocze krwi
Blood pressure	Ciśnienie tętnicze
Blood type	Grupy krwi
Blue	Barwa niebieska
Blue Whale	Płetwal błękitny
Blues	Blues
Boar	Dzik
Board game	Gra planszowa
Boat	Łódź (jednostka pływająca)
Bob Dylan	Bob Dylan
Bob Marley	Bob Marley
Bobby Fischer	Bobby Fischer
Bobsleigh	Bobsleje
Bodhisattva	Bodhisattwa
Body mass index	BMI (wskaźnik)
Bodybuilding	Kulturystyka
Bohemia	Czechy (kraina)
Bohrium	Bohr (pierwiastek)
Boiling point	Temperatura wrzenia
Boise	Boise (Idaho)
Boletus edulis	Borowik szlachetny
Bolivia	Boliwia
Bolivia	Kategoria:Boliwia
Bollywood	Bollywood
Bologna	Bolonia
Bolshevik	Bolszewicy
Bolzano	Bolzano
Bomb	Bomba
Bomber	Samolot bombowy
Bombyx mori	Jedwabnik morwowy
Bond (finance)	Obligacja
Bone	Kość (anatomia)
Bone marrow	Szpik kostny
Bonn	Bonn
Bonsai	Bonsai
Book	Książka
Book of Esther	Księga Estery
Book of Joshua	Księga Jozuego
Book of Judges	Księga Sędziów
Book of Mormon	Księga Mormona
Book of Numbers	Księga Liczb
Book of Revelation	Apokalipsa Świętego Jana
Book of Ruth	Księga Rut
Boolean algebra (structure)	Algebra Boole'a
Boomerang	Bumerang
Bordeaux	Bordeaux
Boris Godunov	Borys Godunow
Boris Pasternak	Borys Pasternak
Boris Spassky	Borys Spasski
Borneo	Borneo
Boron	Bor
Bosnia and Herzegovina	Bośnia i Hercegowina
Bosnia and Herzegovina	Kategoria:Bośnia i Hercegowina
Boson	Bozon
Bosporus	Bosfor
Boston	Boston
Boston Tea Party	Herbatka bostońska
Bot	Szablon:Bot
Botanical garden	Ogród botaniczny
Botany	Botanika
Botany	Kategoria:Botanika
Botswana	Botswana
Botswana	Kategoria:Botswana
Bottle	Butelka
Bottlenose Dolphin	Butlonos
Bourgeoisie	Burżuazja
Bourgogne	Burgundia
Bouvet Island	Wyspa Bouveta
Bovid	Krętorogie
Bow (weapon)	Łuk
Boxer (dog)	Bokser (rasa psów)
Boxers	Kategoria:Bokserzy
Boxing	Boks
Boxing	Kategoria:Boks
Boyle's law	Prawo Boyle'a-Mariotte'a
Bracket	Nawias
Braga	Braga
Brahma	Brahma
Brahmaputra River	Brahmaputra
Braille	Alfabet Braille'a
Brain	Kresomózgowie
Brainstorming	Burza mózgów
Bram Stoker	Bram Stoker
Brandenburg	Brandenburgia
Brandy	Brandy
Brass	Mosiądz
Brassicaceae	Kapustowate
Brassiere	Biustonosz
Bratislava	Bratysława
Braunschweig	Brunszwik
Brazil	Brazylia
Brazil	Kategoria:Brazylia
Brazzaville	Brazzaville
Bread	Chleb
Breast	Sutek
Breast cancer	Rak sutka
Bremen	Brema
Bremen (state)	Brema (kraj związkowy)
Bremerhaven	Bremerhaven
Brescia	Brescia
Brest	Brest
Brest	Brześć
Brest	Brest (ujednoznacznienie)
Bretagne	Bretania
Brick	Cegła
Bridge	Most
Bridges	Kategoria:Mosty i wiadukty
Bridgetown	Bridgetown
Brigade	Brygada
Brighton	Brighton (Anglia)
Brindisi	Brindisi
Brisbane	Brisbane
Bristol	Bristol
British Columbia	Kolumbia Brytyjska
British Empire	Imperium brytyjskie
British Isles	Wyspy Brytyjskie
British Virgin Islands	Brytyjskie Wyspy Dziewicze
British people	Kategoria:Brytyjczycy
Brno	Brno
Broadway (New York City)	Broadway
Broccoli	Brokuł
Bromine	Brom
Bronze	Brązy
Bronze Age	Epoka brązu
Brooklyn	Brooklyn
Brooklyn Bridge	Most Brookliński
Brown	Barwa brązowa
Brown Bear	Niedźwiedź brunatny
Brownian motion	Ruchy Browna
Bruce Lee	Bruce Lee
Bruges	Brugia
Brunei	Brunei
Brunei	Kategoria:Brunei
Brussels	Bruksela
Bubonic plague	Dżuma
Bucharest	Bukareszt
Buckingham Palace	Buckingham Palace
Buckminster Fuller	Buckminster Fuller
Buckwheat	Gryka zwyczajna
Budapest	Budapeszt
Buddha	Budda
Buddhism	Buddyzm
Buddhism	Kategoria:Buddyzm
Buddy Holly	Buddy Holly
Buenos Aires	Buenos Aires
Buffalo	Buffalo (Nowy Jork)
Building	Budynek
Bujumbura	Bużumbura
Bulgaria	Bułgaria
Bulgaria	Kategoria:Bułgaria
Bumblebee	Trzmiel
Buoyancy	Prawo Archimedesa
Bureaucracy	Biurokracja
Burgomaster	Burmistrz
Burkina Faso	Burkina Faso
Burkina Faso	Kategoria:Burkina Faso
Burma	Birma
Burma	Kategoria:Birma
Burqa	Burka
Bursa	Bursa (miasto)
Burundi	Kategoria:Burundi
Bus	Autobus
Bus (computing)	Magistrala (informatyka)
Business	Przedsiębiorstwo (ekonomia)
Businesspeople	Kategoria:Przedsiębiorcy
Buster Keaton	Buster Keaton
Butane	Butan
Butter	Masło
Butterfly	Motyle dzienne
Butterfly effect	Efekt motyla
Bydgoszcz	Bydgoszcz
Byte	Bajt (informatyka)
Byzantine Empire	Kategoria:Bizancjum
C	C
C (programming language)	C (język programowania)
C. S. Lewis	Clive Staples Lewis
CD (disambiguation)	CD
CHAOS (Linux distribution)	CHAOS
CN Tower	CN Tower
COBOL	COBOL
Cabaret	Kabaret
Cacao	Kakaowiec właściwy
Cache	Cache
Cactus	Kaktusowate
Cadmium	Kadm
Cadmus	Kadmos
Caelum	Rylec (gwiazdozbiór)
Caesium	Cez
Caffeine	Kofeina
Cairo	Kair
Cake	Ciasto
Calabria	Kalabria
Calais	Calais
Calcite	Kalcyt
Calcium	Wapń
Calcium carbonate	Węglan wapnia
Calcium oxide	Tlenek wapnia
Calculator	Kalkulator
Calculus	Rachunek różniczkowy i całkowy
Caldera	Kaldera
Calendar	Kalendarz
Caliber	Kaliber broni
California	Kalifornia
California	Kategoria:Kalifornia
Californium	Kaliforn
Caligula	Kaligula
Caliph	Kalif
Caliphate	Kalifat
Calligraphy	Kaligrafia
Calliope	Kalliope (mitologia)
Callisto (moon)	Kallisto (księżyc)
Callisto (mythology)	Kallisto (mitologia)
Calorie	Kaloria
Calvados	Calvados (departament)
Calvary	Golgota
Calvin Coolidge	Calvin Coolidge
Calvinism	Kalwinizm
Calypso (mythology)	Kalipso (mitologia)
Cambodia	Kambodża
Cambodia	Kategoria:Kambodża
Cambrian	Kambr
Cambridge	Cambridge (miasto w Anglii)
Cambridge	Cambridge (Massachusetts)
Cambridge (disambiguation)	Cambridge
Camel	Wielbłąd
Camembert (cheese)	Camembert (ser)
Camera	Aparat fotograficzny
Cameroon	Kamerun
Cameroon	Kategoria:Kamerun
Campania	Kampania (region)
Canada	Kanada
Canada	Kategoria:Kanada
Canadian dollar	Dolar kanadyjski
Canal	Kanał wodny
Canary Islands	Wyspy Kanaryjskie
Canary Islands	Kategoria:Wyspy Kanaryjskie
Canberra	Canberra
Cancer	Nowotwór złośliwy
Cancer (constellation)	Rak (gwiazdozbiór)
Candela	Kandela
Candle	Świeca
Canidae	Psowate
Canis Major	Wielki Pies
Canis Minor	Mały Pies
Cannabis (drug)	Marihuana
Cannes	Cannes
Cannibalism	Kanibalizm
Cannon	Armata
Canoe	Kanadyjka (łódź)
Canon (company)	Canon
Canopus	Kanopus
Cantata	Kantata
Canterbury	Canterbury
Cantonese (linguistics)	Język kantoński
Canute the Great	Kanut Wielki
Capacitance	Pojemność elektryczna
Capacitor	Kondensator
Cape Canaveral	Przylądek Canaveral
Cape Horn	Przylądek Horn
Cape Town	Kapsztad
Cape Verde	Republika Zielonego Przylądka
Cape Verde	Kategoria:Republika Zielonego Przylądka
Cape of Good Hope	Przylądek Dobrej Nadziei
Capital	Stolica
Capital (economics)	Kapitał (ekonomia)
Capital punishment	Kara śmierci
Capitalism	Kapitalizm
Cappadocia	Kapadocja
Capricornus	Koziorożec (gwiazdozbiór)
Capsicum	Papryka
Caracal	Karakal
Caracas	Caracas
Carambola	Oskomian pospolity
Carat (mass)	Karat
Carat (purity)	Karat
Caravaggio	Michelangelo Merisi da Caravaggio
Carbohydrate	Węglowodany
Carbon	Węgiel (pierwiastek)
Carbon cycle	Obieg węgla w przyrodzie
Carbon dioxide	Dwutlenek węgla
Carbon monoxide	Tlenek węgla
Carbonic acid	Kwas węglowy
Carboniferous	Karbon (okres)
Carboxylic acid	Kwasy karboksylowe
Carburetor	Gaźnik
Card game	Gra karciana
Cardamom	Kardamon
Cardiff	Cardiff
Cardinal (Catholicism)	Kardynał
Cardinal Richelieu	Armand Jean Richelieu
Cardiology	Kardiologia
Cardiology	Kategoria:Kardiologia
Cardiovascular system	Kategoria:Układ krążenia człowieka
Caribbean	Karaiby
Caribbean	Kategoria:Karaiby
Caribbean Sea	Morze Karaibskie
Caricature	Karykatura
Carina (constellation)	Kil (gwiazdozbiór)
Carl David Anderson	Carl David Anderson
Carl Jung	Carl Gustav Jung
Carl Lewis	Carl Lewis
Carl Maria von Weber	Carl Maria von Weber
Carl Orff	Carl Orff
Carnival	Karnawał
Carnivora	Drapieżne
Carnivore	Zoofag
Carnivorous plant	Roślina mięsożerna
Carolingian dynasty	Karolingowie
Carolus Linnaeus	Karol Linneusz
Carpathian Mountains	Karpaty
Carrot	Marchew zwyczajna
Carson City	Carson City (Nevada)
Cartagena	Cartagena (Hiszpania)
Cartesian coordinate system	Układ współrzędnych kartezjańskich
Cartesian product	Iloczyn kartezjański
Carthage	Kartagina
Cartography	Kartografia
Cartography	Kategoria:Kartografia
Cary Grant	Cary Grant
Caryophyllales	Goździkowce
Casablanca	Casablanca
Cashew	Nanercz zachodni
Casino	Kasyno
Caspian Sea	Morze Kaspijskie
Cassandra	Kasandra (mitologia)
Cassiopeia (constellation)	Kasjopeja (gwiazdozbiór)
Cast iron	Żeliwo
Caste	System kastowy
Castile (historical region)	Kastylia
Castle	Zamek
Castling	Roszada
Castries	Castries (Saint Lucia)
Casus belli	Casus belli
Cat	Kot
Catalonia	Katalonia
Catalonia	Kategoria:Katalonia
Catalysis	Katalizator
Cataphract	Katafrakt
Cataract	Zaćma
Catfish	Sumokształtne
Catharism	Katarzy
Cathedral	Katedra (budynek)
Catherine Parr	Katarzyna Parr
Catherine of Aragon	Katarzyna Aragońska
Cathode	Katoda
Catholicism	Katolicyzm
Cattle	Krowa
Cattle Egret	Czapla złotawa
Catullus	Katullus
Caucasus	Kaukaz (kraina historyczna)
Caucasus	Kategoria:Kaukaz
Caucasus Mountains	Kaukaz (pasmo górskie)
Cauliflower	Kalafior
Causality	Przyczynowość
Cavalry	Jazda
Cave	Jaskinia
Caviar	Kawior
Cayenne	Kajenna
Cayman Islands	Kajmany (wyspy)
Cecil Rhodes	Cecil Rhodes
Cedar	Cedr
Celery	Seler zwyczajny
Celestial equator	Równik niebieski
Celestial mechanics	Kategoria:Mechanika nieba
Celestial mechanics	Mechanika nieba
Celestial sphere	Sfera niebieska
Celibacy	Celibat
Cell (biology)	Komórka
Cell membrane	Błona komórkowa
Cell nucleus	Jądro komórkowe
Cell wall	Ściana komórkowa
Cello	Wiolonczela
Cellulose	Celuloza
Celsius	Skala Celsjusza
Cement	Cement
Cemetery	Cmentarz
Cenozoic	Era kenozoiczna
Census	Spis statystyczny
Centaur	Centaur (mitologia)
Centaurus	Centaur (gwiazdozbiór)
Center of mass	Środek masy
Centimetre	Centymetr
Central Africa	Afryka Środkowa
Central African Republic	Republika Środkowoafrykańska
Central African Republic	Kategoria:Republika Środkowoafrykańska
Central America	Ameryka Centralna
Central Intelligence Agency	Centralna Agencja Wywiadowcza
Central Park	Central Park
Central Powers	Państwa centralne
Central bank	Bank centralny
Central nervous system	Ośrodkowy układ nerwowy
Central processing unit	Procesor
Centre	Centre
Centriole	Centriola
Century	Wiek
Cephalopod	Głowonogi
Cepheus (constellation)	Cefeusz (gwiazdozbiór)
Ceramic	Ceramika
Cerberus	Cerber
Cereal	Zboża
Cerebellum	Móżdżek
Ceres	Ceres
Ceres (dwarf planet)	1 Ceres
Ceres (mythology)	Ceres (mitologia)
Cerium	Cer
Cesare Borgia	Cezar Borgia
Cestoda	Tasiemce
Cetacea	Walenie
Cetus	Wieloryb (gwiazdozbiór)
Chad	Czad
Chad	Kategoria:Czad
Chaffinch	Zięba
Chair	Krzesło
Chalcedony	Chalcedon (minerał)
Chamaeleon	Kameleon (gwiazdozbiór)
Chamois	Kozica
Champagne (wine)	Szampan
Champagne-Ardenne	Szampania-Ardeny
Channel Tunnel	Eurotunel
Chaos (mythology)	Chaos (mitologia)
Charadriiformes	Siewkowe
Charlemagne	Karol Wielki
Charleroi	Charleroi
Charles	Karol Mountbatten-Windsor
Charles Baudelaire	Charles Baudelaire
Charles Darwin	Charles Darwin
Charles Dickens	Karol Dickens
Charles Fourier	Charles Fourier
Charles Lindbergh	Charles Lindbergh
Charles Peirce	Charles Sanders Peirce
Charles Thomson Rees Wilson	Charles Thomson Rees Wilson
Charles de Gaulle	Charles de Gaulle
Charles the Bald	Karol II Łysy
Charleston	Charleston (Wirginia Zachodnia)
Charlie Chaplin	Charlie Chaplin
Charlie Parker	Charlie Parker
Charlotte	Charlotte (Karolina Północna)
Charmed	Czarodziejki
Charon (moon)	Charon (księżyc)
Charon (mythology)	Charon (mitologia)
Chartres	Chartres
Chauvinism	Szowinizm
Che Guevara	Ernesto Guevara
Chechnya	Czeczenia
Chechnya	Kategoria:Czeczenia
Cheese	Ser
Cheetah	Gepard
Chelyabinsk	Czelabińsk
Chemical bond	Wiązanie chemiczne
Chemical compound	Związki chemiczne
Chemical element	Pierwiastek chemiczny
Chemical engineering	Inżynieria chemiczna
Chemical formula	Symbolika chemiczna
Chemical reaction	Reakcja chemiczna
Chemical warfare	Broń chemiczna
Chemistry	Chemia
Chemistry	Kategoria:Chemia
Chemistry	Portal:Chemia
Chemnitz	Chemnitz
Chemotherapy	Chemioterapia
Chennai	Madras
Cheque	Czek
Chernobyl	Czarnobyl
Cherry	Wiśnia
Chert	Krzemień
Cherub	Cheruby
Chess	Szachy
Chess	Kategoria:Szachy
Chess opening	Otwarcie szachowe
Chester A. Arthur	Chester Arthur
Chestnut	Kasztan
Chewing gum	Guma do żucia
Cheyenne	Cheyenne (Wyoming)
Chi (letter)	Chi (litera)
Chiang Kai-shek	Czang Kaj-szek
Chicago	Chicago
Chicken	Kura domowa
Chickenpox	Ospa wietrzna
Chickpea	Ciecierzyca pospolita
Chihuahua	Chihuahua (stan)
Child	Dziecko
Childbirth	Poród
Chile	Chile
Chile	Kategoria:Chile
Chimborazo (volcano)	Chimborazo
Chimera (mythology)	Chimera (mitologia)
Chimpanzee	Szympans
China	Kategoria:Chiny
China	Chiny (ujednoznacznienie)
Chios	Chios
Chiron	Chiron (mitologia)
Chitin	Chityna
Chlorine	Chlor
Chloroform	Chloroform
Chlorophyll	Chlorofil
Chloroplast	Chloroplast
Chocolate	Czekolada
Choir	Chór
Cholera	Cholera
Cholesterol	Cholesterol
Chondrichthyes	Ryby chrzęstnoszkieletowe
Chongqing	Chongqing
Chord (music)	Akord
Chordate	Strunowce
Christchurch	Christchurch (Nowa Zelandia)
Christiaan Huygens	Christiaan Huygens
Christian Dior	Christian Dior
Christianity	Chrześcijaństwo
Christianity	Kategoria:Chrześcijaństwo
Christmas	Boże Narodzenie
Christmas Eve	Wigilia Bożego Narodzenia
Christmas tree	Choinka
Christopher Columbus	Krzysztof Kolumb
Christopher Marlowe	Christopher Marlowe
Chromatin	Chromatyna
Chromatography	Chromatografia
Chromium	Chrom
Chromosome	Chromosom
Chronology	Kategoria:Chronologia
Chuck Berry	Chuck Berry
Chukchi Sea	Morze Czukockie
Church	Kościół (organizacja)
Church (building)	Kościół (budynek)
Cicero	Cyceron
Ciconiiformes	Brodzące
Cider	Cydr
Cigarette	Papieros
Cinderella	Kopciuszek (baśń)
Cinnabar	Cynober (minerał)
Cinnamon	Cynamonowiec cejloński
Circe	Kirke (mitologia)
Circinus	Cyrkiel (gwiazdozbiór)
Circle	Okrąg
Circulatory system	Układ krwionośny człowieka
Circumcision	Obrzezanie
Circus	Cyrk (rozrywka)
Cirrhosis	Marskość wątroby
Citizenship	Obywatelstwo
Citric acid	Kwas cytrynowy
Citric acid cycle	Cykl kwasu cytrynowego
Citrus	Cytrus
City-state	Wolne miasto
Civil war	Wojna domowa
Civilization	Cywilizacja
Civilization (computer game)	Civilization
Clarinet	Klarnet
Clark Gable	Clark Gable
Class	Klasa
Class (biology)	Klasa (biologia)
Class (computer science)	Klasa (programowanie obiektowe)
Classical mechanics	Mechanika klasyczna
Classical music	Muzyka poważna
Classicism	Klasycyzm
Claude Monet	Claude Monet
Claude Shannon	Claude E. Shannon
Claudio Monteverdi	Claudio Monteverdi
Claudius	Klaudiusz (cesarz)
Clavicle	Obojczyk (anatomia)
Clay	Glina
Clef	Klucz (muzyka)
Clement Attlee	Clement Richard Attlee
Cleopatra (disambiguation)	Kleopatra
Clergy	Duchowieństwo
Cleveland	Cleveland
Client-server	Klient-serwer
Climate	Klimat
Climate	Kategoria:Klimat
Climate change	Zmiana klimatu
Climatology	Klimatologia
Climatology	Kategoria:Klimatologia
Clinical depression	Depresja (choroba)
Clio	Klio
Clitoris	Łechtaczka
Clock	Zegar (czasomierz)
Clock Tower	Big Ben
Cloning	Klonowanie
Clothing	Kategoria:Ubrania
Clothing	Odzież
Cloud	Chmura
Clove	Goździki
Clover	Koniczyna
Clovis I	Chlodwig I
Cnidaria	Parzydełkowce
Coal	Węgle kopalne
Coast	Wybrzeże
Coat of arms	Herb
Cobalt	Kobalt
Cocaine	Kokaina
Coccinellidae	Biedronkowate
Cockatoo	Kakadu
Cockroach	Karaczany
Cocktail	Koktajl alkoholowy
Coconut	Kokos właściwy
Cocos (Keeling) Islands	Wyspy Kokosowe
Codeine	Kodeina
Coffea	Kawowiec
Coffee	Kawa
Coffee	Kategoria:Kawa
Cognac (drink)	Koniak
Cognitive psychology	Psychologia poznawcza
Cognitive science	Kognitywistyka
Coin	Moneta
Cola	Cola
Colchis	Kolchida
Cold War	Zimna wojna
Cold War	Kategoria:Zimna wojna
Colin Powell	Colin Powell
Collage	Kolaż
Collagen	Kolagen
Colloid	Układ koloidalny
Cologne	Kolonia (miasto)
Colombia	Kolumbia
Colombia	Kategoria:Kolumbia
Colombo	Kolombo
Colonel	Pułkownik (stopień wojskowy)
Colony	Kolonia (geografia polityczna)
Color	Barwa
Color blindness	Ślepota barw
Colorado	Kolorado
Colorado	Kategoria:Kolorado
Colorado River	Kolorado (rzeka)
Colosseum	Koloseum
Colossus of Rhodes	Kolos Rodyjski
Colubrid	Połozowate
Columba (constellation)	Gołąb (gwiazdozbiór)
Columbia	Columbia (Karolina Południowa)
Columbia	Kolumbia (ujednoznacznienie)
Columbia River	Kolumbia (rzeka)
Columbia University	Uniwersytet Columbia
Columbidae	Gołębiowate
Columbiformes	Kategoria:Gołębiowe
Columbiformes	Gołębiowe
Columbus	Columbus (Ohio)
Columbus	Columbus
Coma	Śpiączka
Coma Berenices	Warkocz Bereniki (gwiazdozbiór)
Combustion	Spalanie
Comedy	Komedia
Comenius	Jan Ámos Komenský
Comet	Kometa
Comma (punctuation)	Przecinek
Commedia dell'arte	Commedia dell'arte
Commerce	Kategoria:Handel
Common Fig	Figowiec pospolity
Common cold	Przeziębienie
Commonwealth of Independent States	Wspólnota Niepodległych Państw
Commonwealth of Nations	Wspólnota Narodów
Communication	Kategoria:Komunikacja
Communication	Komunikacja interpersonalna
Communism	Komunizm
Communism	Kategoria:Komunizm
Comoros	Komory
Comoros	Kategoria:Komory
Compact Disc	Płyta kompaktowa
Company (military unit)	Kompania
Compass	Kompas magnetyczny
Compass (drafting)	Cyrkiel (przyrząd)
Compiler	Kompilator
Complex instruction set computer	CISC
Complex number	Liczby zespolone
Composer	Kompozytor
Composite material	Materiał kompozytowy
Composite number	Liczby złożone
Computational linguistics	Lingwistyka komputerowa
Computed tomography	Tomografia komputerowa
Computer	Komputer
Computer architecture	Architektura komputera
Computer display	Monitor (ekran)
Computer file	Plik
Computer graphics	Kategoria:Grafika komputerowa
Computer hardware	Hardware
Computer hardware	Kategoria:Sprzęt komputerowy
Computer network	Sieć komputerowa
Computer program	Program komputerowy
Computer programming	Programowanie
Computer programming	Kategoria:Programowanie
Computer science	Informatyka
Computer science	Kategoria:Informatyka
Computer software	Oprogramowanie
Computer virus	Wirus komputerowy
Computer-aided design	Komputerowe wspomaganie projektowania
Computing	Kategoria:Informatyka
Conakry	Konakry
Concentration	Stężenie (chemia)
Concerto	Koncert
Concord	Concord (New Hampshire)
Concrete	Beton
Condom	Prezerwatywa
Conducting	Dyrygent
Cone (geometry)	Stożek (geometria)
Confederate States of America	Skonfederowane Stany Ameryki
Confederation	Konfederacja
Confession	Sakrament pokuty i pojednania
Confirmation	Bierzmowanie
Conflict	Konflikt interpersonalny
Confucianism	Konfucjanizm
Confucius	Konfucjusz
Congo	Kongo (ujednoznacznienie)
Congo River	Kongo (rzeka)
Conic section	Krzywa stożkowa
Connecticut	Connecticut
Connecticut	Kategoria:Connecticut
Connective tissue	Tkanka łączna
Conquistador	Konkwista
Consensus	Konsens
Conservation of energy	Zasada zachowania energii
Conservatism	Konserwatyzm
Consonant	Spółgłoska
Constantine I	Konstantyn I Wielki
Constantinople	Konstantynopol
Constellation	Gwiazdozbiór
Constitution (political)	Konstytucja
Consul	Konsul rzymski
Consumption (economics)	Konsumpcja
Contact lens	Soczewka kontaktowa
Continent	Kontynent
Continental drift	Wędrówka kontynentów
Continental shelf	Szelf kontynentalny
Contract	Umowa
Contract bridge	Brydż
Convection	Konwekcja
Cooking	Sztuka kulinarna
Cooperative	Spółdzielnia
Coordinate system	Układ współrzędnych
Coordinated Universal Time	Uniwersalny czas koordynowany
Copenhagen	Kopenhaga
Copper	Miedź
Copyright	Prawo autorskie
Cor anglais	Rożek angielski
Coraciiformes	Kraskowe
Coral	Koral
Coral Sea	Morze Koralowe
Coral reef	Rafa
Coriander	Kolendra siewna
Corinth	Korynt
Coriolis effect	Efekt Coriolisa
Cork (city)	Cork
Cormorant	Kormoranowate
Cornea	Rogówka
Cornell University	Uniwersytet Cornella
Cornwall	Kornwalia
Corona Borealis	Korona Północna
Corporation	Spółka kapitałowa
Corrosion	Korozja
Corsica	Korsyka
Corundum	Korund
Corvette	Korweta
Corvidae	Krukowate
Corvus (constellation)	Kruk (gwiazdozbiór)
Cosmic microwave background radiation	Mikrofalowe promieniowanie tła
Cosmic ray	Promieniowanie kosmiczne
Cosmology	Kosmologia
Cosmology	Kategoria:Kosmologia
Costa Rica	Kostaryka
Costa Rica	Kategoria:Kostaryka
Cotonou	Kotonu
Cotopaxi	Cotopaxi
Cotton	Bawełna (włókno)
Cougar	Puma
Coulomb	Kulomb
Coulomb's law	Prawo Coulomba
Council of Chalcedon	Sobór chalcedoński
Council of Ephesus	Sobór Efeski
Council of Trent	Sobór trydencki
Counterpoint	Kontrapunkt (muzyka)
Country	Pays
Country music	Muzyka country
Court	Sąd
Covalent bond	Wiązanie kowalencyjne
Coventry	Coventry
Coyote	Kojot
Crab	Kraby
Crab Nebula	Mgławica Kraba
Crane (bird)	Żurawie (ptaki)
Crater (constellation)	Puchar (gwiazdozbiór)
Cremona	Cremona
Cretaceous	Kreda (okres)
Crete	Kreta
Cricket	Krykiet
Cricket (insect)	Świerszczowate
Crime	Przestępstwo
Crimea	Autonomiczna Republika Krymu
Crimean War	Wojna krymska
Criminal law	Kategoria:Prawo karne
Criminal law	Prawo karne
Criminology	Kryminologia
Criminology	Kategoria:Kryminologia
Croatia	Chorwacja
Croatia	Kategoria:Chorwacja
Crocodile	Krokodylowate
Crocodilia	Krokodyle
Cronus	Kronos
Cross	Krzyż
Cross product	Iloczyn wektorowy
Crossbow	Kusza
Crossword	Krzyżówka (zagadka)
Crucifixion	Ukrzyżowanie
Cruiser	Krążownik
Crust (geology)	Skorupa ziemska
Crustacean	Skorupiaki
Crux	Krzyż Południa (gwiazdozbiór)
Cryptography	Kategoria:Kryptografia
Crystal	Ciało krystaliczne
Crystallography	Krystalografia
Crystallography	Kategoria:Krystalografia
Ctenophore	Żebropławy
Cuba	Kuba
Cuba	Kategoria:Kuba
Cube	Sześcian (geometria)
Cubic metre	Metr sześcienny
Cubism	Kubizm
Cuculiformes	Kukułkowe
Cucumber	Ogórek
Cucurbitaceae	Dyniowate
Cultural Revolution	Rewolucja kulturalna
Culture	Kultura
Culture	Kategoria:Kultura
Cumbria	Cumbria
Cumulus cloud	Cumulus
Cupressaceae	Cyprysowate
Curitiba	Kurytyba
Curium	Kiur (pierwiastek)
Curling	Curling
Currency	Kategoria:Waluty
Currency	Waluta
Curry	Curry
Cusco	Cuzco
Cyan	Cyjan (kolor)
Cyanide	Cyjanki
Cyanobacteria	Sinice
Cybele	Kybele
Cybernetics	Cybernetyka
Cyberpunk	Cyberpunk
Cyclades	Cyklady
Cycling	Kolarstwo
Cycling	Kategoria:Rower
Cyclone	Cyklon
Cyclops	Cyklop
Cygnus (constellation)	Łabędź (gwiazdozbiór)
Cylinder (geometry)	Walec (bryła)
Cyperaceae	Ciborowate
Cyprinid	Karpiowate
Cypriniformes	Karpiokształtne
Cyprus	Cypr (państwo)
Cyprus	Kategoria:Cypr
Cyrillic alphabet	Cyrylica
Cyrus the Great	Cyrus II Wielki
Cystic fibrosis	Mukowiscydoza
Cytoplasm	Cytoplazma
Cytosine	Cytozyna
Cytoskeleton	Cytoszkielet
Czech Republic	Czechy
Czech Republic	Kategoria:Czechy
Czechoslovakia	Czechosłowacja
Czechoslovakia	Kategoria:Czechosłowacja
D	D
D. H. Lawrence	David Herbert Lawrence
D. W. Griffith	D.W.Griffith
DDT	Dichlorodifenylotrichloroetan
DNA	Kwas deoksyrybonukleinowy
DOS	DOS
DVD	DVD
Dachshund	Jamnik
Dada	Dadaizm
Daedalus	Dedal
Dagger	Sztylet
Daguerreotype	Dagerotyp
Dahlia	Dalia (roślina)
Dakar	Dakar
Dalai Lama	Dalajlama
Dallas	Dallas
Dalmatia	Dalmacja
Dam	Zapora wodna
Damascus	Damaszek
Dance	Taniec
Dance	Kategoria:Taniec
Dandelion	Mniszek (roślina)
Daniel Bernoulli	Daniel Bernoulli
Daniel Defoe	Daniel Defoe
Daniel Ortega	Daniel Ortega Saavedra
Danish krone	Korona duńska
Dante Alighieri	Dante Alighieri
Danube	Dunaj
Daphne	Dafne (mitologia)
Dar es Salaam	Dar es Salaam
Dardanelles	Dardanele
Darfur	Darfur
Darjeeling	Dardżyling
Dark matter	Ciemna materia
Darmstadtium	Darmsztadt
Darwin	Darwin
Darwin	Darwin (ujednoznacznienie)
Das Kapital	Kapitał (Marks)
Data	Dane
Data mining	Eksploracja danych
Data structure	Struktura danych
Database	Baza danych
Database management system	System zarządzania bazą danych
Date Palm	Palma daktylowa
Dative case	Celownik (przypadek)
Daugavpils	Dyneburg
David	Dawid (król Izraela)
David Hilbert	David Hilbert
David Hume	David Hume
David Livingstone	David Livingstone
David Ricardo	David Ricardo
Davis Cup	Puchar Davisa
Day	Dzień
De facto	Standard de facto
Deacon	Diakonat
Dead Sea	Morze Martwe
Dead Sea scrolls	Rękopisy z Qumran
Deadly nightshade	Pokrzyk wilcza jagoda
Death	Śmierć
Death	Kategoria:Śmierć
Decade	Dziesięciolecie
December	Grudzień
December 31	31 grudnia
December 8	8 grudnia
Decibel	Decybel
Decimal	Dziesiętny system liczbowy
Decius (emperor)	Trajan Decjusz
Declination	Deklinacja (astronomia)
Deco	Deco
Deconstruction	Dekonstrukcja
Deductive reasoning	Rozumowanie dedukcyjne
Deer	Jeleniowate
Definition	Definicja
Deflation	Deflacja (ekonomia)
Degree	Stopień
Degree (angle)	Stopień (kąt)
Deimos (moon)	Deimos (księżyc)
Deism	Deizm
Delaware	Delaware
Delaware	Kategoria:Delaware
Delft	Delft
Delhi	Delhi
Dell	Dell
Delphi	Delfy
Delphinus	Delfin (gwiazdozbiór)
Delta	Delta (ujednoznacznienie)
Delta (letter)	Delta
Deluge (mythology)	Potop
Demagogy	Demagogia
Dementia	Demencja
Demeter	Demeter
Democracy	Demokracja
Democratic Party (United States)	Partia Demokratyczna (USA)
Democratic Republic of the Congo	Demokratyczna Republika Konga
Democratic Republic of the Congo	Kategoria:Demokratyczna Republika Konga
Democritus	Demokryt
Demography	Demografia
Demography	Kategoria:Demografia
Demon	Demon
Demosthenes	Demostenes (mówca grecki)
Deng Xiaoping	Deng Xiaoping
Dengue fever	Denga
Denis Diderot	Denis Diderot
Denmark	Dania
Denmark	Kategoria:Dania
Dennis Gabor	Dennis Gabor
Density	Gęstość
Dental caries	Próchnica zębów
Dentistry	Kategoria:Stomatologia
Dentistry	Dentystyka
Denver	Denver
Derivative	Pochodna funkcji
Dermatology	Dermatologia
Des Moines	Des Moines (Iowa)
Desert	Pustynia
Deserts	Kategoria:Pustynie
Desiderius Erasmus	Erazm z Rotterdamu
Design	Design
Desmond Tutu	Desmond Tutu
Destroyer	Niszczyciel
Determinant	Wyznacznik
Determinism	Determinizm
Detroit	Detroit
Deuterium	Deuter
Deuteronomy	Księga Powtórzonego Prawa
Developmental psychology	Psychologia rozwoju człowieka
Device driver	Sterownik urządzenia
Devon	Devon
Devonian	Dewon
Dew	Rosa
Dew point	Temperatura punktu rosy
Dewey Decimal Classification	Klasyfikacja Dziesiętna Deweya
Dhaka	Dhaka
Dharma	Dharma
Dhaulagiri	Dhaulagiri
Dhole	Cyjon
Diabetes mellitus	Cukrzyca
Diacritic	Znaki diakrytyczne
Dialect	Dialekt
Dialectic	Dialektyka
Dialectical materialism	Materializm dialektyczny
Diameter	Średnica
Diamond	Diament
Diana	Diana Spencer
Diana (mythology)	Diana (bogini)
Diarrhea	Biegunka
Diaspora	Diaspora
Diatom	Okrzemki
Dice	Kość do gry
Dicotyledon	Dwuliścienne
Dictatorship	Dyktatura
Dictionary	Słownik
Diego Rivera	Diego Rivera
Diesel	Olej napędowy
Diesel engine	Silnik o zapłonie samoczynnym
Dietrich Bonhoeffer	Dietrich Bonhoeffer
Differential equation	Równanie różniczkowe
Diffraction	Dyfrakcja
Diffusion	Dyfuzja
Digestion	Trawienie
Digestive system	Kategoria:Układ pokarmowy człowieka
Digital camera	Cyfrowy aparat fotograficzny
Digital photography	Fotografia cyfrowa
Digital subscriber line	DSL
Dijon	Dijon
Dill	Koper (roślina)
Dimension	Wymiar (matematyka)
Dingo	Dingo
Dinosaur	Dinozaury
Diocese	Diecezja
Diocletian	Dioklecjan
Diode	Dioda
Dionysus	Dionizos
Diphtheria	Błonica
Diphthong	Dwugłoska
Diplodocus	Diplodok
Diplomacy	Dyplomacja
Diplomacy	Kategoria:Dyplomacja
Dire Straits	Dire Straits
Direct current	Prąd stały
Disaccharide	Disacharydy
Disambiguation	Kategoria:Strony ujednoznaczniające
Disc jockey	DJ
Discourse	Dyskurs
Discrimination	Dyskryminacja (psychologia społeczna)
Disease	Choroba
Distance	Odległość
Distillation	Destylacja
Divergence	Dywergencja
Division (mathematics)	Dzielenie
Division (military)	Dywizja
Divorce	Rozwód
Dizzy Gillespie	Dizzy Gillespie
Djibouti	Kategoria:Dżibuti
Djibouti (city)	Dżibuti (miasto)
Dmitri Mendeleev	Dmitrij Mendelejew
Dmitri Shostakovich	Dymitr Szostakowicz
Dnieper River	Dniepr
Dnipropetrovsk	Dniepropietrowsk
Doberman Pinscher	Doberman
Doctor of the Church	Doktor Kościoła
Document	Dokument
Dodecahedron	Dwunastościan foremny
Dodecanese	Dodekanez
Dodo	Dront dodo
Dodoma	Dodoma
Dog	Pies domowy
Dogma	Dogmat
Doha	Ad-Dauha
Dollar	Dolar
Dolly (sheep)	Owca Dolly
Dolmen	Dolmen
Dolphin	Delfin
Domain (biology)	Domena (biologia)
Domain name	Domena internetowa
Dome	Kopuła (architektura)
Domesday Book	Domesday Book
Domestication	Domestykacja zwierząt
Dominica	Dominika
Dominica	Kategoria:Dominika
Dominican Order	Dominikanie
Dominican Republic	Dominikana
Dominican Republic	Kategoria:Dominikana
Domitian	Domicjan
Don Quixote	Don Kichot (powieść)
Don River (Russia)	Don
Donald Duck	Kaczor Donald
Donatello	Donatello
Donato Bramante	Donato Bramante
Donetsk	Donieck
Donkey	Osioł
Door	Drzwi
Dopamine	Dopamina
Doppler effect	Efekt Dopplera
Dorado	Złota Ryba (gwiazdozbiór)
Doric order	Porządek dorycki
Doris Lessing	Doris Lessing
Dortmund	Dortmund
Douala	Duala (miasto)
Double bass	Kontrabas
Douglas MacArthur	Douglas MacArthur
Dover	Dover (Delaware)
Dover	Dover
Down syndrome	Zespół Downa
Draco (constellation)	Smok (gwiazdozbiór)
Dracula	Drakula (powieść)
Dragon	Smok
Drainage basin	Dorzecze
Drama	Dramat
Draughts	Warcaby
Dream	Marzenia senne
Dresden	Drezno
Drink	Napój
Dromedary	Dromader
Drought	Susza
Drug addiction	Narkomania
Druid	Druid
Drum	Bęben (muzyka)
Dualism	Dualizm (religia)
Dualism (philosophy of mind)	Dualizm (religia)
Dubai	Dubaj
Dublin	Dublin
Dubnium	Dubn
Dubrovnik	Dubrownik
Dugong	Diugoń
Duke	Diuk
Duke Ellington	Duke Ellington
Duke University	Uniwersytet Duke'a
Dune	Wydma
Dunkirk	Dunkierka
Duodenum	Dwunastnica
Durban	Durban
Dushanbe	Duszanbe
Dustin Hoffman	Dustin Hoffman
Dutch people	Kategoria:Holendrzy
Dwight D. Eisenhower	Dwight D. Eisenhower
Dynamics (physics)	Dynamika (fizyka)
Dynamite	Dynamit
Dynasty	Dynastia
Dyslexia	Dysleksja
Dysprosium	Dysproz
Dystopia	Antyutopia
E	E
E (mathematical constant)	Podstawa logarytmu naturalnego
E-mail	Poczta elektroniczna
E. T. A. Hoffmann	Ernst Theodor Amadeus Hoffmann
ETA	ETA
Eagle	Orły
Ear	Ucho
Eared seal	Uchatkowate
Earless seal	Fokowate
Earth	Ziemia
Earth	Kategoria:Ziemia
Earth science	Nauki o Ziemi
Earthquake	Trzęsienie ziemi
East	Wschód
East Africa	Afryka Wschodnia
East China Sea	Morze Wschodniochińskie
East Germany	Niemiecka Republika Demokratyczna
East Sussex	East Sussex
East Timor	Timor Wschodni
East Timor	Kategoria:Timor Wschodni
Easter	Wielkanoc
Eastern Orthodox Church	Cerkiew prawosławna
Ebola	Gorączka krwotoczna Ebola
Ebro	Ebro
Eccentricity (mathematics)	Ekscentryczność (fizyka)
Ecclesiastes	Księga Koheleta
Echidna (mythology)	Echidna
Echinoderm	Szkarłupnie
Eclipse	Zaćmienie
Eclipse (software)	Eclipse
Ecliptic	Ekliptyka
Ecological niche	Nisza ekologiczna
Ecology	Ekologia
Ecology	Kategoria:Ekologia
Econometrics	Ekonometria
Economics	Ekonomia
Economics	Kategoria:Ekonomia
Economy	Ekonomia
Ecosystem	Ekosystem
Ecuador	Ekwador
Ecuador	Kategoria:Ekwador
Ecumenical council	Sobór powszechny
Edgar Allan Poe	Edgar Allan Poe
Edgar Degas	Edgar Degas
Edgar Rice Burroughs	Edgar Rice Burroughs
Edinburgh	Edynburg
Edirne	Adrianopol
Edmond Halley	Edmund Halley
Edmonton	Edmonton
Edmund Burke	Edmund Burke
Edmund Hillary	Edmund Hillary
Edmund Husserl	Edmund Husserl
Edo	Edo (miasto)
Eduard Buchner	Eduard Buchner
Education	Edukacja
Education	Kategoria:Oświata
Edvard Grieg	Edvard Hagerup Grieg
Edvard Munch	Edvard Munch
Edward Gibbon	Edward Gibbon
Edward Jenner	Edward Jenner
Edward Teller	Edward Teller
Edward the Confessor	Edward Wyznawca
Edwin Hubble	Edwin Hubble
Eel	Węgorzokształtne
Egg (biology)	Jajo (biologia)
Eggplant	Psianka podłużna
Egypt	Egipt
Egypt	Kategoria:Egipt
Egyptian pound	Funt egipski
Egyptology	Egiptologia
Eiffel Tower	Wieża Eiffla
Eindhoven	Eindhoven
Einsteinium	Einstein (pierwiastek)
Ejaculation	Ejakulacja
El Cid	Cyd
El Greco	El Greco
El Paso	El Paso (Teksas)
El Salvador	Salwador
El Salvador	Kategoria:Salwador
Elam	Elam
Elbe	Łaba
Eleanor Roosevelt	Eleanor Roosevelt
Election	Wybory
Electric charge	Ładunek elektryczny
Electric current	Natężenie prądu elektrycznego
Electric field	Pole elektryczne
Electric guitar	Gitara elektryczna
Electric motor	Silnik elektryczny
Electrical engineering	Kategoria:Elektrotechnika
Electrical engineering	Elektrotechnika
Electrical resistance	Rezystancja
Electricity	Elektryczność
Electricity	Kategoria:Elektryczność
Electrocardiogram	Elektrokardiografia
Electrochemistry	Elektrochemia
Electrochemistry	Kategoria:Elektrochemia
Electrolysis	Elektroliza
Electrolyte	Elektrolit
Electromagnetic radiation	Promieniowanie elektromagnetyczne
Electromagnetism	Elektrodynamika klasyczna
Electromagnetism	Kategoria:Elektromagnetyzm
Electron	Elektron
Electron microscope	Mikroskop elektronowy
Electronegativity	Elektroujemność
Electronics	Elektronika
Electronics	Kategoria:Elektronika
Elegy	Elegia
Element	Pierwiastek
Elementary particle	Cząstka elementarna
Elephant	Słoniowate
Elevator	Winda
Elf	Elf (fantastyka)
Elia Kazan	Elia Kazan
Elias Canetti	Elias Canetti
Elijah	Eliasz (postać biblijna)
Elizabeth Taylor	Elizabeth Taylor
Ella Fitzgerald	Ella Fitzgerald
Ellipse	Elipsa (matematyka)
Ellipsis	Wielokropek
Elm	Wiąz
Elvis Presley	Elvis Presley
Embryo	Embrion
Embryology	Embriologia
Emerald	Szmaragd
Emilia-Romagna	Emilia-Romania
Emiliano Zapata	Emiliano Zapata
Emily Dickinson	Emily Dickinson
Emir	Emir
Emma Goldman	Emma Goldman
Emoticon	Emotikon
Emotion	Emocja
Empathy	Empatia
Empedocles	Empedokles
Emperor	Cesarz
Emperor Penguin	Pingwin cesarski
Empire	Imperium
Empire State Building	Empire State Building
Empiricism	Empiryzm
Emu	Emu
Emulator	Emulator
Emulsion	Emulsja
Encyclopedia	Encyklopedia
Endemism	Endemit
Endocrine system	Układ hormonalny
Endocrinology	Endokrynologia
Endocrinology	Kategoria:Endokrynologia
Energy	Energia (fizyka)
Energy	Kategoria:Energetyka
Energy (society)	Energia
Engine	Silnik
Engineer	Inżynier
Engineering	Inżynieria
England	Anglia
England	Kategoria:Anglia
English Channel	Kanał La Manche
English Civil War	Angielska wojna domowa
English language	Język angielski
English language	Kategoria:Język angielski
English people	Kategoria:Anglicy
English people	Anglicy
Enki	Enki
Enrico Caruso	Enrico Caruso
Enrico Fermi	Enrico Fermi
Entertainment	Kategoria:Rozrywki
Enthalpy	Entalpia
Entomology	Entomologia
Entomology	Kategoria:Entomologia
Entropy	Entropia
Environment	Kategoria:Ochrona przyrody
Environment	Środowisko
Enzyme	Enzymy
Eocene	Eocen
Eon (geology)	Eon
Eos	Eos
Ephesus	Efez
Epic poetry	Epos
Epicenter	Epicentrum
Epictetus	Epiktet
Epicurus	Epikur
Epidemic	Epidemia
Epidemiology	Epidemiologia
Epigraphy	Epigrafika
Epilepsy	Padaczka
Epimetheus (mythology)	Epimeteusz
Epinephrine	Adrenalina
Epiphany (Christian)	Epifania
Epirus (periphery)	Epir
Epistemology	Epistemologia
Epistle to the Galatians	List do Galatów
Epistle to the Romans	List do Rzymian
Epithelium	Tkanka nabłonkowa
Epsilon	Epsilon
Equation	Równanie (matematyka)
Equator	Równik
Equatorial Guinea	Gwinea Równikowa
Equatorial Guinea	Kategoria:Gwinea Równikowa
Equidae	Koniowate
Equinox	Równonoc
Equisetum	Skrzyp
Erasure	Erasure
Erato	Erato
Eratosthenes	Eratostenes
Erbium	Erb
Erebus	Ereb
Erectile dysfunction	Impotencja
Erection	Erekcja (fizjologia)
Ericaceae	Wrzosowate
Ericales	Wrzosowce
Eridanus (constellation)	Erydan (gwiazdozbiór)
Erik Axel Karlfeldt	Erik Axel Karlfeldt
Erik Satie	Erik Satie
Eris (dwarf planet)	136199 Eris
Eris (mythology)	Eris
Eritrea	Kategoria:Erytrea
Ernest Hemingway	Ernest Hemingway
Ernest Rutherford	Ernest Rutherford
Ernst Werner von Siemens	Werner von Siemens
Eros (mythology)	Eros
Erosion	Erozja
Erotica	Erotyka
Erwin Rommel	Erwin Rommel
Escape velocity	Prędkość ucieczki
Eschatology	Eschatologia
Escherichia coli	Pałeczka okrężnicy
Esfahan	Isfahan (miasto)
Esophagus	Przełyk
Esperanto	Esperanto
Esperanto	Kategoria:Esperanto
Espionage	Szpiegostwo
Espoo	Espoo
Espresso	Espresso
Essay	Esej
Essen	Essen
Essential oil	Olejek eteryczny
Essex	Essex
Ester	Estry
Estonia	Kategoria:Estonia
Estrogen	Estrogeny
Eta (letter)	Eta
Etching	Akwaforta
Ethane	Etan
Ethanol	Alkohol etylowy
Ether	Etery
Ethernet	Ethernet
Ethics	Etyka
Ethics	Kategoria:Etyka
Ethiopia	Etiopia
Ethiopia	Kategoria:Etiopia
Ethnic group	Grupa etniczna
Ethnography	Etnografia
Ethnology	Kategoria:Etnologia
Ethology	Etologia
Ethylene	Eten
Etymology	Etymologia
Eucalyptus	Eukaliptus
Eucharist	Eucharystia (sakrament)
Euclid	Euklides
Euclidean geometry	Geometria euklidesowa
Eugene O'Neill	Eugene O'Neill
Eukaryote	Jądrowce
Eunuch	Eunuch
Euphemism	Eufemizm
Euphrates	Eufrat
Eurasia	Eurazja
Eurasian Badger	Borsuk
Euripides	Eurypides
Euro	Euro
Europa (moon)	Europa (księżyc)
Europa (mythology)	Europa (mitologia grecka)
Europe	Europa
Europe	Kategoria:Europa
European Central Bank	Europejski Bank Centralny
European Community	Wspólnota Europejska
European Magpie	Sroka
European Union	Unia Europejska
European Union	Kategoria:Unia Europejska
Europium	Europ
Eusebius of Caesarea	Euzebiusz z Cezarei
Euterpe	Euterpe
Euthanasia	Eutanazja
Eva Braun	Eva Braun
Evanescence	Evanescence
Evangelista Torricelli	Evangelista Torricelli
Evaporation	Parowanie
Even-toed ungulate	Parzystokopytne
Evolution	Ewolucja biologiczna
Excalibur	Excalibur
Exchange rate	Kurs walutowy
Exclamation mark	Wykrzyknik
Excommunication	Ekskomunika
Executive (government)	Władza wykonawcza
Exhibitionism	Ekshibicjonizm
Existentialism	Egzystencjalizm (filozofia)
Exodus	Księga Wyjścia
Expected value	Wartość oczekiwana
Experiment	Eksperyment
Explosion	Wybuch
Expo (exhibition)	Wystawa światowa
Exponential function	Funkcja wykładnicza
Exponentiation	Potęga
Expressionism	Ekspresjonizm
Extinction	Wyginięcie
Eye	Oko
Eye	Kategoria:Oko
Ezra Pound	Ezra Pound
F	F
F. Scott Fitzgerald	Francis Scott Fitzgerald
Fabaceae	Bobowate
Fable	Bajka
Face	Twarz
Fact	Szablon:Fakt
Factorial	Silnia
Factory	Fabryka
Facula	Plama słoneczna
Fado	Fado
Fagaceae	Kategoria:Bukowate
Fagales	Bukowce
Fahrenheit	Skala Fahrenheita
Fair use	Dozwolony użytek
Fairy tale	Baśń
Falcon	Sokoły
Falconiformes	Szponiaste
Falkland Islands	Falklandy
Fallacy	Sofizmat
Fallopian tube	Jajowód
Fallow Deer	Daniel (zwierzę)
Falun Gong	Falun Gong
Family	Kategoria:Rodzina
Family (biology)	Rodzina (biologia)
Family history	Genealogia
Family name	Nazwisko
Fantasy	Fantasy
Farad	Farad
Faroe Islands	Kategoria:Wyspy Owcze
Fascism	Faszyzm
Fascism	Kategoria:Faszyzm
Fashion	Kategoria:Moda
Fashion	Moda (styl)
Fast food	Fast food
Fasting	Post
Fatah	Al-Fatah
Fatty acid	Kwasy tłuszczowe
Fault (geology)	Uskok
Fauna	Fauna
Fauvism	Fowizm
Fax	Telefaks
Fear	Strach
Feather	Pióro
February	Luty
February 12	12 lutego
February 14	14 lutego
February 2	2 lutego
February 22	22 lutego
February 29	29 lutego
February Revolution	Rewolucja lutowa 1917
Feces	Kał
Federal Bureau of Investigation	Federal Bureau of Investigation
Federal Reserve System	System Rezerwy Federalnej USA
Federated States of Micronesia	Mikronezja
Federated States of Micronesia	Kategoria:Mikronezja
Federation	Federacja
Federico Fellini	Federico Fellini
Fedora (Linux distribution)	Fedora Core
Feedback	Sprzężenie zwrotne
Feldspar	Skaleń
Felidae	Kotowate
Felix Mendelssohn	Felix Mendelssohn-Bartholdy
Feminism	Feminizm
Feminism	Kategoria:Feminizm
Fencing	Szermierka
Feng shui	Feng shui
Fennel	Fenkuł włoski
Fenrir	Fenrir
Fenugreek	Kozieradka pospolita
Ferdinand II	Ferdynand II Habsburg
Ferdinand Magellan	Ferdynand Magellan
Ferdinand de Saussure	Ferdinand de Saussure
Fermentation (biochemistry)	Fermentacja
Fermentation (food)	Fermentacja
Fermion	Fermion
Fermium	Ferm (pierwiastek)
Fern	Paprotniki
Ferrara	Ferrara
Ferry	Prom
Fertile Crescent	Żyzny Półksiężyc
Fertilisation	Zapłodnienie
Fertilizer	Nawozy
Fetus	Płód
Feudalism	Feudalizm
Fever	Gorączka
Fiat	Fiat
Fibonacci number	Ciąg Fibonacciego
Fictional character	Postać literacka
Fidel Castro	Fidel Castro
Field (mathematics)	Ciało (matematyka)
Field hockey	Hokej na trawie
Fighter aircraft	Samolot myśliwski
Figure skating	Łyżwiarstwo figurowe
Fiji	Fidżi
Fiji	Kategoria:Fidżi
File Allocation Table	File Allocation Table
File Transfer Protocol	FTP
File system	System plików
Filippo Brunelleschi	Filippo Brunelleschi
Film	Kategoria:Kinematografia
Film	Film
Film	Portal:Film
Film director	Reżyser
Fin Whale	Finwal
Finance	Kategoria:Finanse
Finance	Finanse
Finger	Palec ręki
Finland	Finlandia
Finland	Kategoria:Finlandia
Fir	Jodła
Fire	Ogień
Firearm	Broń palna
Firefighter	Straż pożarna
Firewall (networking)	Zapora sieciowa
Firmware	Oprogramowanie wbudowane w urządzenie
First Council of Constantinople	Sobór Konstantynopolitański I
First Council of Nicaea	Sobór Nicejski I
First Crusade	I wyprawa krzyżowa
First Epistle to the Corinthians	1. List do Koryntian
First aid	Pierwsza pomoc
First language	Język ojczysty
Fish	Ryby
Fishing	Wędkarstwo
Fishing	Kategoria:Wędkarstwo
Fjord	Fiord
Flag	Flaga
Flagellum	Wić
Flamenco	Flamenco
Flamingo	Flamingi
Flanders	Flandria
Flash memory	Pamięć Flash
Flatulence	Gazy jelitowe
Flatworm	Płazińce
Flea	Pchły
Flemish (linguistics)	Język flamandzki
Flint	Krzemień
Flip-flop (electronics)	Przerzutnik
Flood	Powódź
Floppy disk	Dyskietka
Florence	Florencja
Florence Nightingale	Florence Nightingale
Florida	Floryda
Florida	Kategoria:Floryda
Flour	Mąka
Flower	Kwiat
Flowering plant	Okrytonasienne
Fluid	Płyn
Fluid mechanics	Mechanika płynów
Fluorite	Fluoryt
Flute	Flet
Fly	Muchówki
Fog	Mgła
Folic acid	Kwas foliowy
Folk music	Muzyka folkowa
Folklore	Folklor
Food	Pokarm
Food additive	Dodatek do żywności
Food and Agriculture Organization	Organizacja Narodów Zjednoczonych do spraw Wyżywienia i Rolnictwa
Food chain	Łańcuch pokarmowy
Foot	Stopa (anatomia)
Foot (unit of length)	Stopa angielska
Football (soccer)	Piłka nożna
Football (soccer)	Kategoria:Piłka nożna
Football (soccer) by country	Kategoria:Piłka nożna w krajach świata
Football (soccer) clubs	Kategoria:Kluby piłkarskie
Football (soccer) managers	Kategoria:Trenerzy piłkarscy
Football (soccer) players	Kategoria:Piłkarze
Forbidden City	Zakazane Miasto
Force	Siła
Forest	Las
Forestry	Leśnictwo (nauka)
Fork	Widelec
Formaldehyde	Aldehyd mrówkowy
Formic acid	Kwas mrówkowy
Fornax	Piec (gwiazdozbiór)
Fort Worth	Fort Worth
Fortification	Fortyfikacja
Fortran	Fortran
Fossil	Skamieniałości
Fossil fuel	Paliwa kopalne
Foucault pendulum	Wahadło Foucaulta
Fountain	Fontanna
Fourier series	Szereg Fouriera
Fourth Crusade	IV wyprawa krzyżowa
Fox	Lis
Fractal	Fraktal
Fraction (mathematics)	Ułamek
France	Francja
France	Kategoria:Francja
Francis Bacon	Francis Bacon (filozof)
Francis Crick	Francis Crick
Francis Drake	Francis Drake
Francis Ford Coppola	Francis Ford Coppola
Francis II	Franciszek II Habsburg
Francis Poulenc	Francis Poulenc
Francis of Assisi	Franciszek z Asyżu
Franciscan	Bracia mniejsi
Francisco Franco	Francisco Franco
Francisco Goya	Francisco Goya
Francisco Pizarro	Francisco Pizarro
Francium	Frans (pierwiastek)
Franco-Prussian War	Wojna francusko-pruska
Frank Lloyd Wright	Frank Lloyd Wright
Frank Sinatra	Frank Sinatra
Frankfort	Frankfort (Kentucky)
Frankfurt	Frankfurt nad Menem
Frankfurt	Kategoria:Frankfurt nad Menem
Frankfurt (Oder)	Frankfurt nad Odrą
Frankfurt (disambiguation)	Frankfurt
Franklin Pierce	Franklin Pierce
Frans Hals	Frans Hals
Franz Kafka	Franz Kafka
Franz Liszt	Ferenc Liszt
Franz Schubert	Franz Schubert
Fred Astaire	Fred Astaire
Frederick I	Fryderyk I Barbarossa
Frederick II	Fryderyk II Hohenstauf
Frederick Sanger	Frederick Sanger
Frederick Soddy	Frederick Soddy
Fredericton	Fredericton
Free State	Wolne Państwo
Free will	Wolna wola
Freedom (philosophy)	Wolność
Freedom of speech	Wolność słowa
Freemasonry	Wolnomularstwo
Freetown	Freetown
Freeware	Freeware
French Polynesia	Polinezja Francuska
French Polynesia	Kategoria:Polinezja Francuska
French Revolution	Rewolucja francuska
French Revolution	Kategoria:Rewolucja francuska
French franc	Frank francuski
French people	Kategoria:Francuzi
Frequency	Częstotliwość
Fresco	Fresk
Freshwater	Woda słodka
Fresno	Fresno (Kalifornia)
Freyja	Freja
Freyr	Frejr
Friction	Tarcie (pojęcie fizyczne)
Friday	Piątek
Fridtjof Nansen	Fridtjof Nansen
Friedrich Engels	Fryderyk Engels
Friesland	Fryzja (prowincja)
Frigate	Fregata (okręt)
Frigg	Frigg
Fritz Haber	Fritz Haber
Friuli-Venezia Giulia	Friuli-Wenecja Julijska
Frog	Płazy bezogonowe
Fructose	Fruktoza
Fruit	Owoc
Fruit	Kategoria:Owoce
Fucking	Fucking
Fuel	Paliwo
Fuel cell	Ogniwo paliwowe
Fugue	Fuga (muzyka)
Fukuoka	Fukuoka
Funafuti	Funafuti
Function (mathematics)	Funkcja
Fundamental	Kategoria:Strona główna
Fundamental interaction	Oddziaływania podstawowe
Fundamentalism	Fundamentalizm
Fungi	Kategoria:Grzyby
Fungus	Grzyby
Funicular	Kolej linowo-terenowa
Funk	Funk
Furniture	Kategoria:Meble
Furniture	Meble
Future	Przyszłość
Futurism (art)	Futuryzm
Fuzzy logic	Logika rozmyta
Fyodor Dostoevsky	Fiodor Dostojewski
G	G
GIMP	GIMP
GNOME	GNOME
GNU	GNU
Gabon	Gabon
Gabon	Kategoria:Gabon
Gaborone	Gaborone
Gabriel	Archanioł Gabriel
Gabriel Lippmann	Gabriel Lippmann
Gadolinium	Gadolin
Gaetano Donizetti	Gaetano Donizetti
Gaia (mythology)	Gaja (mitologia)
Galatia	Galacja
Galaxy	Galaktyka
Galen	Galen
Galena	Galena
Galicia (Central Europe)	Galicja
Galicia (Spain)	Galicia
Galilee	Galilea
Galileo (spacecraft)	Galileo (sonda)
Galileo Galilei	Galileusz
Gallbladder	Pęcherzyk żółciowy
Galley	Galera
Galliformes	Grzebiące
Galliformes	Kategoria:Grzebiące
Gallium	Gal
Gallon	Galon (miara)
Galway	Galway
Gamal Abdel Nasser	Gamal Abdel Naser
Gambling	Gry hazardowe
Game	Gra
Game theory	Teoria gier
Gamma	Gamma
Gamma ray	Promieniowanie gamma
Ganesha	Ganeśa
Ganges	Ganges
Ganja	Gandża
Gansu	Gansu
Ganymede	Ganimedes (mitologia)
Ganymede (moon)	Ganimedes (księżyc)
Gap	Gap
Garden	Sad
Garden of Eden	Eden (raj)
Gardening	Ogrodnictwo
Garfield	Garfield
Gargoyle	Rzygacz
Garlic	Czosnek pospolity
Garnet	Granat (minerał)
Garonne	Garonna
Gas	Gaz
Gas constant	Stała gazowa
Gas giant	Gazowy olbrzym
Gasoline	Benzyna
Gastrointestinal tract	Układ pokarmowy człowieka
Gastropoda	Ślimaki
Gaul	Galia
Gautama Buddha	Budda Siakjamuni
Gay	Gej
Gaza	Gaza (Palestyna)
Gaza Strip	Strefa Gazy
Gear	Koło zębate
Geb	Geb
Geisha	Gejsza
Gemini (constellation)	Bliźnięta (gwiazdozbiór)
Gemstone	Kamienie szlachetne
Gene	Gen
Genealogy	Genealogia
Genealogy	Kategoria:Genealogia
General Agreement on Tariffs and Trade	GATT
General Officer	Generał
General relativity	Ogólna teoria względności
Genesis	Księga Rodzaju
Genetic code	Kod genetyczny
Genetic engineering	Inżynieria genetyczna
Genetics	Genetyka
Genetics	Kategoria:Genetyka
Geneva	Genewa
Genitive case	Dopełniacz (przypadek)
Genoa	Genua
Genocide	Ludobójstwo
Genome	Genom
Genotype	Genotyp
Genus	Rodzaj (biologia)
Geochemistry	Geochemia
Geodesy	Geodezja
Geodesy	Kategoria:Geodezja
Geoffrey Chaucer	Geoffrey Chaucer
Geography	Geografia
Geography	Kategoria:Geografia
Geography	Portal:Geografia
Geology	Kategoria:Geologia
Geology	Geologia
Geometric progression	Szereg geometryczny
Geometry	Geometria
Geometry	Kategoria:Geometria
Geomorphology	Geomorfologia
Geomorphology	Kategoria:Geomorfologia
Geophysics	Geofizyka
Geophysics	Kategoria:Geofizyka
Geopolitics	Geopolityka
Georg Philipp Telemann	Georg Philipp Telemann
Georg Wilhelm Friedrich Hegel	Georg Wilhelm Friedrich Hegel
George Berkeley	George Berkeley
George Bernard Shaw	George Bernard Shaw
George Boole	George Boole
George Bush	George Bush
George Frideric Handel	Georg Friedrich Händel
George Gershwin	George Gershwin
George Harrison	George Harrison
George Lucas	George Lucas
George Marshall	George Marshall
George Orwell	George Orwell
George Paget Thomson	George Thomson
George Sand	George Sand
George Stephenson	George Stephenson
George W. Bush	George W. Bush
George Washington	George Washington
Georges Bizet	Georges Bizet
Georges Braque	Georges Braque
Georges Clemenceau	Georges Clemenceau
Georges Simenon	Georges Simenon
Georgetown	Georgetown (Gujana)
Georgia (U.S. state)	Georgia
Georgia (U.S. state)	Kategoria:Georgia
Georgia (country)	Gruzja
Georgia (country)	Kategoria:Gruzja
Gerald Ford	Gerald Ford
Gerard Kuiper	Gerard Kuiper
German Shepherd Dog	Owczarek niemiecki
German language	Język niemiecki
German language	Kategoria:Język niemiecki
German mark	Marka niemiecka
Germanium	German
Germany	Niemcy
Germany	Kategoria:Niemcy
Geronimo	Geronimo (wódz Indian Chiricahua)
Gestapo	Gestapo
Geyser	Gejzer
Ghana	Ghana
Ghana	Kategoria:Ghana
Ghent	Gandawa
Ghetto	Getto
Ghost	Duch (spirytyzm)
Giacomo Puccini	Giacomo Puccini
Giant Panda	Panda wielka
Gibbon	Gibonowate
Gibraltar	Gibraltar
Gibraltar	Kategoria:Gibraltar
Gigabyte	Gigabajt
Gilgamesh	Gilgamesz
Ginger	Imbir lekarski
Ginkgo	Miłorząb dwuklapowy
Giordano Bruno	Giordano Bruno
Giorgio Vasari	Giorgio Vasari
Giorgio de Chirico	Giorgio de Chirico
Giotto di Bondone	Giotto di Bondone
Giovanni Boccaccio	Giovanni Boccaccio
Giraffe	Żyrafa
Giraffidae	Żyrafowate
Girolamo Savonarola	Girolamo Savonarola
Gironde	Gironde
Giuseppe Garibaldi	Giuseppe Garibaldi
Giuseppe Verdi	Giuseppe Verdi
Giza	Giza
Glacier	Lodowiec
Gladiator	Gladiator
Gland	Gruczoł
Glasgow	Glasgow
Glasnost	Głasnost
Glass	Szkło
Glasses	Okulary korekcyjne
Glider	Szybowiec
Global Positioning System	Global Positioning System
Global warming	Globalne ocieplenie
Globalization	Globalizacja
Globe artichoke	Karczoch zwyczajny
Gloucestershire	Gloucestershire
Glucagon	Glukagon
Glucose	Glukoza
Gluon	Gluon
Glutamic acid	Kwas glutaminowy
Glycerol	Gliceryna
Glycine	Glicyna
Glycogen	Glikogen
Glycolysis	Glikoliza
Gnathostomata	Żuchwowce
Gneiss	Gnejs
Gnosticism	Gnostycyzm
Go (board game)	Go
Goa	Goa
Goalkeeper	Bramkarz
Goat	Koza domowa
Gobi Desert	Gobi
God	Bóg
Golan Heights	Wzgórza Golan
Gold	Złoto
Golda Meir	Golda Meir
Golden Eagle	Orzeł przedni
Golden Gate Bridge	Most Golden Gate
Golden Horde	Złota Orda
Golden Retriever	Golden Retriever
Golf	Golf
Golf	Kategoria:Golf
Golgi apparatus	Aparat Golgiego
Gomel	Homel
Good Friday	Wielki Piątek
Google	Google
Google	Kategoria:Google
Googol	Googol
Gorgon	Gorgona (postać mitologiczna)
Gorilla	Goryl
Goshawk	Jastrząb gołębiarz
Gospel	Ewangelia
Gospel of Luke	Ewangelia Łukasza
Gothenburg	Göteborg
Gothic	Gothic
Gothic architecture	Architektura gotycka
Gotthold Ephraim Lessing	Gotthold Ephraim Lessing
Gottlieb Daimler	Gottlieb Daimler
Gout	Dna moczanowa
Government	Rada Ministrów
Grace Kelly	Grace Kelly
Gradient	Gradient (matematyka)
Graffiti	Graffiti
Graham Greene	Graham Greene (pisarz)
Gram	Gram
Grammar	Gramatyka
Grammar	Kategoria:Gramatyka
Grammatical gender	Rodzaj gramatyczny
Granada	Granada (miasto w Hiszpanii)
Grand Canyon	Wielki Kanion Kolorado
Grand Slam (tennis)	Wielki Szlem (tenis)
Grandmaster (chess)	Arcymistrz
Granite	Granit
Grape	Winorośl
Grapefruit	Grejpfrut
Graphical user interface	Interfejs graficzny
Graphite	Grafit
Gravitation	Grawitacja
Gravitational constant	Stała grawitacji
Graviton	Grawiton
Gray (unit)	Grej
Gray Wolf	Wilk
Graz	Graz
Great Barrier Reef	Wielka Rafa Koralowa
Great Britain	Wielka Brytania (wyspa)
Great Crested Grebe	Perkoz dwuczuby
Great Depression	Wielki kryzys
Great Lakes	Wielkie Jeziora Północnoamerykańskie
Great Rift Valley	Wielkie Rowy Afrykańskie
Great Wall of China	Wielki Mur Chiński
Great white shark	Żarłacz biały
Greater Antilles	Wielkie Antyle
Greater London	Wielki Londyn
Greatest common divisor	Największy wspólny dzielnik
Grebe	Perkozy
Greece	Grecja
Greece	Kategoria:Grecja
Greek alphabet	Alfabet grecki
Greek alphabet	Kategoria:Alfabet grecki
Greek fire	Ogień grecki
Greek mythology	Mitologia grecka
Greek mythology	Kategoria:Mitologia grecka
Green	Barwa zielona
Greenhouse	Szklarnia (ogrodnictwo)
Greenhouse effect	Efekt cieplarniany
Greenhouse gas	Gaz cieplarniany
Greenland	Grenlandia
Greenland	Kategoria:Grenlandia
Greenland Sea	Morze Grenlandzkie
Greenpeace	Greenpeace
Greenwich	Greenwich
Greenwich Mean Time	Czas uniwersalny
Gregor Mendel	Gregor Mendel
Gregorian calendar	Kalendarz gregoriański
Grenada	Kategoria:Grenada
Grenoble	Grenoble
Greta Garbo	Greta Garbo
Grey	Szary
Greylag Goose	Gęś gęgawa
Griffin	Gryf (mitologia)
Griffon Vulture	Sęp płowy
Gross domestic product	Produkt krajowy brutto
Group	Grupa
Group (mathematics)	Grupa (matematyka)
Group (periodic table)	Grupa układu okresowego
Group theory	Teoria grup
Grover Cleveland	Grover Cleveland
Grozny	Grozny
Gruiformes	Żurawiowe
Grus (constellation)	Żuraw (gwiazdozbiór)
Guadalajara	Guadalajara (miasto w Meksyku)
Guadeloupe	Gwadelupa
Guam	Guam
Guangdong	Guangdong
Guangzhou	Kanton (Chiny)
Guanine	Guanina
Guano	Guano
Guatemala	Kategoria:Gwatemala
Guatemala City	Gwatemala (miasto)
Guayaquil	Guayaquil
Guernsey	Guernsey
Guglielmo Marconi	Guglielmo Marconi
Guild	Gildia (historia)
Guillaume Apollinaire	Guillaume Apollinaire
Guillotine	Gilotyna
Guinea	Gwinea
Guinea	Kategoria:Gwinea
Guinea pig	Świnka morska
Guinea-Bissau	Gwinea Bissau
Guinea-Bissau	Kategoria:Gwinea Bissau
Guitar	Gitara
Gujarat	Gujarat
Gulag	Gułag
Gulf Stream	Prąd Zatokowy
Gulf War	I wojna w Zatoce Perskiej
Gulf of Aden	Zatoka Adeńska
Gulf of Aqaba	Zatoka Akaba
Gulf of Bothnia	Zatoka Botnicka
Gulf of Finland	Zatoka Fińska
Gulf of Guinea	Zatoka Gwinejska
Gulf of Mexico	Zatoka Meksykańska
Gulf of Oman	Zatoka Omańska
Gulf of Riga	Zatoka Ryska
Gulf of Thailand	Zatoka Tajlandzka
Gull	Mewy
Gunpowder	Proch
Gunpowder Plot	Spisek prochowy
Guppy	Gupik
Gustav Klimt	Gustav Klimt
Gustav Ludwig Hertz	Gustav Ludwig Hertz
Gustav Mahler	Gustav Mahler
Gustave Courbet	Gustave Courbet
Gustave Flaubert	Gustaw Flaubert
Guy Fawkes	Guy Fawkes
Guy de Maupassant	Guy de Maupassant
Guyana	Kategoria:Gujana
Gymnastics	Gimnastyka
Gymnosperm	Nagonasienne
Gynaecology	Ginekologia
Gypsum	Gips
Gyroscope	Żyroskop
H	H
H. G. Wells	Herbert George Wells
HIV	Wirus zespołu nabytego braku odporności
HTML	HTML
Habitat	Siedlisko (biologia)
Hacker	Haker (slang komputerowy)
Hadean	Hadeik
Hades	Hades
Hadith	Hadis
Hadrian	Hadrian
Hadrian's Wall	Mur Hadriana
Hadron	Hadron
Haemophilia	Hemofilia
Hafnium	Hafn
Hagia Sophia	Hagia Sofia
Haifa	Hajfa
Haiku	Haiku
Hail	Grad
Hail Mary	Zdrowaś Maryjo
Hair	Włos
Haiti	Haiti
Haiti	Kategoria:Haiti
Hajj	Pielgrzymki w islamie
Halal	Halal
Halberd	Halabarda
Half-life	Czas połowicznego rozpadu
Halle	Halle (Saale)
Halloween	Halloween
Hallucination	Halucynacja
Halogen	Fluorowce
Hamas	Hamas
Hamburg	Hamburg
Hamburg	Kategoria:Hamburg
Hamburger	Hamburger
Hamlet	Hamlet
Hammer	Młotek
Hammer and sickle	Sierp i młot
Hammurabi	Hammurabi
Hampshire	Hampshire (Anglia)
Hamster	Chomik
Han Dynasty	Dynastia Han
Hand	Dłoń
Hand grenade	Granat (broń)
Handgun	Pistolet
Hanging	Powieszenie
Hanging Gardens of Babylon	Wiszące ogrody Semiramidy
Hannah Arendt	Hannah Arendt
Hannibal	Hannibal
Hanoi	Hanoi
Hanover	Hanower
Hans Bethe	Hans Bethe
Hans Christian Andersen	Hans Christian Andersen
Hanseatic League	Hanza
Hanukkah	Chanuka
Hanuman	Hanuman
Happiness	Szczęście
Harare	Harare
Hardness	Twardość
Harem	Harem
Harlem	Harlem (Nowy Jork)
Harmonica	Harmonijka ustna
Harmony	Harmonika (muzyka)
Harold Pinter	Harold Pinter
Harp	Harfa
Harpsichord	Klawesyn
Harpy	Harpia (mitologia)
Harriet Beecher Stowe	Harriet Beecher Stowe
Harriet Tubman	Harriet Tubman
Harrisburg	Harrisburg (Pensylwania)
Harry Houdini	Harry Houdini
Hartford	Hartford (Connecticut)
Hassium	Has
Hatred	Nienawiść
Haute-Normandie	Górna Normandia
Havana	Hawana
Hawaii	Hawaje (stan w USA)
Hawaii	Kategoria:Hawaje
Hazel	Leszczyna
Head	Głowa
Head of state	Głowa państwa
Health	Zdrowie
Health	Kategoria:Zdrowie
Heart	Serce
Heat	Ciepło
Heat engine	Silnik cieplny
Heaven	Niebo
Heavy metal	Kategoria:Metal
Heavy metal music	Heavy metal
Heavy water	Ciężka woda
Hebe (mythology)	Hebe (mitologia)
Hebei	Hebei
Hebrew alphabet	Alfabet hebrajski
Hebrew calendar	Kalendarz żydowski
Hebrides	Hebrydy
Hecate	Hekate (mitologia)
Hectare	Hektar
Hector	Hektor
Hector Berlioz	Hector Berlioz
Hedgehog	Jeżowate
Hedonism	Hedonizm
Heimdall	Hajmdal
Heinrich Hertz	Heinrich Hertz
Heinrich Himmler	Heinrich Himmler
Heinrich Schliemann	Heinrich Schliemann
Hel (being)	Hel (bogini)
Helen	Helena Trojańska
Helen Keller	Helen Keller
Helena	Helena (Montana)
Helicopter	Śmigłowiec
Helios	Helios
Helium	Hel
Hell	Piekło
Helmut Schmidt	Helmut Schmidt
Helsinki	Helsinki
Hematite	Hematyt
Hematology	Hematologia
Hematology	Kategoria:Hematologia
Hemoglobin	Hemoglobina
Hemorrhoid	Żylaki odbytu
Henri Becquerel	Henri Becquerel
Henri Bergson	Henri Bergson
Henri Matisse	Henri Matisse
Henrik Ibsen	Henryk Ibsen
Henry (unit)	Henr
Henry Cavendish	Henry Cavendish
Henry David Thoreau	Henry David Thoreau
Henry Fonda	Henry Fonda
Henry Ford	Henry Ford
Henry James	Henry James
Henry Kissinger	Henry Kissinger
Henry Miller	Henry Miller
Henry Moore	Henry Moore (rzeźbiarz)
Henry Purcell	Henry Purcell
Hepatitis	Zapalenie wątroby
Hephaestus	Hefajstos
Hera	Hera
Heracles	Herakles
Heraclitus	Heraklit
Heraldry	Heraldyka
Heraldry	Kategoria:Heraldyka
Herat	Herāt (miasto)
Herbert Hoover	Herbert Hoover
Herbert Marcuse	Herbert Marcuse
Herbert Spencer	Herbert Spencer
Hercules	Herakles
Hercules (constellation)	Herkules (gwiazdozbiór)
Heresy	Herezja
Herman Melville	Herman Melville
Hermann Hesse	Hermann Hesse
Hermann Minkowski	Hermann Minkowski
Hermann von Helmholtz	Hermann von Helmholtz
Hermeneutics	Hermeneutyka
Hermes	Hermes
Hero	Bohater
Hero of Alexandria	Heron z Aleksandrii
Herod the Great	Herod Wielki
Herodotus	Herodot
Heroin	Heroina
Heron	Czaplowate
Herring Gull	Mewa srebrzysta
Hertfordshire	Hertfordshire
Hertz	Herc
Hesiod	Hezjod
Hesperides	Hesperydy
Hesse	Hesja
Hesse	Kategoria:Hesja
Hestia	Hestia
Heterosexuality	Heteroseksualizm
Heterotroph	Cudzożywność
Hexadecimal	Szesnastkowy system liczbowy
Hexagon	Sześciokąt
Hezbollah	Hezbollah
Hibernation	Sen zimowy
Hideki Yukawa	Hideki Yukawa
Hieronymus Bosch	Hieronim Bosch
Hilbert space	Przestrzeń Hilberta
Himalayas	Himalaje
Hindu Kush	Hindukusz
Hinduism	Hinduizm
Hinduism	Kategoria:Hinduizm
Hipparchus	Hipparchos z Nikei
Hippie	Ruch hippisowski
Hippocrates	Hipokrates
Hippocratic Oath	Przysięga Hipokratesa
Hippopotamus	Hipopotam nilowy
Hirohito	Hirohito
Hiroshima	Hiroszima
Hispaniola	Haiti (wyspa)
Histidine	Histydyna
Histology	Histologia
Histology	Kategoria:Histologia
Histone	Histony
Historiography	Historiografia
History	Historia
History	Kategoria:Historia
History	Portal:Historia
Ho Chi Minh	Hồ Chí Minh
Ho Chi Minh City	Ho Chi Minh (miasto)
Hobart	Hobart
Hobbit	Hobbit (rasa)
Hobby	Hobby
Hokusai	Katsushika Hokusai
Holiday	Święto
Hollywood	Hollywood
Holmium	Holm (pierwiastek)
Holocene	Holocen
Holography	Holografia
Holy Grail	Graal
Holy Roman Empire	Święte Cesarstwo Rzymskie Narodu Niemieckiego
Holy Spirit	Duch Święty
Homeopathy	Homeopatia
Homeostasis	Homeostaza
Homer	Homer
Hominidae	Człowiekowate
Homo (genus)	Człowiek
Homo erectus	Homo erectus
Homo habilis	Homo habilis
Homonym	Homonim
Homophobia	Homofobia
Homosexuality	Homoseksualizm
Honduras	Honduras
Honduras	Kategoria:Honduras
Honey	Miód
Honey Buzzard	Trzmielojad
Hong Kong	Hongkong
Hong Kong	Kategoria:Hongkong
Honiara	Honiara
Honolulu	Honolulu
Hookah	Szisza
Hooke's law	Prawo Hooke'a
Hoopoe	Dudek
Horace	Horacy (poeta)
Horatio Nelson	Horatio Nelson
Horizon	Horyzont
Hormone	Hormon
Horn (anatomy)	Róg (biologia)
Horn (instrument)	Róg (instrument muzyczny)
Horoscope	Horoskop
Horse	Koń
Horsepower	Koń parowy
Horus	Horus
Hosni Mubarak	Hosni Mubarak
Hospital	Szpital
Hotel	Hotel
Hour	Godzina
Hourglass	Klepsydra
House	Dom
House (TV series)	Dr House
House Mouse	Mysz domowa
House Sparrow	Wróbel domowy
Houston	Houston
Hovercraft	Poduszkowiec
Howard Carter (archaeologist)	Howard Carter
Hubble's law	Prawo Hubble'a
Hudson Bay	Zatoka Hudsona
Hudson River	Hudson (rzeka)
Hugh Capet	Hugo Kapet
Hugo Grotius	Hugo Grocjusz
Huguenot	Hugenoci
Human	Człowiek rozumny
Humanism	Humanizm
Humanities	Kategoria:Nauki humanistyczne
Humerus	Kość ramienna
Humidity	Wilgotność powietrza
Hummingbird	Kolibry
Humor	Kategoria:Humor
Humour	Humor (postać komizmu)
Humpback Whale	Humbak
Humphrey Bogart	Humphrey Bogart
Humus	Próchnica (gleba)
Hunan	Hunan
Hundred Years' War	Wojna stuletnia
Hungary	Węgry
Hungary	Kategoria:Węgry
Hunger	Głód
Hunting	Polowanie
Hutu	Hutu
Hybrid	Hybryda (biologia)
Hyderabad	Hajdarabad (Indie)
Hydra (constellation)	Hydra (gwiazdozbiór)
Hydrocarbon	Węglowodór
Hydrochloric acid	Kwas solny
Hydroelectricity	Elektrownia wodna
Hydrogen	Wodór
Hydrogen bond	Wiązanie wodorowe
Hydrogen cyanide	Cyjanowodór
Hydrogen peroxide	Nadtlenek wodoru
Hydrology	Hydrologia
Hydrology	Kategoria:Hydrologia
Hydrolysis	Hydroliza
Hydrosphere	Hydrosfera
Hydroxide	Jon wodorotlenowy
Hydrus	Wąż Wodny (gwiazdozbiór)
Hyena	Hienowate
Hygiene	Kategoria:Higiena
Hymen	Błona dziewicza
Hymenoptera	Kategoria:Błonkoskrzydłe
Hymenoptera	Błonkoskrzydłe
Hymn	Hymn
Hyperbola	Hiperbola (matematyka)
Hyperbole	Hiperbola (teoria literatury)
Hyperion (moon)	Hyperion (księżyc)
Hyperion (mythology)	Hyperion (mitologia)
Hypertension	Nadciśnienie tętnicze
Hypertext	Hipertekst
Hypertext Transfer Protocol	Hypertext Transfer Protocol
Hypnos	Hypnos
Hypnosis	Hipnoza
Hypothalamus	Podwzgórze
Hypothesis	Hipoteza
I	I
I. M. Pei	Ieoh Ming Pei
IPod	IPod
Ian Fleming	Ian Fleming
Iapetus (moon)	Japet (księżyc)
Iapetus (mythology)	Japeton
Iberian Peninsula	Półwysep Iberyjski
Ibuprofen	Ibuprofen
Ice	Lód
Ice age	Epoka lodowa
Ice cream	Lody
Ice hockey	Hokej na lodzie
Ice hockey	Kategoria:Hokej na lodzie
Iceberg	Góra lodowa
Iceland	Islandia
Iceland	Kategoria:Islandia
Ichthyology	Ichtiologia
Icon	Ikona
Iconoclasm	Ikonoklazm
Idaho	Idaho
Idaho	Kategoria:Idaho
Ideal gas	Gaz doskonały
Idealism	Idealizm
Identity element	Element neutralny
Identity matrix	Macierz jednostkowa
Ideology	Ideologia
Ido	Ido
Igloo	Igloo
Ignatius of Loyola	Ignacy Loyola
Igneous rock	Skały magmowe
Igor Stravinsky	Igor Strawiński
Iguazu Falls	Wodospad Iguaçu
Iliad	Iliada
Illinois	Illinois
Illinois	Kategoria:Illinois
Illyria	Iliria
Image scanner	Skaner
Imam	Imam
Immanuel Kant	Immanuel Kant
Immune system	Układ odpornościowy
Immunology	Immunologia
Immunology	Kategoria:Immunologia
Imperialism	Imperializm
Impressionism	Impresjonizm
Incest	Kazirodztwo
Inch	Cal
Incheon	Inch'ŏn
Inclined plane	Równia pochyła
Independence	Niepodległość
India	Indie
India	Kategoria:Indie
Indian Ocean	Ocean Indyjski
Indian Ocean	Kategoria:Ocean Indyjski
Indiana	Indiana
Indiana	Kategoria:Indiana
Indianapolis	Indianapolis
Indira Gandhi	Indira Gandhi
Indium	Ind
Indochina	Indochiny
Indonesia	Indonezja
Indonesia	Kategoria:Indonezja
Indra	Indra
Inductance	Indukcyjność
Inductive reasoning	Rozumowanie indukcyjne
Inductor	Cewka
Indulgence	Odpust
Indus (constellation)	Indianin (gwiazdozbiór)
Indus River	Indus (rzeka)
Industrial Revolution	Rewolucja przemysłowa
Industry	Przemysł (ekonomia)
Industry	Kategoria:Przemysł
Inequality	Nierówność
Inertia	Bezwładność
Infantry	Piechota
Infectious disease	Choroba zakaźna
Infinitive	Bezokolicznik
Infinity	Nieskończoność
Inflammation	Zapalenie
Inflation	Inflacja
Influenza	Grypa
Information	Informacja
Information technology	Technologia informacyjna
Information theory	Teoria informacji
Infrared	Podczerwień
Ingmar Bergman	Ingmar Bergman
Ingrid Bergman	Ingrid Bergman
Inner Mongolia	Mongolia Wewnętrzna
Innovation	Innowacja
Innsbruck	Innsbruck
Inorganic chemistry	Chemia nieorganiczna
Inorganic chemistry	Kategoria:Chemia nieorganiczna
Inquisition	Inkwizycja
Insect	Owady
Insecticide	Insektycydy
Insectivora	Owadożerne
Insulin	Insulina
Insurance	Ubezpieczenie (ubezpieczenia)
Integer	Liczby całkowite
Integrated circuit	Układ scalony
Intellectual property	Prawo własności intelektualnej
Intelligence	Inteligencja (psychologia)
Intelligence quotient	Iloraz inteligencji
Intercontinental ballistic missile	Międzykontynentalny pocisk balistyczny
Interest	Odsetki
Interference	Interferencja
Interjection	Wykrzyknik (część mowy)
Interlingua	Interlingua
International Atomic Energy Agency	Międzynarodowa Agencja Energii Atomowej
International Civil Aviation Organization	Organizacja Międzynarodowego Lotnictwa Cywilnego
International Court of Justice	Międzynarodowy Trybunał Sprawiedliwości
International Date Line	Międzynarodowa linia zmiany daty
International Labour Organization	Międzynarodowa Organizacja Pracy
International Monetary Fund	Międzynarodowy Fundusz Walutowy
International System of Units	Układ SI
International law	Kategoria:Prawo międzynarodowe
International organization	Organizacja międzynarodowa
Internet	Internet
Internet	Kategoria:Internet
Internet Explorer	Internet Explorer
Internment	Obóz koncentracyjny
Interpreter (computing)	Interpreter
Intersection (set theory)	Przekrój zbiorów
Interval (music)	Interwał
Intestine	Jelito
Intranet	Intranet
Invention	Wynalazek
Invertebrate	Bezkręgowce
Io (moon)	Io (księżyc)
Io (mythology)	Io (nimfa)
Iodine	Jod
Ion	Jon
Ionia	Jonia
Ionian Sea	Morze Jońskie
Ionic bond	Wiązanie jonowe
Ionosphere	Jonosfera
Iota	Jota (litera)
Iowa	Iowa
Iowa	Kategoria:Iowa
Iran	Iran
Iran	Kategoria:Iran
Iran-Iraq War	Wojna iracko-irańska
Iraq	Irak
Iraq	Kategoria:Irak
Ireland	Irlandia (wyspa)
Ireland	Kategoria:Irlandia
Irenaeus	Ireneusz z Lyonu
Iridium	Iryd
Iris (anatomy)	Tęczówka
Iris (mythology)	Iris (mitologia)
Irish Republican Army	Irlandzka Armia Republikańska
Irish Sea	Morze Irlandzkie
Irish people	Kategoria:Irlandczycy
Iron	Żelazo
Iron Age	Epoka żelaza
Iron Curtain	Żelazna kurtyna
Iron Maiden	Iron Maiden
Irony	Ironia
Irrational number	Liczby niewymierne
Irredentism	Irredenta
Irtysh River	Irtysz
Isaac	Izaak (postać biblijna)
Isaac Asimov	Isaac Asimov
Isaac Bashevis Singer	Isaac Bashevis Singer
Isaac Newton	Isaac Newton
Isadora Duncan	Isadora Duncan
Ishmael	Izmael (syn Abrahama)
Isis	Izyda
Islam	Islam
Islam	Kategoria:Islam
Islamabad	Islamabad
Islamic calendar	Kalendarz muzułmański
Island	Wyspa
Isle of Man	Wyspa Man
Isle of Man	Kategoria:Wyspa Man
Isle of Wight	Wight
Isomer	Izomeria
Isoroku Yamamoto	Isoroku Yamamoto
Isotope	Izotopy
Israel	Izrael
Israel	Kategoria:Izrael
Istanbul	Stambuł
Istanbul	Kategoria:Stambuł
Isthmus	Przesmyk
Isthmus of Panama	Przesmyk Panamski
Italian Peninsula	Półwysep Apeniński
Italo Calvino	Italo Calvino
Italy	Włochy
Italy	Kategoria:Włochy
Ithaca	Itaka
Ivan Lendl	Ivan Lendl
Ivan Pavlov	Iwan Pawłow
Ivan Turgenev	Iwan Turgieniew
Ivory	Kość słoniowa
Ivy League	Liga Bluszczowa
Iwo Jima	Iō-jima
J	J
J. D. Salinger	Jerome David Salinger
J. M. Barrie	James Matthew Barrie
Jack Kerouac	Jack Kerouac
Jack Lemmon	Jack Lemmon
Jack London	Jack London
Jack the Ripper	Kuba Rozpruwacz
Jackdaw	Kawka
Jackson	Jackson (Missisipi)
Jackson Pollock	Jackson Pollock
Jacksonville	Jacksonville (Floryda)
Jacob	Jakub (postać biblijna)
Jacques Cartier	Jacques Cartier
Jacques Derrida	Jacques Derrida
Jacques Offenbach	Jacques Offenbach
Jade	Żad
Jaguar	Jaguar
Jainism	Dżinizm
Jakarta	Dżakarta
Jalalabad	Dżalalabad (miasto w Afganistanie)
Jamaica	Jamajka
Jamaica	Kategoria:Jamajka
James	Jakub Większy Apostoł
James A. Garfield	James Garfield
James Bond	James Bond
James Buchanan	James Buchanan (prezydent USA)
James Clerk Maxwell	James Clerk Maxwell
James Cook	James Cook
James Franck	James Franck
James Joyce	James Joyce
James K. Polk	James Polk
James Madison	James Madison
James Monroe	James Monroe
James Naismith	James Naismith
James Prescott Joule	James Joule
James Watt	James Watt
Jammu and Kashmir	Dżammu i Kaszmir
Jan Hus	Jan Hus
Jan van Eyck	Jan van Eyck
Jane Austen	Jane Austen
Jane Fonda	Jane Fonda
Jane Seymour	Jane Seymour (królowa)
Janis Joplin	Janis Joplin
Janissary	Janczarzy
January	Styczeń
January 1	1 stycznia
January 19	19 stycznia
January 20	20 stycznia
January 6	6 stycznia
Janus (moon)	Janus (księżyc)
Janus (mythology)	Janus (mitologia)
Japan	Japonia
Japan	Kategoria:Japonia
Jason	Jazon (mitologia)
Jaundice	Żółtaczka (medycyna)
Java	Jawa
Java (disambiguation)	Java (ujednoznacznienie)
Java (programming language)	Java
Jawaharlal Nehru	Jawaharlal Nehru
Jazz	Jazz
Jazz	Kategoria:Jazz
Jean Auguste Dominique Ingres	Jean Ingres
Jean Cocteau	Jean Cocteau
Jean Piaget	Jean Piaget
Jean Racine	Jean Baptiste Racine
Jean Sibelius	Jean Sibelius
Jean de La Fontaine	Jean de La Fontaine
Jean-Jacques Rousseau	Jan Jakub Rousseau
Jean-Paul Sartre	Jean-Paul Sartre
Jean-Philippe Rameau	Jean-Philippe Rameau
Jeddah	Dżudda
Jefferson City	Jefferson City (Missouri)
Jefferson Davis	Jefferson Davis
Jehovah	JHWH
Jehovah's Witnesses	Świadkowie Jehowy
Jellyfish	Krążkopławy
Jena	Jena
Jeremy Bentham	Jeremy Bentham
Jerez de la Frontera	Jerez de la Frontera
Jericho	Jerycho
Jerome	Hieronim ze Strydonu
Jersey	Jersey
Jerusalem	Jerozolima
Jerusalem	Kategoria:Jerozolima
Jesus	Jezus Chrystus
Jet engine	Silnik odrzutowy
Jew	Żydzi
Jew's harp	Drumla
Jihad	Dżihad
Jimi Hendrix	Jimi Hendrix
Jimmy Carter	Jimmy Carter
Joan of Arc	Joanna d'Arc
Johann Bernoulli	Johann Bernoulli
Johann Sebastian Bach	Johann Sebastian Bach
Johann Wolfgang von Goethe	Johann Wolfgang von Goethe
Johannes Brahms	Johannes Brahms
Johannes Diderik van der Waals	Johannes Diderik van der Waals
Johannes Gutenberg	Johannes Gutenberg
Johannes Kepler	Jan Kepler
Johannes Vilhelm Jensen	Johannes Jensen
Johannesburg	Johannesburg
John Adams	John Adams
John Bardeen	John Bardeen
John Cage	John Cage
John Calvin	Jan Kalwin
John Chrysostom	Jan Chryzostom
John Dalton	John Dalton
John Dewey	John Dewey
John Galsworthy	John Galsworthy
John Herschel	John Herschel
John Keats	John Keats
John Lennon	John Lennon
John Locke	John Locke
John Major	John Major
John Maynard Keynes	John Maynard Keynes
John Milton	John Milton
John Napier	John Napier
John Quincy Adams	John Quincy Adams
John Ruskin	John Ruskin
John Steinbeck	John Steinbeck
John Stuart Mill	John Stuart Mill
John Tyler	John Tyler
John Wayne	John Wayne
John Wycliffe	John Wycliffe
John the Baptist	Jan Chrzciciel
John von Neumann	John von Neumann
Johnny Cash	Johnny Cash
Joint	Staw (anatomia)
Jonathan Swift	Jonathan Swift
Jordan	Jordania
Jordan	Kategoria:Jordania
Jordan River	Jordan (rzeka)
Jorge Luis Borges	Jorge Luis Borges
Joseph Conrad	Joseph Conrad
Joseph Goebbels	Joseph Goebbels
Joseph Haydn	Joseph Haydn
Joseph Louis Gay-Lussac	Joseph Louis Gay-Lussac
Joseph McCarthy	Joseph Raymond McCarthy
Joseph Priestley	Joseph Priestley
Joseph Pulitzer	Joseph Pulitzer
Joseph Schumpeter	Joseph Schumpeter
Joseph Smith	Joseph Smith
Joseph Stalin	Józef Stalin
Josephus	Józef Flawiusz
Joule	Dżul
Journalism	Kategoria:Dziennikarstwo
Journalism	Dziennikarstwo
Journalist	Dziennikarz
Jovian	Jowian
Joystick	Dżojstik
Judaism	Judaizm
Judaism	Kategoria:Judaizm
Judas Iscariot	Judasz Iskariota
Judea	Judea
Judo	Judo
Judy Garland	Judy Garland
Jujutsu	Jujutsu
Jules Verne	Juliusz Verne
Julian calendar	Kalendarz juliański
Julian the Apostate	Julian Apostata
Julius Caesar	Gajusz Juliusz Cezar
July	Lipiec
July 1	1 lipca
July 4	4 lipca
June	Czerwiec
June 14	14 czerwca
June 21	21 czerwca
June 23	23 czerwca
June 24	24 czerwca
June 29	29 czerwca
June 3	3 czerwca
Juneau	Juneau (Alaska)
Juniper	Jałowiec
Juno (mythology)	Junona
Jupiter	Jowisz
Jupiter	Kategoria:Jowisz
Jupiter (disambiguation)	Jowisz (ujednoznacznienie)
Jupiter (mythology)	Jowisz (mitologia)
Jurassic	Jura
Justinian I	Justynian I Wielki
Jutland	Półwysep Jutlandzki
K	K
K2	K2
KGB	KGB
Kaaba	Kaaba
Kabbalah	Kabała
Kabul	Kabul
Kalahari Desert	Kalahari
Kamchatka Peninsula	Kamczatka
Kamikaze	Kamikaze
Kampala	Kampala
Kandahar	Kandahar
Kangaroo	Kangurowate
Kansas	Kansas
Kansas	Kategoria:Kansas
Kansas City	Kansas City
Kappa	Kappa (litera)
Kara Sea	Morze Karskie
Karachi	Karaczi
Karakoram	Karakorum
Karaoke	Karaoke
Karate	Karate
Karen Blixen	Karen Blixen
Karl Barth	Karl Barth
Karl Jaspers	Karl Jaspers
Karl Marx	Karol Marks
Karl Popper	Karl Popper
Karma	Karma
Karnataka	Karnataka
Katharine Hepburn	Katharine Hepburn
Kathmandu	Katmandu
Katowice	Katowice
Kaunas	Kowno
Kayak	Kajak
Kazakhstan	Kazachstan
Kazakhstan	Kategoria:Kazachstan
Kazan	Kazań
Kazimir Malevich	Kazimierz Malewicz
Kelvin	Kelwin
Kent	Kent
Kentucky	Kentucky
Kentucky	Kategoria:Kentucky
Kenya	Kenia
Kenya	Kategoria:Kenia
Kernel (computer science)	Jądro systemu operacyjnego
Kerosene	Nafta
Ketchup	Keczup
Ketone	Ketony
Keyboard (computing)	Klawiatura
Keyboard instrument	Instrument klawiszowy
Khabarovsk	Chabarowsk
Khan	Chan (władca)
Kharkiv	Charków
Khartoum	Chartum
Khmer Rouge	Czerwoni Khmerzy
Khufu	Cheops
Kibbutz	Kibuc
Kidney	Nerka
Kiev	Kijów
Kigali	Kigali
Kilobyte	Kilobajt
Kilogram	Kilogram
Kilometre	Kilometr
Kilometres per hour	Kilometr na godzinę
Kimono	Kimono
Kindergarten	Przedszkole
Kinematics	Kinematyka
Kinetic energy	Energia kinetyczna
King (chess)	Król (szachy)
King Arthur	Król Artur
King Lear	Król Lear
Kingdom (biology)	Królestwo (biologia)
Kingston	Kingston (miasto na Jamajce)
Kingstown	Kingstown
Kinshasa	Kinszasa
Kiribati	Kiribati
Kiribati	Kategoria:Kiribati
Kirkuk	Kirkuk
Kiss	Pocałunek
Kite	Latawiec
Kiwi	Kiwi
Knee	Staw kolanowy
Knesset	Kneset
Knife	Nóż
Knight	Kawaler (tytuł szlachecki)
Knight (chess)	Skoczek
Knossos	Knossos
Knot (speed)	Węzeł (jednostka prędkości)
Knowledge	Wiedza
Knut Hamsun	Knut Hamsun
Koala	Koala
Kobe	Kobe
Kola Peninsula	Półwysep Kolski
Kolkata	Kalkuta
Komodo dragon	Waran z Komodo
Konqueror	Konqueror
Konrad Adenauer	Konrad Adenauer
Korea	Korea
Korea	Kategoria:Korea
Korean War	Wojna koreańska
Kosovo	Kosowo
Kosovo	Kategoria:Kosowo
Krakatoa	Krakatau
Kremlin	Kreml
Krishna	Kryszna
Krypton	Krypton (pierwiastek)
Ku Klux Klan	Ku Klux Klan
Kuala Lumpur	Kuala Lumpur
Kublai Khan	Kubilaj-chan
Kuiper belt	Pas Kuipera
Kumquat	Kumkwat
Kung fu (term)	Kung-fu
Kunlun Mountains	Kunlun
Kuomintang	Guomindang
Kura River	Kura (rzeka)
Kurdistan	Kurdystan
Kurdistan	Kategoria:Kurdystan
Kurdistan Workers Party	Partia Pracujących Kurdystanu
Kursk	Kursk
Kurt Vonnegut	Kurt Vonnegut
Kurt Waldheim	Kurt Waldheim
Kuwait	Kuwejt
Kuwait	Kategoria:Kuwejt
Kuwait City	Kuwejt (miasto)
KwaZulu-Natal	KwaZulu-Natal
Kyoto	Kioto
Kyrgyzstan	Kirgistan
Kyrgyzstan	Kategoria:Kirgistan
L	L
L'Aquila	L'Aquila
LAMP (software bundle)	LAMP
La Paz	La Paz (miasto w Boliwii)
La Plata	La Plata (miasto)
La Spezia	La Spezia
LaTeX	LaTeX
Laboratory	Laboratorium
Labour Party (UK)	Partia Pracy (brytyjska)
Labrador Retriever	Labrador Retriever
Lacerta	Jaszczurka (gwiazdozbiór)
Lactic acid	Kwas mlekowy
Lactose	Laktoza
Lady Jane Grey	Lady Jane Grey
Lagomorpha	Zajęczaki
Lagos	Lagos (Nigeria)
Lahore	Lahaur
Laissez-faire	Leseferyzm
Lake	Jezioro
Lake Baikal	Bajkał
Lake Balaton	Balaton
Lake Chad	Czad (jezioro)
Lake Constance	Jezioro Bodeńskie
Lake Erie	Erie (jezioro)
Lake Eyre	Eyre (jezioro)
Lake Geneva	Jezioro Genewskie
Lake Huron	Huron (jezioro)
Lake Ilmen	Ilmień
Lake Ladoga	Ładoga
Lake Malawi	Niasa (jezioro)
Lake Michigan	Michigan (jezioro)
Lake Onega	Onega (jezioro)
Lake Ontario	Ontario (jezioro)
Lake Superior	Jezioro Górne (Wielkie Jeziora Amerykańskie)
Lake Tanganyika	Tanganika (jezioro)
Lake Victoria	Jezioro Wiktorii
Lakshmi	Lakszmi
Lambda	Lambda
Lamiaceae	Jasnotowate
Lammergeier	Orłosęp brodaty
Lamprey	Minogi
Lancashire	Lancashire
Lancelet	Bezczaszkowce
Landfill	Składowisko odpadów
Language	Język (mowa)
Languedoc-Roussillon	Langwedocja-Roussillon
Lansing	Lansing (Michigan)
Lanthanide	Lantanowce
Lanthanum	Lantan
Laos	Laos
Laos	Kategoria:Laos
Laptev Sea	Morze Łaptiewów
Laptop	Laptop
Larch	Modrzew
Larva	Larwa
Larynx	Krtań
Las Vegas	Las Vegas
Lascaux	Lascaux (Akwitania)
Laser	Laser
Lathe	Tokarka
Latin	Łacina
Latin America	Ameryka Łacińska
Latin alphabet	Alfabet łaciński
Latitude	Szerokość geograficzna
Latvia	Łotwa
Latvia	Kategoria:Łotwa
Laughter	Śmiech
Laurasia	Laurazja
Lausanne	Lozanna
Lava	Lawa
Law	Prawo
Law	Kategoria:Prawo
Law enforcement	Kategoria:Policja
Lawrencium	Lorens
Lawyer	Adwokat
Lazio	Lacjum
Le Corbusier	Le Corbusier
Le Havre	Hawr
Lead	Ołów
Leaf	Liść
League of Nations	Liga Narodów
Leaning Tower of Pisa	Krzywa wieża w Pizie
Leap year	Rok przestępny
Learning	Uczenie się
Lebanon	Liban
Lebanon	Kategoria:Liban
Leda (mythology)	Leda
Lee Harvey Oswald	Lee Harvey Oswald
Leeds	Leeds
Left-handed	Leworęczność
Legend	Legenda
Legislature	Władza ustawodawcza
Lego	LEGO
Leicester	Leicester
Leiden	Lejda
Leipzig	Lipsk
Lemon	Cytryna zwyczajna
Lemon balm	Melisa lekarska
Lena River	Lena (rzeka)
Lens (optics)	Soczewka
Lent	Wielki Post
Lentil	Soczewica jadalna
Leo (constellation)	Lew (gwiazdozbiór)
Leo I (emperor)	Leon I (cesarz bizantyjski)
Leon Trotsky	Lew Trocki
Leonard Bernstein	Leonard Bernstein
Leonardo da Vinci	Leonardo da Vinci
Leonhard Euler	Leonhard Euler
Leonid Brezhnev	Leonid Breżniew
Leopard	Lampart
Lepidoptera	Motyle
Leprosy	Trąd
Lepton	Lepton (mechanika kwantowa)
Lepus (constellation)	Zając (gwiazdozbiór)
Lesbian	Lesbijka
Lesotho	Lesotho
Lesotho	Kategoria:Lesotho
Lesser Antilles	Małe Antyle
Leto	Leto
Letter (alphabet)	Litera
Leukemia	Białaczka
Levant	Lewant
Lever	Dźwignia
Leviathan	Lewiatan (potwór)
Leviticus	Księga Kapłańska
Lewis Carroll	Lewis Carroll
Lexicology	Leksykologia
Lhasa	Lhasa
Lhotse	Lhotse
Liberalism	Liberalizm
Liberalism	Kategoria:Liberalizm
Liberation Tigers of Tamil Eelam	Tamilskie Tygrysy
Liberia	Liberia
Liberia	Kategoria:Liberia
Libra (constellation)	Waga (gwiazdozbiór)
Library	Biblioteka
Library science	Bibliotekoznawstwo
Libretto	Libretto
Libreville	Libreville
Libya	Libia
Libya	Kategoria:Libia
Lichen	Porosty
Lie	Kłamstwo
Liechtenstein	Liechtenstein
Liechtenstein	Kategoria:Liechtenstein
Lieutenant	Podporucznik
Life	Życie
Light	Światło
Light-emitting diode	Dioda elektroluminescencyjna
Light-year	Rok świetlny
Lighter	Zapalniczka
Lighthouse	Latarnia morska
Lightning	Piorun
Liguria	Liguria
Ligurian Sea	Morze Liguryjskie
Liliaceae	Liliowate
Lilith	Lilith
Lille	Lille
Lilongwe	Lilongwe
Lima	Lima
Limerick	Limerick
Limestone	Wapień
Limit (mathematics)	Granica (matematyka)
Limnology	Limnologia
Limousin (region)	Limousin
Lincoln	Lincoln (Nebraska)
Lincoln	Lincoln
Lincolnshire	Lincolnshire
Line (mathematics)	Prosta
Linear algebra	Algebra liniowa
Linear algebra	Kategoria:Algebra liniowa
Linear equation	Równanie liniowe
Lingua franca	Lingua franca
Linguistics	Językoznawstwo
Linguistics	Kategoria:Językoznawstwo
Linus Pauling	Linus Pauling
Linux	Linux
Linux	Kategoria:Linux
Linz	Linz
Lion	Lew
Lipid	Lipidy
Liqueur	Likier
Liquid	Ciecz
Liquid crystal display	Wyświetlacz ciekłokrystaliczny
Liquorice	Lukrecja (roślina)
Lisbon	Lizbona
Lise Meitner	Lise Meitner
Lisp (programming language)	LISP
Literature	Literatura
Literature	Kategoria:Literatura
Literature	Portal:Literatura
Lithium	Lit (pierwiastek)
Lithography	Litografia
Lithosphere	Litosfera
Lithuania	Litwa
Lithuania	Kategoria:Litwa
Litre	Litr
Little Owl	Pójdźka
Liverpool	Liverpool
Livonia	Liwonia
Livy	Tytus Liwiusz
Lizard	Jaszczurki
Ljubljana	Lublana
Llama	Lama
Loanword	Zapożyczenia językowe
Local area network	Sieć lokalna
Loch Ness	Loch Ness
Loch Ness Monster	Potwór z Loch Ness
Locomotive	Lokomotywa
Logarithm	Logarytm
Logic	Logika
Logic	Kategoria:Logika
Logic gate	Bramka logiczna
Logistics	Logistyka
Logo	Logo (znak graficzny)
Loire	Loire
Loire River	Loara
Loki	Loki
Lolita	Lolita
Lombardy	Lombardia
London	Londyn
London	Kategoria:Londyn
Long Beach	Long Beach (Kalifornia)
Long Island	Long Island
Long jump	Skok w dal
Long-eared Owl	Sowa uszata
Lope de Vega	Lope de Vega
Lord's Prayer	Ojcze nasz
Lorraine (region)	Lotaryngia
Los Angeles	Los Angeles
Lot (department)	Lot (departament)
Loudspeaker	Głośnik
Louis Aragon	Louis Aragon
Louis Armstrong	Louis Armstrong
Louis Braille	Louis Braille
Louis Pasteur	Ludwik Pasteur
Louis the Pious	Ludwik I Pobożny
Louis the Stammerer	Ludwik II Jąkała
Louisiana	Luizjana
Louisiana	Kategoria:Luizjana
Louisville	Louisville (Kentucky)
Louvre	Luwr
Love	Miłość
Low German	Język dolnoniemiecki
Lower Saxony	Dolna Saksonia
Luanda	Luanda
Lublin	Lublin
Lucerne	Lucerna
Luciano Pavarotti	Luciano Pavarotti
Lucifer	Lucyfer
Lucretius	Lukrecjusz
Lucrezia Borgia	Lukrecja Borgia
Ludwig Boltzmann	Ludwig Boltzmann
Ludwig Mies van der Rohe	Ludwig Mies van der Rohe
Ludwig Wittgenstein	Ludwig Wittgenstein
Ludwig van Beethoven	Ludwig van Beethoven
Luftwaffe	Luftwaffe
Luigi Galvani	Luigi Galvani
Luigi Pirandello	Luigi Pirandello
Lumen (unit)	Lumen
Luminescence	Luminescencja
Lunar eclipse	Zaćmienie Księżyca
Lund	Lund (miasto)
Lung	Płuco
Lung cancer	Rak płuca
Lungfish	Dwudyszne
Lupus (constellation)	Wilk (gwiazdozbiór)
Lusaka	Lusaka
Lusitania	Luzytania
Lute	Lutnia
Lutetium	Lutet
Lutheranism	Luteranizm
Lux	Luks
Luxembourg	Luksemburg
Luxembourg	Kategoria:Luksemburg
Luxembourg (city)	Luksemburg (miasto)
Luxor	Luksor
Luzon	Luzon
Lychee	Liczi chińskie
Lydia	Lidia (kraina)
Lymphatic system	Układ limfatyczny
Lynx (constellation)	Ryś (gwiazdozbiór)
Lynx (web browser)	Lynx
Lyon	Lyon
Lyra	Lutnia (gwiazdozbiór)
Lysergic acid diethylamide	Dietyloamid kwasu lizergowego
Lysine	Lizyna
Lysosome	Lizosom
M	M
M-theory	M-teoria
MESSENGER	MESSENGER
MIME	Multipurpose Internet Mail Extensions
MS-DOS	MS-DOS
Macau	Makau
Macbeth	Makbet
Macedon	Starożytna Macedonia
Macedonia	Macedon (ujednoznacznienie)
Macedonia (Greece)	Macedonia (Grecja)
Mach number	Liczba Macha
Machine	Maszyna
Machine code	Język maszynowy
Machine gun	Karabin maszynowy
Machine translation	Tłumaczenie automatyczne
Machu Picchu	Machu Picchu
Macintosh	Macintosh
Macroeconomics	Makroekonomia
Macroeconomics	Kategoria:Makroekonomia
Madagascar	Madagaskar
Madagascar	Kategoria:Madagaskar
Madeira	Madera
Madison	Madison (Wisconsin)
Madonna (entertainer)	Madonna (piosenkarka)
Madrid	Madryt
Madrid (autonomous community)	Madryt (wspólnota autonomiczna)
Mafia	Mafia
Magazine	Czasopismo
Magenta	Magenta (barwa)
Maghreb	Maghreb
Magic (paranormal)	Magia
Magic square	Kwadrat magiczny (matematyka)
Maginot Line	Linia Maginota
Magma	Magma
Magna Carta	Magna Charta Libertatum
Magnesium	Magnez
Magnet	Magnes
Magnetic field	Pole magnetyczne
Magnetic resonance imaging	Obrazowanie rezonansu magnetycznego
Magnetism	Magnetyzm
Magnetism	Kategoria:Magnetyzm
Magnetite	Magnetyt
Magnifying glass	Lupa
Magnoliopsida	Kategoria:Magnoliopsida
Maharashtra	Maharashtra
Mahatma Gandhi	Mahatma Gandhi
Mahayana	Mahajana
Mail	Poczta
Maimonides	Mojżesz Majmonides
Main	Men
Main	Szablon:Main
Maine	Maine (stan w USA)
Maine	Kategoria:Maine
Mainframe computer	Mainframe
Maitreya	Budda Maitreja
Maize	Kukurydza zwyczajna
Major	Major
Major scale	Skala durowa
Majorca	Majorka
Makalu	Makalu
Malabo	Malabo
Malachite	Malachit
Malacostraca	Pancerzowce
Malaria	Malaria
Malawi	Kategoria:Malawi
Malay Peninsula	Półwysep Malajski
Malayan Tapir	Tapir malajski
Malaysia	Malezja
Malaysia	Kategoria:Malezja
Malcolm X	Malcolm X
Maldives	Malediwy
Maldives	Kategoria:Malediwy
Mali	Mali
Mali	Kategoria:Mali
Mallard	Kaczka krzyżówka
Malta	Malta
Malta	Kategoria:Malta
Maltese language	Język maltański
Maltose	Maltoza
Malvaceae	Ślazowate
Mammal	Ssaki
Mammoth	Mamut
Management	Zarządzanie
Managua	Managua (miasto)
Manama	Manama
Manatee	Manatowate
Manchester	Manchester
Manchuria	Mandżuria
Mandala	Mandala
Mandarin (linguistics)	Języki mandaryńskie
Mandarin orange	Mandarynka (roślina)
Mandelbrot set	Zbiór Mandelbrota
Manganese	Mangan
Mango	Mango
Mangrove	Namorzyny
Manhattan	Manhattan
Manhattan Project	Projekt Manhattan
Manichaeism	Manicheizm
Manila	Manila
Manipur	Manipur
Manitoba	Manitoba
Mannerism	Manieryzm (sztuka)
Mannheim	Mannheim
Mantle (geology)	Płaszcz ziemski
Mantra	Mantra
Mantua	Mantua
Manuel de Falla	Manuel de Falla
Manuscript	Rękopis
Mao Zedong	Mao Zedong
Maoism	Maoizm
Map	Mapa
Maple	Klon (roślina)
Maputo	Maputo (miasto)
Marathon	Bieg maratoński
Marble	Marmur
Marc Chagall	Marc Chagall
Marcel Duchamp	Marcel Duchamp
Marcel Marceau	Marcel Marceau
Marcel Proust	Marcel Proust
March	Marzec
March 17	17 marca
March 19	19 marca
March 2	2 marca
March 25	25 marca
Marche	Marche
Marco Polo	Marco Polo
Marcus Aurelius	Marek Aureliusz
Marcus Junius Brutus	Marek Juniusz Brutus
Marcus Vipsanius Agrippa	Marek Agrypa
Marduk	Marduk
Margaret Mead	Margaret Mead
Margaret Mitchell	Margaret Mitchell
Margaret Thatcher	Margaret Thatcher
Maria Callas	Maria Callas
Mariana Islands	Mariany
Marie Antoinette	Maria Antonina Austriaczka
Marie Curie	Maria Skłodowska-Curie
Mariehamn	Maarianhamina
Marilyn Monroe	Marilyn Monroe
Mario Vargas Llosa	Mario Vargas Llosa
Mark Antony	Marek Antoniusz
Mark Twain	Mark Twain
Market	Rynek (ekonomia)
Marketing	Marketing
Marketing	Kategoria:Marketing
Markup language	Język znaczników
Marlene Dietrich	Marlene Dietrich
Marquis de Sade	Donatien Alphonse François de Sade
Marrakech	Marrakesz
Marriage	Małżeństwo
Mars	Kategoria:Mars
Mars (disambiguation)	Mars (ujednoznacznienie)
Mars (mythology)	Mars (mitologia)
Marseille	Marsylia
Marshall Islands	Wyspy Marshalla
Marshall Islands	Kategoria:Wyspy Marshalla
Marshall Plan	Plan Marshalla
Marsupial	Torbacze
Martin Buber	Martin Buber
Martin Heidegger	Martin Heidegger
Martin Luther	Marcin Luter
Martin Luther King	Martin Luther King
Martin Scorsese	Martin Scorsese
Martin Van Buren	Martin Van Buren
Martina Navratilova	Martina Navrátilová
Martinique	Martynika
Martyr	Martyrologia
Marx Brothers	Bracia Marx
Marxism	Marksizm
Marxism	Kategoria:Marksizm
Mary (mother of Jesus)	Maria z Nazaretu
Mary Magdalene	Maria Magdalena
Mary Shelley	Mary Shelley
Mary Wollstonecraft	Mary Wollstonecraft
Maryland	Maryland
Maryland	Kategoria:Maryland
Maseru	Maseru
Mashhad	Meszhed
Mass	Masa (fizyka)
Mass (liturgy)	Msza
Mass number	Liczba masowa
Massachusetts	Massachusetts
Massachusetts	Kategoria:Massachusetts
Massachusetts Institute of Technology	Massachusetts Institute of Technology
Masturbation	Masturbacja
Mata Hari	Mata Hari
Match	Zapałka
Materialism	Materializm
Mathematical logic	Logika matematyczna
Mathematical logic	Kategoria:Logika matematyczna
Mathematical proof	Dowód (matematyka)
Mathematics	Matematyka
Mathematics	Kategoria:Matematyka
Mathematics	Portal:Matematyka
Matrix (mathematics)	Macierz
Matter	Materia (fizyka)
Matterhorn	Matterhorn
Mauna Kea	Mauna Kea
Mauna Loa	Mauna Loa
Maundy Thursday	Wielki Czwartek
Maurice Ravel	Maurice Ravel
Mauritania	Mauretania
Mauritania	Kategoria:Mauretania
Mauritius	Mauritius
Mauritius	Kategoria:Mauritius
Max Born	Max Born
Max Bruch	Max Bruch
Max Ernst	Max Ernst
Max Planck	Max Planck
Max Weber	Max Weber
Maximian	Maksymian
Maxwell's equations	Równania Maxwella
May	Maj
May 1	1 maja
May 24	24 maja
Mayenne	Mayenne (departament)
Mayfly	Jętki (owady)
Mayonnaise	Sos majonezowy
Mayor	Burmistrz
Mbabane	Mbabane
McCarthyism	Maccartyzm
Mead	Miód pitny
Measles	Odra (choroba)
Measure (mathematics)	Miara (matematyka)
Measurement	Kategoria:Metrologia
Measurement	Pomiar
Meat	Mięso
Mecca	Mekka
Mechanical engineering	Inżynieria mechaniczna
Mechanics	Kategoria:Mechanika
Mechanics	Mechanika
Medea	Medea
Median	Mediana
Medication	Farmakoterapia
Medici	Medyceusze
Medicine	Medycyna
Medicine	Kategoria:Medycyna
Medina	Medyna
Meditation	Medytacja
Mediterranean	Kategoria:Morze Śródziemne
Mediterranean Sea	Morze Śródziemne
Medusa	Meduza (mitologia)
Meerkat	Surykatka
Megabyte	Megabajt
Meiosis	Mejoza
Meister Eckhart	Johannes Eckhart
Meitnerium	Meitner
Mekong	Mekong
Mel Gibson	Mel Gibson
Melanesia	Melanezja
Melody	Melodia
Melpomene	Melpomene
Melting	Topnienie
Melting point	Temperatura topnienia
Meme	Mem
Memory	Pamięć człowieka
Memphis	Memphis
Memphis	Memfis
Menachem Begin	Menachem Begin
Mendelevium	Mendelew
Menelaus	Menelaos
Meningitis	Zapalenie opon mózgowo-rdzeniowych
Mensa (constellation)	Góra Stołowa (gwiazdozbiór)
Menstrual cycle	Cykl miesiączkowy
Menstruation	Menstruacja
Mental disorder	Zaburzenie psychiczne
Mentha	Mięta
Mercantilism	Merkantylizm
Mercenary	Wojsko najemne
Mercury	Merkury (ujednoznacznienie)
Mercury (element)	Rtęć
Mercury (mythology)	Merkury (bóg)
Mercury (planet)	Merkury
Meridian (geography)	Południk
Meritocracy	Merytokracja
Mermaid	Syrena (mitologia)
Merovingian	Merowingowie
Meryl Streep	Meryl Streep
Mescaline	Meskalina
Mesolithic	Mezolit
Meson	Mezony
Mesopotamia	Mezopotamia
Mesopotamia	Kategoria:Mezopotamia
Mesosphere	Mezosfera (warstwa atmosfery)
Mesozoic	Era mezozoiczna
Messenger RNA	MRNA
Messiah	Pomazaniec
Messina	Mesyna
Metabolism	Metabolizm
Metadata	Metadane
Metal	Metale
Metallic bond	Wiązanie metaliczne
Metalloid	Półmetale
Metallurgy	Metalurgia
Metallurgy	Kategoria:Metalurgia
Metamorphic rock	Skały metamorficzne
Metaphor	Metafora
Metaphysics	Metafizyka klasyczna
Metastasis	Przerzuty nowotworowe
Meteor shower	Rój meteorów
Meteorite	Meteoryt
Meteoroid	Meteoroid
Meteorology	Kategoria:Meteorologia i fizyka atmosfery
Meteorology	Meteorologia
Methadone	Metadon
Methamphetamine	Metamfetamina
Methanol	Alkohol metylowy
Methionine	Metionina
Methodism	Metodyzm
Methylenedioxymethamphetamine	3,4-metylenodioksymetamfetamina
Metis (moon)	Metis (księżyc)
Metonymy	Metonimia
Metre	Metr
Metric space	Przestrzeń metryczna
Meuse	Meuse
Meuse River	Moza
Mexico	Meksyk
Mexico	Kategoria:Meksyk
Mexico City	Meksyk (miasto)
Miami	Miami
Mica	Miki
Michael (archangel)	Michał Archanioł
Michael Faraday	Michael Faraday
Michel Ney	Michel Ney
Michelangelo	Michał Anioł
Michigan	Michigan
Michigan	Kategoria:Michigan
Mick Jagger	Mick Jagger
Mickey Mouse	Myszka Miki
Microbiology	Mikrobiologia
Microbiology	Kategoria:Mikrobiologia
Microeconomics	Mikroekonomia
Microeconomics	Kategoria:Mikroekonomia
Micronesia	Mikronezja (wyspy)
Microorganism	Mikroorganizm
Microphone	Mikrofon
Microprocessor	Mikroprocesor
Microscope	Mikroskop
Microscopium	Mikroskop (gwiazdozbiór)
Microwave	Mikrofale
Microwave oven	Kuchenka mikrofalowa
Middle Ages	Średniowiecze
Middle Ages	Kategoria:Średniowiecze
Middle East	Bliski Wschód
Midnight sun	Dzień polarny
Migraine	Migrena
Miguel de Cervantes	Miguel de Cervantes
Mike Tyson	Mike Tyson
Mikhail Bakunin	Michał Bakunin
Mikhail Glinka	Michał Glinka
Mikhail Gorbachev	Michaił Gorbaczow
Milan	Mediolan
Mile	Mila
Miles Davis	Miles Davis
Military	Kategoria:Wojsko
Military rank	Stopień wojskowy
Milk	Mleko
Milky Way	Droga Mleczna
Millard Fillmore	Millard Fillmore
Millennium	Tysiąclecie
Millimetre	Milimetr
Million	Milion
Millipede	Dwuparce
Milton Friedman	Milton Friedman
Milwaukee	Milwaukee (Wisconsin)
Minaret	Minaret
Mindanao	Mindanao
Mineral	Minerał
Mineral water	Woda mineralna
Mineralogy	Mineralogia
Mineralogy	Kategoria:Mineralogia
Minerva	Minerwa
Ming Dynasty	Dynastia Ming
Minimalism	Minimalizm (sztuka)
Mining	Górnictwo
Minister (government)	Minister (urząd)
Minneapolis	Minneapolis (Minnesota)
Minnesota	Minnesota
Minnesota	Kategoria:Minnesota
Minoan civilization	Kultura minojska
Minor scale	Skala molowa
Minos	Minos
Minotaur	Minotaur (mitologia)
Minsk	Mińsk
Minute	Minuta
Miocene	Miocen
Miracle	Cud
Mirror	Lustro
Mishnah	Miszna
Mississippi	Kategoria:Missisipi
Mississippi River	Missisipi (rzeka)
Missouri	Missouri (stan w USA)
Missouri	Kategoria:Missouri
Missouri River	Missouri (rzeka)
Mitochondrion	Mitochondrium
Mnemosyne	Mnemosyne
Mobile phone	Telefon komórkowy
Modem	Modem
Modernism	Modernizm (sztuka)
Modest Mussorgsky	Modest Musorgski
Modulation	Modulacja
Mogadishu	Mogadiszu
Moirae	Mojry
Mold	Pleśń
Moldova	Mołdawia
Moldova	Kategoria:Mołdawia
Mole (unit)	Mol
Molecular biology	Biologia molekularna
Molecular biology	Kategoria:Biologia molekularna
Molecule	Cząsteczka
Molise	Molise
Mollusca	Mięczaki
Molotov cocktail	Butelka zapalająca
Molybdenum	Molibden
Mombasa	Mombasa
Momentum	Pęd (fizyka)
Monaco	Monako
Monaco	Kategoria:Monako
Monarch	Monarcha
Monarchy	Monarchia
Monastery	Klasztor
Monday	Poniedziałek
Money	Pieniądz
Mongolia	Mongolia
Mongolia	Kategoria:Mongolia
Mongoose	Mangustowate
Monica Seles	Monica Seles
Monism	Monizm
Monocotyledon	Jednoliścienne
Monomer	Monomery
Monopoly	Monopol
Monopoly (game)	Monopoly
Monosaccharide	Cukry proste
Monosodium glutamate	Glutaminian sodu
Monotheism	Monoteizm
Monotreme	Stekowce
Monroe Doctrine	Doktryna Monroe'a
Monrovia	Monrovia
Mons	Mons
Monsoon	Monsun
Mont Blanc	Mont Blanc
Montana	Montana
Montana	Kategoria:Montana
Monte Carlo	Monte Carlo
Montenegro	Czarnogóra
Montenegro	Kategoria:Czarnogóra
Monterrey	Monterrey
Montevideo	Montevideo
Montgomery	Montgomery (Alabama)
Month	Miesiąc
Montpelier	Montpelier (Vermont)
Montreal	Montreal
Montserrat	Montserrat (wyspa)
Moon	Księżyc
Moose	Łoś
Morality	Moralność
Moravia	Morawy
Morocco	Maroko
Morocco	Kategoria:Maroko
Morpheme	Morfem
Morphine	Morfina
Morphology	Morfologia
Morphology (linguistics)	Morfologia (językoznawstwo)
Morse code	Alfabet Morse'a
Mortar (weapon)	Moździerz
Mosaic	Mozaika
Moscow	Moskwa
Moscow	Kategoria:Moskwa
Moselle	Moselle
Moses	Mojżesz
Moshe Dayan	Mosze Dajan
Mosque	Meczet
Mosquito	Komarowate
Moss	Mchy
Mossad	Mossad
Mosul	Mosul
Motet	Motet
Mother	Matka
Mother Teresa	Matka Teresa z Kalkuty
Mother's Day	Dzień Matki
Motion (physics)	Ruch (fizyka)
Motorcycle	Motocykl
Motto	Motto
Mount Ararat	Ararat
Mount Athos	Athos
Mount Etna	Etna
Mount Everest	Mount Everest
Mount Fuji	Fudżi
Mount Kilimanjaro	Kilimandżaro
Mount McKinley	McKinley
Mount Olympus	Olimp
Mount Pinatubo	Pinatubo
Mount Rushmore	Mount Rushmore
Mount St. Helens	Mount St. Helens
Mount Vesuvius	Wezuwiusz
Mountain	Góra
Mountain bike	Rower górski
Mountain pass	Przełęcz
Mountain range	Łańcuch górski
Mouse	Mysz
Mouse (computing)	Mysz komputerowa
Mozambique	Mozambik
Mozambique	Kategoria:Mozambik
Mu (letter)	My (litera)
Muezzin	Muezin
Muhammad	Mahomet
Muhammad Ali	Muhammad Ali (bokser)
Mulberry	Morwa
Mule	Muł (ssak)
Multimedia	Multimedia
Multiple sclerosis	Stwardnienie rozsiane
Multiplication	Mnożenie
Mumbai	Bombaj
Mummy	Mumia
Munich	Monachium
Municipality	Gmina (ujednoznacznienie)
Muon	Mion
Murmansk	Murmańsk
Murphy's law	Prawa Murphy'ego
Murray Gell-Mann	Murray Gell-Mann
Musa (genus)	Banan
Musca	Mucha (gwiazdozbiór)
Muscat	Maskat
Muscle	Mięsień
Muse	Muza
Museum	Muzeum
Mushroom	Owocnik
Music	Muzyka
Music	Kategoria:Muzyka
Musical Instrument Digital Interface	MIDI
Musical instrument	Instrument muzyczny
Musical scale	Skala (muzyka)
Musician	Muzyk
Musicology	Muzykologia
Musket	Muszkiet
Mustelidae	Łasicowate
Mutation	Mutacja
Mute Swan	Łabędź niemy
Myanmar	Kategoria:Birma
Mycenae	Mykeny
Mycology	Mikologia
Mycology	Kategoria:Mikologia
Myocardial infarction	Zawał mięśnia sercowego
Myopia	Krótkowzroczność
Myriapoda	Wije
Mysticism	Mistycyzm
Myth	Mit
Mythology	Mitologia
Mythology	Kategoria:Mitologia
N	N
N'Djamena	Ndżamena
NASDAQ	NASDAQ
NATO	NATO
NATO	Kategoria:NATO
Nadine Gordimer	Nadine Gordimer
Nadir	Nadir (astronomia)
Nagasaki	Nagasaki
Nagoya	Nagoja
Nahuatl	Język nahuatl
Nail (anatomy)	Paznokieć
Nail (fastener)	Gwóźdź
Nairobi	Nairobi
Namib Desert	Namib
Namibia	Namibia
Namibia	Kategoria:Namibia
Namur (city)	Namur (miasto)
Nancy	Nancy
Nanga Parbat	Nanga Parbat
Nanjing	Nankin
Nanotechnology	Nanotechnologia
Nantes	Nantes
Napalm	Napalm
Naples	Neapol
Napoleonic Wars	Wojny napoleońskie
Narcissus (mythology)	Narcyz (mitologia grecka)
Nashville	Nashville (Tennessee)
Nassau	Nassau (Bahamy)
Nathaniel Hawthorne	Nathaniel Hawthorne
Nation	Naród
National Security Agency	National Security Agency
National anthem	Hymn państwowy
National park	Park narodowy
Nationalism	Nacjonalizm
Nationalism	Kategoria:Nacjonalizm
Natural gas	Gaz ziemny
Natural language processing	Analiza języka naturalnego
Natural number	Liczby naturalne
Natural science	Nauki przyrodnicze
Natural selection	Dobór naturalny
Nature	Natura
Naturism	Naturyzm
Nauru	Nauru
Nauru	Kategoria:Nauru
Nautical mile	Mila morska
Navigation	Kategoria:Nawigacja
Navigation	Nawigacja
Navy	Marynarka wojenna
Nazareth	Nazaret
Nazi Germany	III Rzesza
Nazi Germany	Kategoria:III Rzesza
Nazi Party	Narodowosocjalistyczna Niemiecka Partia Robotników
Nazism	Kategoria:Nazizm
Neanderthal	Neandertalczyk
Nebraska	Nebraska
Nebraska	Kategoria:Nebraska
Nebuchadrezzar II	Nabuchodonozor II
Nebula	Mgławica
Neckar	Neckar
Necktie	Krawat
Nefertiti	Nefertiti
Negev	Pustynia Negew
Neil Armstrong	Neil Armstrong
Nelson Mandela	Nelson Mandela
Nematode	Nicienie
Nemean Lion	Lew nemejski
Nemesis (mythology)	Nemezis
Neodymium	Neodym
Neolithic	Neolit
Neologism	Neologizm
Neon	Neon (pierwiastek)
Neoplatonism	Neoplatonizm
Nepal	Nepal
Nepal	Kategoria:Nepal
Nephthys	Neftyda
Neptune	Neptun
Neptunium	Neptun (pierwiastek)
Nereid (moon)	Nereida (księżyc)
Nero	Neron
Nerva	Nerwa
Nervous system	Układ nerwowy człowieka
Nervous system	Kategoria:Układ nerwowy człowieka
Nest	Gniazdo (etologia)
Nestorianism	Nestorianizm
Netherlands	Holandia
Netherlands	Kategoria:Holandia
Netherlands Antilles	Antyle Holenderskie
Network topology	Topologia sieci komputerowej
Neurology	Neurologia
Neurology	Kategoria:Neurologia
Neuron	Neuron
Neurotransmitter	Neuroprzekaźnik
Neutrino	Neutrino
Neutron	Neutron
Neutron star	Gwiazda neutronowa
Neva River	Newa
Nevada	Nevada
Nevada	Kategoria:Nevada
Neville Chamberlain	Neville Chamberlain
New Brunswick	Nowy Brunszwik
New Caledonia	Nowa Kaledonia
New Delhi	Nowe Delhi
New England	Nowa Anglia
New Guinea	Nowa Gwinea
New Hampshire	New Hampshire
New Hampshire	Kategoria:New Hampshire
New Jersey	New Jersey
New Jersey	Kategoria:New Jersey
New Mexico	Nowy Meksyk
New Mexico	Kategoria:Nowy Meksyk
New Orleans	Nowy Orlean
New South Wales	Nowa Południowa Walia
New Testament	Nowy Testament
New World	Nowy Świat (geografia)
New Year	Nowy Rok
New York	Nowy Jork (stan)
New York	Kategoria:Nowy Jork (stan)
New York (disambiguation)	Nowy Jork (ujednoznacznienie)
New York City	Nowy Jork
New York City	Kategoria:Nowy Jork
New York Stock Exchange	New York Stock Exchange
New Zealand	Nowa Zelandia
New Zealand	Kategoria:Nowa Zelandia
Newark	Newark (New Jersey)
Newfoundland (island)	Nowa Fundlandia
Newfoundland and Labrador	Nowa Fundlandia i Labrador
Newport	Newport (Walia)
Newton	Niuton
Niacin	Witamina PP
Niagara Falls	Wodospad Niagara
Niamey	Niamey
Nicaragua	Nikaragua
Nicaragua	Kategoria:Nikaragua
Nice	Nicea
Nicene Creed	Nicejsko-konstantynopolitańskie wyznanie wiary
Nicholas	Dynastia Petrović Njegoš
Nickel	Nikiel
Nicolas Poussin	Nicolas Poussin
Nicolaus Copernicus	Mikołaj Kopernik
Nicosia	Nikozja
Nicotine	Nikotyna
Niels Bohr	Niels Bohr
Niels Henrik Abel	Niels Henrik Abel
Niger	Niger
Niger	Kategoria:Niger
Niger River	Niger (rzeka)
Nigeria	Nigeria
Nigeria	Kategoria:Nigeria
Nightingale	Słowik rdzawy
Nihilism	Nihilizm
Nijmegen	Nijmegen
Nike	Nike (firma)
Nike (mythology)	Nike (mitologia)
Nikita Khrushchev	Nikita Chruszczow
Nikola Tesla	Nikola Tesla
Nile	Nil
Nile crocodile	Krokodyl nilowy
Nineveh	Niniwa
Ninja	Ninja
Niobium	Niob
Nirvana	Nirwana
Nitric acid	Kwas azotowy(V)
Nitrogen	Azot
Nitroglycerin	Nitrogliceryna
Nix (moon)	Nix (księżyc)
Njord	Njörðr
Noah	Noe
Noam Chomsky	Noam Chomsky
Nobel Prize	Nagroda Nobla
Nobel Prize	Kategoria:Nagroda Nobla
Nobelium	Nobel (pierwiastek)
Nobility	Szlachta
Nobility	Kategoria:Szlachta
Noble gas	Gazy szlachetne
Nomad	Nomada
Nominative case	Mianownik (przypadek)
Nonmetal	Niemetale
Norfolk	Norfolk (Anglia)
Norfolk Island	Norfolk (terytorium)
Norma (constellation)	Węgielnica (gwiazdozbiór)
Normal distribution	Rozkład normalny
Norman Mailer	Norman Mailer
Normandy	Normandia
Norn	Norny
Norse mythology	Mitologia nordycka
Norse mythology	Kategoria:Mitologia nordycka
North	Północ
North Africa	Afryka Północna
North America	Ameryka Północna
North America	Kategoria:Ameryka Północna
North Carolina	Karolina Północna
North Carolina	Kategoria:Karolina Północna
North Dakota	Dakota Północna
North Dakota	Kategoria:Dakota Północna
North Island	Wyspa Północna (Nowa Zelandia)
North Korea	Korea Północna
North Korea	Kategoria:Korea Północna
North Pole	Biegun północny
North Sea	Morze Północne
North Star	Gwiazda Polarna
North Yorkshire	North Yorkshire
Northern Europe	Europa Północna
Northern Hemisphere	Półkula północna
Northern Ireland	Irlandia Północna
Northern Ireland	Kategoria:Irlandia Północna
Northern Mariana Islands	Mariany Północne
Northern Territory	Terytorium Północne
Northern pike	Szczupak pospolity
Northwest Territories	Terytoria Północno-Zachodnie
Norway	Norwegia
Norway	Kategoria:Norwegia
Norwegian Sea	Morze Norweskie
Norwegian krone	Korona norweska
Nose	Nos
Nostradamus	Nostradamus
Note	Nuta
Nouakchott	Nawakszut
Noun	Rzeczownik
Nova Scotia	Nowa Szkocja
Novaya Zemlya	Nowa Ziemia
Novel	Powieść
November	Listopad
November 1	1 listopada
November 11	11 listopada
November 2	2 listopada
November 5	5 listopada
Novial	Novial
Novosibirsk	Nowosybirsk
Nu (letter)	Ny (litera)
Nuclear fission	Rozszczepienie jądra atomowego
Nuclear fusion	Reakcja termojądrowa
Nuclear physics	Fizyka jądrowa
Nuclear physics	Kategoria:Fizyka jądrowa
Nuclear power	Energia jądrowa
Nuclear weapon	Broń jądrowa
Nucleic acid	Kwasy nukleinowe
Nucleon	Nukleony
Nucleotide	Nukleotydy
Number	Liczba
Numbers	Kategoria:Liczby
Numidia	Numidia
Numismatics	Numizmatyka
Numismatics	Kategoria:Numizmatyka
Nunavut	Nunavut
Nuremberg	Norymberga
Nut (fruit)	Orzech (botanika)
Nutmeg	Muszkatołowiec korzenny
Nutrition	Kategoria:Odżywianie
Nymph	Nimfa (mitologia)
Nymphaeaceae	Grzybieniowate
Nyx (mythology)	Nyks
O	O
OPEC	OPEC
Oahu	Oahu
Oak	Dąb
Oakland	Oakland (Kalifornia)
Oasis	Oaza (geografia)
Oat	Owies
Oaxaca	Oaxaca
Ob River	Ob
Obelisk	Obelisk
Obesity	Otyłość
Object-oriented programming	Programowanie obiektowe
Oboe	Obój
Observatory	Obserwatorium astronomiczne
Obsidian	Obsydian
Occam's razor	Brzytwa Ockhama
Ocean	Ocean
Ocean current	Prąd morski
Oceania	Oceania
Oceania	Kategoria:Australia i Oceania
Oceanid	Okeanidy
Oceanography	Oceanografia
Oceanography	Kategoria:Oceanografia
Oceanus	Okeanos
Octal	Ósemkowy system liczbowy
Octans	Oktant (gwiazdozbiór)
Octave	Oktawa (interwał)
October	Październik
October 12	12 października
October 24	24 października
October Revolution	Rewolucja październikowa
Octopus	Ośmiornice
Ode	Oda (literatura)
Oder River	Odra
Odessa	Odessa
Odin	Odyn
Odonata	Ważki
Odysseus	Odyseusz
Odyssey	Odyseja
Oedipus	Edyp
Offside (football)	Spalony (piłka nożna)
Ohio	Ohio
Ohio	Kategoria:Ohio
Ohm	Om (jednostka)
Ohm's law	Prawo Ohma
Oil	Olej
Oil (disambiguation)	Olej
Oil painting	Malarstwo olejne
Okapi	Okapi
Oklahoma	Oklahoma
Oklahoma	Kategoria:Oklahoma
Oklahoma City	Oklahoma City
Oktoberfest	Oktoberfest
Old Church Slavonic	Język staro-cerkiewno-słowiański
Old Norse	Język staronordyjski
Old Testament	Stary Testament
Oligarchy	Oligarchia
Oligocene	Oligocen
Oligopoly	Oligopol
Olive	Oliwka europejska
Olive oil	Oliwa z oliwek
Oliver Cromwell	Oliver Cromwell
Oliver Stone	Oliver Stone
Olivine	Oliwiny
Olympia	Olympia (Waszyngton)
Olympia	Olimpia (miasto)
Olympic Games	Igrzyska olimpijskie
Olympics	Kategoria:Igrzyska olimpijskie
Omaha	Omaha (Nebraska)
Oman	Oman
Oman	Kategoria:Oman
Omega	Omega
Omicron	Omikron
Omsk	Omsk
Oncology	Kategoria:Onkologia
Onion	Cebula zwyczajna
Onomastics	Onomastyka
Ontario	Ontario (prowincja Kanady)
Ontario	Kategoria:Ontario
Ontology	Ontologia
Oort cloud	Obłok Oorta
Opal	Opal (minerał)
Opel	Adam Opel AG
Opera	Opera (dzieło)
Opera (Internet suite)	Opera (program)
Operating system	System operacyjny
Operetta	Operetka
Ophiuchus	Wężownik (gwiazdozbiór)
Opium	Opium
Optical fiber	Światłowód
Optical illusion	Złudzenie optyczne
Optics	Optyka
Optics	Kategoria:Optyka
Optimization (mathematics)	Optymalizacja (matematyka)
Oral sex	Seks oralny
Orange (colour)	Barwa pomarańczowa
Orange (fruit)	Pomarańcza
Orangutan	Orangutan
Oratorio	Oratorium
Orbit	Orbita
Orca	Orka
Orchestra	Orkiestra
Orchidaceae	Storczykowate
Order (biology)	Rząd (biologia)
Order of Saint Benedict	Benedyktyni
Ordovician	Ordowik
Oregano	Lebiodka pospolita
Oregon	Oregon
Oregon	Kategoria:Oregon
Orestes (mythology)	Orestes (mitologia)
Organ (anatomy)	Narząd
Organ (music)	Organy
Organelle	Organellum
Organic chemistry	Chemia organiczna
Organic chemistry	Kategoria:Chemia organiczna
Organic compound	Związki organiczne
Organism	Organizm
Organization	Organizacja
Organization of American States	Organizacja Państw Amerykańskich
Orgasm	Orgazm
Origami	Origami
Origen	Orygenes
Original sin	Grzech pierworodny
Orinoco	Orinoko
Orion (constellation)	Orion (gwiazdozbiór)
Orissa	Orisa
Orlando	Orlando (Floryda)
Ornithology	Ornitologia
Ornithology	Kategoria:Ornitologia
Orpheus	Orfeusz
Orson Welles	Orson Welles
Orthography	Ortografia
Osaka	Osaka
Osama bin Laden	Usama ibn Ladin
Oscar Wilde	Oscar Wilde
Oscillation	Drgania
Osiris	Ozyrys (bóg)
Oslo	Oslo
Osman I	Osman I
Osmium	Osm
Osprey	Rybołów
Osteichthyes	Ryby kostnoszkieletowe
Osteoporosis	Osteoporoza
Ostrava	Ostrawa
Ostrich	Struś
Othello	Otello
Otho	Marek Salwiusz Oton
Ottawa	Ottawa
Otto Hahn	Otto Hahn
Otto I	Otton I Wielki
Otto von Bismarck	Otto von Bismarck
Ottoman Empire	Imperium osmańskie
Ounce	Uncja
Ovary	Jajniki
Ovid	Owidiusz
Oviedo	Oviedo
Ovis	Ovis
Ovum	Komórka jajowa
Owl	Sowy
Oxford	Oksford
Oxidation state	Stopień utlenienia
Oxide	Tlenki
Oxygen	Tlen
Oxymoron	Oksymoron
Oxytocin	Oksytocyna
Ozone	Ozon (chemia)
Ozone layer	Ozonosfera
P	P
PAL	PAL
PH	Skala pH
Pablo Neruda	Pablo Neruda
Pablo Picasso	Pablo Picasso
Pacific Ocean	Ocean Spokojny
Pacific Ocean	Kategoria:Ocean Spokojny
Pacifism	Pacyfizm
Padua	Padwa
Paganism	Pogaństwo
Painting	Kategoria:Malarstwo
Pakistan	Pakistan
Pakistan	Kategoria:Pakistan
Palace of Versailles	Pałac wersalski
Palau	Palau
Palau	Kategoria:Palau
Paleocene	Paleocen
Paleolithic	Paleolit
Paleontology	Paleontologia
Paleontology	Kategoria:Paleontologia
Paleozoic	Paleozoik
Palermo	Palermo
Palestine	Palestyna
Palestine	Kategoria:Autonomia Palestyńska
Palestine Liberation Organization	Organizacja Wyzwolenia Palestyny
Palestinian National Authority	Autonomia Palestyńska
Pali	Język pali
Palindrome	Palindrom
Palladium	Pallad
Palm Sunday	Niedziela Palmowa
Palmyra	Palmyra (miasto)
Pamir Mountains	Pamir
Pan (mythology)	Pan (mitologia)
Panama	Panama
Panama	Kategoria:Panama
Panama Canal	Kanał Panamski
Panama City	Panama (miasto)
Pancreas	Trzustka
Pandemic	Pandemia
Pandora	Pandora
Pangaea	Pangea
Pantheism	Panteizm
Pantheon	Panteon w Rzymie
Panthera	Panthera
Papal States	Państwo Kościelne
Papua New Guinea	Papua-Nowa Gwinea
Papua New Guinea	Kategoria:Papua-Nowa Gwinea
Papyrus	Papirus
Parabola	Parabola (matematyka)
Paracelsus	Paracelsus
Parachute	Spadochron
Paradigm	Paradygmat
Paradox	Paradoks
Paragliding	Paralotniarstwo
Paraguay	Paragwaj
Paraguay	Kategoria:Paragwaj
Parallax	Paralaksa
Parallelogram	Równoległobok
Paramaribo	Paramaribo
Paranoia	Zespół paranoiczny
Paraphilia	Parafilia
Parapsychology	Parapsychologia
Parasitism	Pasożytnictwo (biologia)
Parchment	Pergamin
Paris	Paryż
Paris	Kategoria:Paryż
Paris (mythology)	Parys
Parity (mathematics)	Liczby parzyste i nieparzyste
Parkinson's disease	Choroba Parkinsona
Parliament	Parlament
Parmenides	Parmenides
Parody	Parodia
Parrot	Papugowe
Parsec	Parsek
Parsley	Pietruszka zwyczajna
Parthenon	Partenon
Parthia	Partia (kraina)
Particle physics	Fizyka cząstek elementarnych
Particle physics	Kategoria:Fizyka cząstek elementarnych
Parvati	Parwati
Pascal	Pascal
Pascal (programming language)	Pascal (język programowania)
Pascal (unit)	Paskal
Passeriformes	Kategoria:Wróblowe
Passerine	Wróblowe
Passover	Pesach
Passport	Paszport
Pasteurization	Pasteryzacja
Patagonia	Patagonia
Patent	Patent
Pathology	Fitopatologia
Patras	Patras
Patriarch	Patriarcha
Patrick White	Patrick White
Patriotism	Patriotyzm
Paul Gauguin	Paul Gauguin
Paul Johann Ludwig von Heyse	Paul Heyse
Paul Klee	Paul Klee
Paul McCartney	Paul McCartney
Paul Newman	Paul Newman
Paul Verlaine	Paul Verlaine
Paul the Apostle	Paweł z Tarsu
Paul von Hindenburg	Paul von Hindenburg
Pauli exclusion principle	Reguła Pauliego
Pavo (constellation)	Paw (gwiazdozbiór)
Pawn (chess)	Pion (szachy)
Pays de la Loire	Kraje Loary
Pea	Groch
Peace	Pokój (polityka)
Peace of Westphalia	Pokój westfalski 1648
Peach	Brzoskwinia
Peanut	Orzech ziemny
Pear	Grusza
Pearl	Perła
Pearl Harbor	Naval Base Pearl Harbor
Peat	Torf
Pedagogy	Pedagogika
Pedagogy	Kategoria:Pedagogika
Pediatrics	Pediatria
Pedophilia	Pedofilia
Pedunculate Oak	Dąb szypułkowy
Pegasus	Pegaz (mitologia)
Pegasus (constellation)	Pegaz (gwiazdozbiór)
Peloponnese	Peloponez
Peloponnesian War	Wojny peloponeskie
Pencil	Ołówek
Pendulum	Wahadło
Penelope	Penelopa
Penguin	Pingwiny
Penicillin	Penicyliny
Peninsula	Półwysep
Pennsylvania	Pensylwania
Pennsylvania	Kategoria:Pensylwania
Pentagon	Pięciokąt
Pentagram	Pentagram
Pentecost	Zesłanie Ducha Świętego
Pentecostalism	Pentekostalizm
People	Kategoria:Biografie
People's Republic of China	Chińska Republika Ludowa
Pepin the Short	Pepin Krótki
Pepsi	Pepsi-Cola
Peptide	Peptydy
Percentage	Procent
Perception	Spostrzeganie
Perciformes	Okoniokształtne
Percussion instrument	Instrument perkusyjny
Percy Bysshe Shelley	Percy Bysshe Shelley
Peregrine Falcon	Sokół wędrowny
Perestroika	Pieriestrojka
Perfume	Perfumy
Pericles	Perykles
Period (periodic table)	Prawo okresowości Mendelejewa
Periodic table	Układ okresowy pierwiastków
Perm	Perm (miasto)
Permafrost	Wieczna zmarzlina
Permian	Perm
Permutation	Permutacja
Pernambuco	Pernambuco
Perpetual motion	Perpetuum mobile
Persephone	Persefona
Persepolis	Persepolis
Perseus	Perseusz (mitologia)
Perseus (constellation)	Perseusz (gwiazdozbiór)
Persian Gulf	Zatoka Perska
Personal digital assistant	Palmtop
Perth	Perth
Peru	Peru
Peru	Kategoria:Peru
Pesticide	Pestycydy
Peter Abelard	Piotr Abelard
Peter Paul Rubens	Peter Paul Rubens
Peter Sellers	Peter Sellers
Petrarch	Francesco Petrarca
Petroleum	Ropa naftowa
Petrology	Petrologia
Phanerozoic	Fanerozoik
Pharaoh	Faraon
Pharmacology	Farmakologia
Pharmacology	Kategoria:Farmakologia
Pharynx	Gardło
Phase (matter)	Stan skupienia materii
Phenol	Fenol
Phenomenology	Fenomenologia
Phenotype	Fenotyp
Phenylalanine	Fenyloalanina
Phenylketonuria	Fenyloketonuria
Phi (letter)	Phi
Philadelphia	Filadelfia
Philately	Filatelistyka
Philately	Kategoria:Filatelistyka
Philip II of Macedon	Filip II Macedoński
Philip II of Spain	Filip II Hiszpański
Philipp Lenard	Fülöp Lénárd
Philippine Sea	Morze Filipińskie
Philippines	Filipiny
Philippines	Kategoria:Filipiny
Philology	Filologia
Philology	Kategoria:Filologia
Philosopher's stone	Kamień filozoficzny
Philosophy	Filozofia
Philosophy	Kategoria:Filozofia
Philosophy	Portal:Filozofia
Phnom Penh	Phnom Penh
Phobia	Fobia
Phobos (moon)	Fobos (księżyc)
Phoenicia	Fenicja
Phoenix	Phoenix (Arizona)
Phoenix	Feniks (ujednoznacznienie)
Phoenix (constellation)	Feniks (gwiazdozbiór)
Phoenix (mythology)	Feniks
Phoenix (spacecraft)	Phoenix (lądownik)
Phoneme	Fonem
Phonetics	Fonetyka
Phonology	Fonologia
Phosphate	Fosforany
Phosphoric acid	Kwas fosforowy
Phosphorus	Fosfor
Photography	Fotografia
Photography	Kategoria:Fotografia
Photon	Foton
Photosphere	Fotosfera
Photosynthesis	Fotosynteza
Phylum	Typ (biologia)
Physical chemistry	Chemia fizyczna
Physical chemistry	Kategoria:Chemia fizyczna
Physician	Lekarz
Physics	Fizyka
Physics	Kategoria:Fizyka
Physics	Portal:Fizyka
Physiology	Fizjologia
Physiology	Kategoria:Fizjologia
Pi	Pi
Pi (letter)	Pi (litera)
Piano	Fortepian
Picardie	Pikardia
Piciformes	Dzięciołowe
Pictor	Malarz (gwiazdozbiór)
Pidgin	Języki pidżynowe
Pidgin (software)	Pidgin (komunikator internetowy)
Piedmont	Piemont
Pierre	Pierre (Dakota Południowa)
Pierre Curie	Pierre Curie
Pierre de Fermat	Pierre de Fermat
Piet Mondrian	Piet Mondrian
Pieter Zeeman	Pieter Zeeman
Pigment	Pigment
Pilsen	Pilzno
Pinaceae	Sosnowate
Pindar	Pindar
Pine	Sosna
Pineapple	Ananas jadalny
Ping	Ping
Pink	Barwa różowa
Pinniped	Płetwonogie
Piracy	Pirat
Pisa	Piza
Pisces (constellation)	Ryby (gwiazdozbiór)
Piston	Tłok
Pittsburgh	Pittsburgh
Pituitary gland	Przysadka mózgowa
Pixel	Piksel
Pizza	Pizza
Plagiarism	Plagiat
Plane (mathematics)	Płaszczyzna
Planet	Planeta
Planetary nebula	Mgławica planetarna
Plankton	Plankton
Plant	Rośliny
Plasma (physics)	Plazma
Plasmid	Plazmid
Plastic	Tworzywa sztuczne
Plastid	Plastyd
Plate tectonics	Teoria wędrówki płyt tektonicznych
Platelet	Trombocyt
Platinum	Platyna
Plato	Platon
Platypus	Dziobak
Playboy	Playboy
Playing card	Karty do gry
Pleiades (star cluster)	Plejady
Pleistocene	Plejstocen
Pleven	Plewen
Pliny the Elder	Pliniusz Starszy
Pliny the Younger	Pliniusz Młodszy
Pliocene	Pliocen
Plotinus	Plotyn
Plovdiv	Płowdiw
Plum	Śliwa domowa
Plutarch	Plutarch
Pluto	134340 Pluton
Pluto (disambiguation)	Pluton
Plutonium	Pluton (pierwiastek)
Plymouth	Plymouth (Anglia)
Pneumonia	Zapalenie płuc
Po River	Pad (rzeka)
Poaceae	Wiechlinowate
Podcast	Podcasting
Poetry	Poezja
Poetry	Kategoria:Poezja
Pogrom	Pogrom
Point (geometry)	Punkt (geometria)
Poison	Trucizna
Poitiers	Poitiers
Poitou-Charentes	Poitou-Charentes
Poker	Poker
Poland	Polska
Poland	Kategoria:Polska
Polar bear	Niedźwiedź polarny
Polaris	Alfa Ursae Minoris
Police	Policja
Poliomyelitis	Choroba Heinego-Medina
Political party	Partia polityczna
Political science	Politologia
Political science	Kategoria:Politologia
Politician	Polityk
Politics	Polityka
Politics	Kategoria:Polityka
Pollen	Pyłek
Pollination	Zapylanie
Pollution	Zanieczyszczenie środowiska
Polo	Polo (sport)
Polonium	Polon
Polyethylene	Polietylen
Polygamy	Poligamia
Polygon	Wielokąt
Polyhedron	Wielościan
Polyhymnia	Polihymnia
Polymer	Polimery
Polynesia	Polinezja
Polynomial	Wielomian
Polytheism	Politeizm
Polyvinyl chloride	Poli(chlorek winylu)
Pomegranate	Granatowiec właściwy
Pomelo	Pomarańcza olbrzymia
Pompeii	Pompeje
Pompey	Pompejusz
Pontius Pilate	Poncjusz Piłat
Pop art	Pop-art
Pop music	Muzyka pop
Pope	Papież
Pope Alexander VI	Papież Aleksander VI
Poplar	Topola
Populism	Populizm
Porcelain	Porcelana
Pornography	Pornografia
Port	Port morski
Port Louis	Port Louis
Port Moresby	Port Moresby
Port Vila	Port Vila
Port of Spain	Port of Spain
Port-au-Prince	Port-au-Prince
Portland	Portland (Oregon)
Portland	Portland
Porto	Porto (miasto)
Portrait	Portret
Portsmouth	Portsmouth
Portugal	Portugalia
Portugal	Kategoria:Portugalia
Poseidon	Posejdon
Positron	Pozyton
Postage stamp	Znaczek pocztowy
Postal code	Kod pocztowy
Postmodernism	Postmodernizm (filozofia)
Potassium	Potas
Potassium nitrate	Azotan potasu
Potato	Ziemniak
Potential energy	Energia potencjalna
Potsdam	Poczdam
Pound (mass)	Funt
Pound sterling	Funt szterling
Poverty	Bieda
Power (physics)	Moc
Power station	Elektrownia
Praetor	Pretor
Prague	Praga
Prague	Kategoria:Praga
Praia	Praia
Praseodymium	Prazeodym
Prayer	Modlitwa
Precambrian	Prekambr
Precession	Precesja
Precipitation (meteorology)	Opad atmosferyczny
Pregnancy	Ciąża
Prehistory	Prehistoria
Prehistory	Kategoria:Prehistoria
President	Prezydent
President of the United States	Prezydenci USA
Pressure	Ciśnienie
Pretoria	Pretoria
Priam	Priam
Price	Cena (ekonomia)
Priest	Kapłan
Primate	Naczelne
Primates	Kategoria:Naczelne
Prime Meridian	Południk zerowy
Prime minister	Premier
Prime number	Liczby pierwsze
Prince Edward Island	Wyspa Księcia Edwarda
Prince Philip	Filip Mountbatten, książę Edynburga
Prince of Wales	Książę Walii
Princeton University	Uniwersytet Princeton
Principle of relativity	Teoria względności
Printing	Druk
Prion	Priony
Prism (geometry)	Graniastosłup
Prism (optics)	Pryzmat
Prison	Zakład karny
Prisoner of war	Jeniec wojenny
Prix Goncourt	Nagroda Goncourtów
Probability	Prawdopodobieństwo
Probability theory	Teoria prawdopodobieństwa
Probability theory	Kategoria:Rachunek prawdopodobieństwa
Procyonidae	Szopowate
Professor	Profesor
Profit	Zysk (ekonomia)
Programmer	Programista
Programming language	Język programowania
Progressive rock	Rock progresywny
Project	Projekt (zarządzanie)
Prokaryote	Prokarioty
Prolog	Prolog (język programowania)
Prometheus	Prometeusz (mitologia)
Promethium	Promet
Pronoun	Zaimek
Propaganda	Propaganda
Propane	Propan
Prophet	Prorok
Prose	Proza
Prostate	Prostata
Protactinium	Protaktyn
Protectorate	Protektorat
Protein	Białka
Proterozoic	Proterozoik
Protestant Reformation	Reformacja
Protestantism	Protestantyzm
Protist	Protisty
Protista	Kategoria:Protisty
Protocol	Protokół
Proton	Proton
Protozoa	Protisty zwierzęce
Providence	Providence (Rhode Island)
Proxima Centauri	Proxima Centauri
Prunus	Śliwa
Prussia	Prusy (państwo)
Psalms	Księga Psalmów
Pseudonym	Pseudonim
Pseudoscience	Kategoria:Pseudonauka
Pseudoscience	Pseudonauka
Psi (letter)	Psi (litera)
Psoriasis	Łuszczyca
Psychiatry	Psychiatria
Psychiatry	Kategoria:Psychiatria
Psychoanalysis	Psychoanaliza
Psychology	Psychologia
Psychology	Kategoria:Psychologia
Psychosis	Psychoza
Psychotherapy	Psychoterapia
Ptah	Ptah
Pterosaur	Pterozaury
Ptolemaic dynasty	Ptolemeusze
Ptolemy	Klaudiusz Ptolemeusz
Puberty	Pokwitanie
Public domain	Domena publiczna
Public relations	Public relations
Puerto Rico	Portoryko
Puerto Rico	Kategoria:Portoryko
Pula	Pula
Pulley	Krążek linowy
Pulsar	Pulsar
Pump	Pompa
Punctuation	Interpunkcja
Punjab (India)	Pendżab (stan w Indiach)
Punk	Kategoria:Punk
Pupil	Źrenica
Puppis	Rufa (gwiazdozbiór)
Pyongyang	Pjongjang
Pyramid	Piramida
Pyramid (geometry)	Ostrosłup
Pyrenees	Pireneje
Pyrite	Piryt
Pyrrhic victory	Pyrrusowe zwycięstwo
Pythagoras	Pitagoras
Python (programming language)	Python
Pyxis	Kompas (gwiazdozbiór)
Q	Q
Qatar	Katar
Qatar	Kategoria:Katar
Qin Dynasty	Dynastia Qin
Qing Dynasty	Mandżurska dynastia Qing
Quadratic equation	Równanie kwadratowe
Quadrilateral	Czworokąt
Quaestor	Kwestor
Quantum field theory	Kwantowa teoria pola
Quantum mechanics	Mechanika kwantowa
Quantum mechanics	Kategoria:Mechanika kwantowa
Quarantine	Kwarantanna (medycyna)
Quark	Kwark
Quartz	Kwarc
Quasar	Kwazar
Quaternary	Czwartorzęd
Quaternion	Kwaterniony
Quebec	Quebec
Quebec	Kategoria:Quebec
Quebec City	Québec (miasto)
Quechua	Język keczua
Queen (chess)	Hetman (szachy)
Queens	Queens (dzielnica)
Queensland	Queensland
Quentin Tarantino	Quentin Tarantino
Question mark	Pytajnik
Quetzalcoatl	Quetzalcoatl
Quince	Pigwa pospolita
Quito	Quito
R	R
RAF (disambiguation)	RAF
RAID	RAID
RNA	Kwasy rybonukleinowe
Ra	Re (bóg)
Rabat	Rabat (Maroko)
Rabbi	Rabin
Rabindranath Tagore	Rabindranath Tagore
Raccoon Dog	Jenot
Race	Rasa
Rachel Carson	Rachel Carson
Racism	Rasizm
Radar	Radar
Radian	Radian
Radio	Kategoria:Radio
Radio telescope	Radioteleskop
Radioactive decay	Radioaktywność
Radiocarbon dating	Datowanie radiowęglowe
Radiology	Radiologia
Radium	Rad (pierwiastek)
Radius	Promień
Radon	Radon
Rain	Deszcz
Rainbow	Tęcza
Rainer Maria Rilke	Rainer Maria Rilke
Raleigh	Raleigh (Karolina Północna)
Ralph Waldo Emerson	Ralph Waldo Emerson
Rama	Rama (Bóg)
Ramadan	Ramadan
Ramayana	Ramajana
Ramesses II	Ramzes II
Random access memory	Pamięć o dostępie swobodnym
Ranunculaceae	Jaskrowate
Rape	Zgwałcenie
Rapeseed	Kapusta rzepak
Raphael	Rafael Santi
Raphael (archangel)	Archanioł Rafael
Rapid transit	Kategoria:Metro
Raspberry	Malina (roślina)
Rat	Szczur
Rational number	Liczby wymierne
Ratite	Bezgrzebieniowce
Ravenna	Rawenna
Rawalpindi	Rawalpindi
Ray Bradbury	Ray Bradbury
Read-only memory	Pamięć tylko do odczytu
Real number	Liczby rzeczywiste
Recession	Recesja (ekonomia)
Recife	Recife
Rectangle	Prostokąt
Rectifier	Prostownik
Recursion	Rekurencja
Recycling	Recykling
Red	Barwa czerwona
Red Army Faction	Frakcja Czerwonej Armii
Red Deer	Jeleń szlachetny
Red Fox	Lis rudy
Red Panda	Panda mała
Red Sea	Morze Czerwone
Red algae	Krasnorosty
Red blood cell	Erytrocyt
Red dwarf	Czerwony karzeł
Red giant	Czerwony olbrzym
Redshift	Przesunięcie ku czerwieni
Redshift (disambiguation)	Przesunięcie ku czerwieni
Reduced instruction set computer	RISC
Referendum	Referendum
Refraction	Refrakcja
Refractive index	Współczynnik załamania
Refugee	Uchodźca
Regent	Regent
Reggae	Reggae
Regiment	Pułk
Regina	Regina (Saskatchewan)
Region	Region (geografia)
Reims	Reims
Reincarnation	Reinkarnacja
Reindeer	Renifer
Relation (mathematics)	Relacja (matematyka)
Relativism	Relatywizm
Relativity	Kategoria:Teoria względności
Relay	Przekaźnik
Religion	Religia
Religion	Kategoria:Religie
Religious Society of Friends	Kwakrzy
Rembrandt	Rembrandt
Renaissance	Renesans
Renaissance	Kategoria:Renesans
Reproduction	Rozmnażanie
Reptile	Gady
Republic	Republika
Republic of China	Republika Chińska
Republic of Ireland	Irlandia
Republic of Ireland	Kategoria:Irlandia
Republic of the Congo	Kongo
Republic of the Congo	Kategoria:Kongo
Republican Party (United States)	Partia Republikańska (USA)
Requiem	Requiem (muzyka)
Resistor	Opornik
Respiratory system	Układ oddechowy
Restaurant	Restauracja (lokal gastronomiczny)
Reticulum	Sieć (gwiazdozbiór)
Retina	Siatkówka (anatomia)
Retinol	Witamina A
Revolution	Rewolucja
Revolver	Rewolwer
Rhea (moon)	Rea (księżyc)
Rhea (mythology)	Rea (mitologia)
Rhenium	Ren (pierwiastek)
Rhetoric	Retoryka
Rhetoric	Kategoria:Retoryka
Rhine	Ren
Rhinoceros	Nosorożce
Rho (letter)	Rho (litera)
Rhode Island	Rhode Island
Rhode Island	Kategoria:Rhode Island
Rhodes	Rodos (wyspa)
Rhodium	Rod (pierwiastek)
Rhombus	Romb
Rhyme	Rym
Rhythm	Rytm
Rhythm and blues	Rhythm and blues
Rib	Żebra (anatomia)
Riboflavin	Witamina B2
Ribosome	Rybosom
Rice	Ryż siewny
Richard Feynman	Richard Feynman
Richard Nixon	Richard Nixon
Richard Strauss	Richard Strauss
Richard Wagner	Richard Wagner
Richard Wright (musician)	Richard Wright (muzyk)
Richmond	Richmond (Wirginia)
Riga	Ryga
Rigel	Rigel
Right ascension	Rektascensja
Ring (mathematics)	Pierścień (matematyka)
Ringo Starr	Ringo Starr
Rio Grande	Rio Grande (rzeka w Ameryce Północnej)
Rio de Janeiro	Rio de Janeiro
Rio de Janeiro (state)	Rio de Janeiro (stan)
River	Rzeka
River Thames	Tamiza
Riyadh	Rijad
Road	Droga (komunikacja)
Roald Amundsen	Roald Amundsen
Robert A. Heinlein	Robert A. Heinlein
Robert Andrews Millikan	Robert Millikan
Robert Boyle	Robert Boyle
Robert Burns	Robert Burns
Robert De Niro	Robert De Niro
Robert E. Lee	Robert E. Lee
Robert Falcon Scott	Robert Falcon Scott
Robert Hooke	Robert Hooke
Robert Koch	Robert Koch
Robert Louis Stevenson	Robert Louis Stevenson
Robert Oppenheimer	Julius Robert Oppenheimer
Robert Owen	Robert Owen
Robert Redford	Robert Redford
Robert Schumann	Robert Schumann
Robin Hood	Robin Hood
Robot	Robot
Rock	Papier, kamień, nożyce
Rock (geology)	Skała
Rock and roll	Rock and roll
Rock music	Rock
Rock music	Kategoria:Rock
Rocket	Rakieta (lotnictwo)
Rocky Mountains	Góry Skaliste
Rococo	Rokoko
Rodent	Gryzonie
Roe Deer	Sarna
Roentgenium	Roentgen (pierwiastek)
Roger Bacon	Roger Bacon
Roman Catholic Church	Łaciński Kościół katolicki
Roman Empire	Cesarstwo rzymskie
Roman Republic	Republika rzymska
Roman calendar	Kalendarz rzymski
Roman law	Prawo rzymskie
Roman legion	Legion
Roman mythology	Mitologia rzymska
Roman mythology	Kategoria:Mitologia rzymska
Romania	Rumunia
Romania	Kategoria:Rumunia
Romansh	Język romansz
Romanticism	Romantyzm
Rome	Rzym
Rome	Kategoria:Rzym
Ronald Reagan	Ronald Reagan
Roof	Dach
Rook (bird)	Gawron
Rook (chess)	Wieża (szachy)
Roosevelt	Roosevelt
Root	Korzeń
Rosa Parks	Rosa Parks
Rosaceae	Różowate
Rosales	Różowce
Rosario	Rosario
Rosary	Różaniec
Rose	Róża
Roseau	Roseau
Rosemary	Rozmaryn lekarski
Rosetta Stone	Kamień z Rosetty
Rosh Hashanah	Rosz ha-Szana
Ross Sea	Morze Rossa
Rostock	Rostock
Rotifer	Wrotki (biologia)
Rotterdam	Rotterdam
Router	Router
Rowing (sport)	Wioślarstwo
Royal Air Force	Royal Air Force
Royal Society	Royal Society
Rubber	Guma
Rubicon	Rubikon
Rubidium	Rubid
Ruble	Rubel
Rubus idaeus	Malina właściwa
Ruby	Rubin
Ruby (programming language)	Ruby (język programowania)
Rudolf Diesel	Rudolf Diesel
Rudolf Hess	Rudolf Hess
Rudolf Steiner	Rudolf Steiner
Rudyard Kipling	Rudyard Kipling
Rugby football	Rugby (sport)
Rupert Murdoch	Rupert Murdoch
Russia	Rosja
Russia	Kategoria:Rosja
Russian Orthodox Church	Rosyjski Kościół Prawosławny
Russian Revolution (1917)	Rewolucje w Rosji 1917 roku
Russo-Japanese War	Wojna rosyjsko-japońska
Ruthenium	Ruten
Rutherford B. Hayes	Rutherford Hayes
Rutherfordium	Rutherford (pierwiastek)
Rwanda	Rwanda
Rwanda	Kategoria:Rwanda
Rye	Żyto
S	S
SOAP	SOAP
SOS	SOS
Sacrament	Sakrament
Sacramento	Sacramento (Kalifornia)
Saddam Hussein	Saddam Husajn
Safari (web browser)	Safari (program)
Saffron	Szafran
Sagitta	Strzała (gwiazdozbiór)
Sagittarius (constellation)	Strzelec (gwiazdozbiór)
Sahara	Sahara
Sail	Żagiel
Saint	Święty
Saint Andrew	Andrzej Apostoł
Saint George	Święty Jerzy
Saint Kitts and Nevis	Saint Kitts i Nevis
Saint Kitts and Nevis	Kategoria:Saint Kitts i Nevis
Saint Lawrence River	Rzeka Świętego Wawrzyńca
Saint Lucia	Saint Lucia
Saint Lucia	Kategoria:Saint Lucia
Saint Martin	Sint Maarten (wyspa)
Saint Nicholas	Mikołaj z Miry
Saint Patrick	Święty Patryk
Saint Paul	Saint Paul
Saint Peter	Piotr Apostoł
Saint Petersburg	Sankt Petersburg
Saint Petersburg	Kategoria:Sankt Petersburg
Saint Vincent and the Grenadines	Saint Vincent i Grenadyny
Saint Vincent and the Grenadines	Kategoria:Saint Vincent i Grenadyny
Sake	Sake
Saladin	Saladyn
Salah	Salat
Salamander	Płazy ogoniaste
Salem	Salem (Oregon)
Salerno	Salerno
Saliva	Ślina
Salman Rushdie	Salman Rushdie
Salmonidae	Łososiowate
Salt	Sól kuchenna
Salt (chemistry)	Sole
Salt Lake City	Salt Lake City
Salvador	Salvador
Salzburg	Salzburg
Salzburg (state)	Salzburg (kraj związkowy)
Samara	Samara (miasto)
Samarium	Samar
Samarkand	Samarkanda
Samoa	Samoa
Samoa	Kategoria:Samoa
Samsara	Samsara
Samuel Beckett	Samuel Beckett
Samuel F. B. Morse	Samuel Finley Breese Morse
Samuel Taylor Coleridge	Samuel Taylor Coleridge
Samurai	Samuraj
San Antonio	San Antonio (Teksas)
San Diego	San Diego
San Francisco	San Francisco
San Jose	San José (Kalifornia)
San Juan	San Juan
San Marino	San Marino
San Marino	Kategoria:San Marino
San Marino	San Marino (miasto)
San Salvador	San Salvador (miasto w Salwadorze)
Sand	Piasek
Sandro Botticelli	Sandro Botticelli
Sandstone	Piaskowiec
Sandwich	Kanapka
Sanskrit	Sanskryt
Santa Claus	Święty Mikołaj (postać baśniowa)
Santa Fe	Santa Fe (Nowy Meksyk)
Santiago	Santiago de Chile
Santiago	Santiago
Santiago de Cuba	Santiago de Cuba
Santo Domingo	Santo Domingo
Santos (Săo Paulo)	Santos
Sapphire	Szafir
Sappho	Safona
Sapporo	Sapporo
Sarah Bernhardt	Sarah Bernhardt
Sarajevo	Sarajewo
Saratov	Saratów
Sarcophagus	Sarkofag
Sardine	Sardynka
Sardinia	Sardynia
Sari	Sari (miasto w Iranie)
Sarin	Sarin
Saskatchewan	Saskatchewan
Satellite	Sztuczny satelita
Satire	Satyra
Saturday	Sobota
Saturn	Saturn
Saturn	Kategoria:Saturn
Saturn (disambiguation)	Saturn (ujednoznacznienie)
Saturn (mythology)	Saturn (mitologia)
Satyr	Satyr
Sauce	Sos
Saudi Arabia	Arabia Saudyjska
Saudi Arabia	Kategoria:Arabia Saudyjska
Saul Bellow	Saul Bellow
Sausage	Wędliny
Savanna	Sawanna
Saxony	Saksonia
Saxony	Kategoria:Saksonia
Saxophone	Saksofon
Scandinavia	Skandynawia
Scandinavia	Kategoria:Skandynawia
Scandinavian Peninsula	Półwysep Skandynawski
Scandium	Skand
Scapula	Łopatka
Scheldt	Skalda
Scheme (programming language)	Scheme
Schizophrenia	Schizofrenia
Scholasticism	Scholastyka (filozofia)
School	Szkoła (oświata)
Schutzstaffel	Schutzstaffel
Science	Nauka
Science	Kategoria:Nauka
Science fiction	Fantastyka naukowa
Scientific method	Metoda naukowa
Scientist	Naukowiec
Scientology	Scjentologia
Scipio Africanus	Scypion Afrykański Starszy
Scissors	Nożyczki
Sciuridae	Wiewiórkowate
Scorpion	Skorpiony
Scorpius	Skorpion (gwiazdozbiór)
Scotland	Szkocja
Scotland	Kategoria:Szkocja
Scots Pine	Sosna zwyczajna
Scottish Gaelic	Język szkocki gaelicki
Scouting	Skauting
Scrabble	Scrabble
Screw	Śruba (złącze)
Screwdriver	Wkrętak
Scrotum	Moszna (anatomia)
Sculptor (constellation)	Rzeźbiarz (gwiazdozbiór)
Sculpture	Rzeźba
Sculpture	Kategoria:Rzeźba
Sea	Morze
Sea Otter	Wydra morska
Sea anemone	Ukwiał
Sea cucumber	Strzykwy
Sea level	Poziom morza
Sea of Azov	Morze Azowskie
Sea of Japan	Morze Japońskie
Sea of Marmara	Morze Marmara
Sea of Okhotsk	Morze Ochockie
Sea urchin	Jeżowce
Seaborgium	Seaborg
Seahorse	Konik morski
Search engine	Wyszukiwarka internetowa
Sears Tower	Sears Tower
Season	Pora roku
Seattle	Seattle
Second	Sekunda
Second Crusade	II wyprawa krzyżowa
Second Vatican Council	Sobór Watykański II
Second law of thermodynamics	Druga zasada termodynamiki
Sect	Sekta
Security	Kategoria:Ochrona
Sedimentary rock	Skały osadowe
Seed	Nasienie (botanika)
Segovia	Segowia
Seine	Sekwana
Seismology	Sejsmologia
Seismology	Kategoria:Sejsmologia
Selene	Selene
Selenium	Selen
Seleucus I Nicator	Seleukos I Nikator
Semantics	Semantyka
Semen	Sperma
Semicolon	Średnik
Semiconductor	Półprzewodniki
Semiotics	Semiotyka (językoznawstwo)
Semitic	Ludy semickie
Senegal	Senegal
Senegal	Kategoria:Senegal
Seoul	Seul
Seppuku	Seppuku
September	Wrzesień
September 11	11 września
September 11	Zamach na World Trade Center i Pentagon
September 17	17 września
September 29	29 września
Septuagint	Septuaginta
Sequence	Ciąg (matematyka)
Serbia	Serbia
Serbia	Kategoria:Serbia
Serbia and Montenegro	Serbia i Czarnogóra
Serbia and Montenegro	Kategoria:Serbia i Czarnogóra
Serfdom	Pańszczyzna
Sergei Eisenstein	Siergiej Eisenstein
Sergei Rachmaninoff	Siergiej Rachmaninow
Series (mathematics)	Szereg (matematyka)
Serine	Seryna
Serotonin	Serotonina
Serpens	Wąż (gwiazdozbiór)
Server (computing)	Serwer
Set	Zbiór
Set (mythology)	Set (bóg)
Set theory	Teoria mnogości
Set theory	Kategoria:Teoria mnogości
Sevastopol	Sewastopol
Seven Years' War	Wojna siedmioletnia
Severe acute respiratory syndrome	SARS (choroba)
Seville	Sewilla
Sex	Płeć
Sexism	Seksizm
Sextant	Sekstant
Sexual intercourse	Stosunek płciowy
Sexuality	Kategoria:Seksualność
Sexually transmitted disease	Choroby przenoszone drogą płciową
Seychelles	Seszele
Seychelles	Kategoria:Seszele
Shah	Szach (władca)
Shahadah	Szahada
Shamanism	Szamanizm
Shanghai	Szanghaj
Share (finance)	Akcja (prawo)
Shareware	Shareware
Sharia	Szariat
Shark	Rekiny
Sheffield	Sheffield
Sherlock Holmes	Sherlock Holmes
Shetland	Szetlandy
Shield	Tarcza (uzbrojenie)
Shikoku	Sikoku
Shinto	Shintō
Ship	Statek wodny
Shiva	Śiwa
Shogi	Shōgi
Shogun	Shōgun
Shorthand	Stenografia
Shrimp	Krewetki
Shrub	Krzew
Siberia	Syberia
Siberian Husky	Siberian Husky
Sichuan	Syczuan
Sicily	Sycylia
Sicily	Kategoria:Sycylia
Siemens (unit)	Simens
Sierra Leone	Sierra Leone
Sierra Leone	Kategoria:Sierra Leone
Sigma	Sigma
Sigmund Freud	Zygmunt Freud
Sign language	Język migowy
Sigrid Undset	Sigrid Undset
Sikhism	Sikhizm
Sikkim	Sikkim
Silesia	Śląsk
Silicon	Krzem
Silicon Valley	Dolina Krzemowa
Silicon dioxide	Ditlenek krzemu
Silk	Jedwab
Silk Road	Jedwabny szlak
Silurian	Sylur
Silver	Srebro
Simone de Beauvoir	Simone de Beauvoir
Sin	Grzech
Sinai Peninsula	Synaj (półwysep)
Sinclair Lewis	Sinclair Lewis
Singapore	Singapur
Singapore	Kategoria:Singapur
Single (music)	Singel (muzyka)
Siren	Syrena (mitologia)
Sirenia	Syreny
Sirius	Syriusz
Sistine Chapel	Kaplica Sykstyńska
Sisyphus	Syzyf
Sitting Bull	Siedzący Byk
Situation comedy	Sitcom
Six-Day War	Wojna sześciodniowa
Skagerrak	Skagerrak
Skateboard	Deskorolka
Skeletal system	Kategoria:Układ kostny człowieka
Skepticism	Sceptycyzm
Skin	Skóra
Skinhead	Skinhead
Skopje	Skopje
Skull	Czaszka
Skylab	Skylab
Skyscraper	Wieżowiec
Slash (musician)	Slash
Slavery	Niewolnictwo
Slayer	Slayer
Sleep	Sen
Slovakia	Słowacja
Slovakia	Kategoria:Słowacja
Slovenia	Słowenia
Slovenia	Kategoria:Słowenia
Small intestine	Jelito cienkie
Smog	Smog
Smolensk	Smoleńsk
Snake	Węże
Snooker	Snooker
Snow	Śnieg
Soap	Mydła
Social psychology	Psychologia społeczna
Socialism	Socjalizm
Socialism	Kategoria:Socjalizm
Socialist Party (France)	Partia Socjalistyczna (Francja)
Society	Kategoria:Społeczeństwo
Society	Społeczeństwo
Society of Jesus	Jezuici
Sociolinguistics	Socjolingwistyka
Sociology	Socjologia
Sociology	Kategoria:Socjologia
Socrates	Sokrates
Sodium	Sód
Sodium bicarbonate	Wodorowęglan sodu
Sodium chloride	Chlorek sodu
Sodium hydroxide	Wodorotlenek sodu
Sofia	Sofia
Softball	Softball
Software	Kategoria:Oprogramowanie
Soil	Gleba
Solanaceae	Psiankowate
Solanaceae	Kategoria:Psiankowate
Solar System	Układ Słoneczny
Solar System	Kategoria:Układ Słoneczny
Solar cell	Ogniwo słoneczne
Solar eclipse	Zaćmienie Słońca
Solar energy	Energetyka słoneczna
Solar wind	Wiatr słoneczny
Solid	Ciało stałe
Solidarity	Niezależny Samorządny Związek Zawodowy "Solidarność"
Solomon	Salomon (król Izraela)
Solomon Islands	Wyspy Salomona
Solomon Islands	Kategoria:Wyspy Salomona
Solon	Solon
Solstice	Przesilenie
Solution	Roztwór
Solvent	Rozpuszczalnik
Somalia	Somalia
Somalia	Kategoria:Somalia
Somerset	Hrabstwo Somerset (Anglia)
Somme	Somme
Sonata	Sonata
Song	Piosenka
Song of Solomon	Pieśń nad pieśniami
Sonnet	Sonet
Sophia Loren	Sophia Loren
Sophism	Sofiści
Sophocles	Sofokles
Soprano	Sopran
Sorbonne	Sorbona
Sorghum	Sorgo
Sorting algorithm	Sortowanie
Soul	Dusza
Sound	Dźwięk
Soup	Zupa
Source code	Kod źródłowy
South	Południe
South Africa	Kategoria:Republika Południowej Afryki
South America	Ameryka Południowa
South America	Kategoria:Ameryka Południowa
South Australia	Australia Południowa
South Carolina	Karolina Południowa
South Carolina	Kategoria:Karolina Południowa
South China Sea	Morze Południowochińskie
South Dakota	Dakota Południowa
South Dakota	Kategoria:Dakota Południowa
South Island	Wyspa Południowa (Nowa Zelandia)
South Korea	Korea Południowa
South Korea	Kategoria:Korea Południowa
South Pole	Biegun południowy
South Vietnam	Wietnam Południowy
Southeast Asia	Azja Południowo-Wschodnia
Southern Hemisphere	Półkula południowa
Sovereignty	Suwerenność
Soviet Union	Związek Socjalistycznych Republik Radzieckich
Soviet Union	Kategoria:ZSRR
Soybean	Soja
Space	Przestrzeń
Space Shuttle	Program lotów wahadłowców
Space station	Stacja orbitalna
Spacecraft	Statek kosmiczny
Spaghetti	Spaghetti
Spain	Hiszpania
Spain	Kategoria:Hiszpania
Spam (electronic)	Spam
Spanish Civil War	Hiszpańska wojna domowa
Spanish people	Kategoria:Hiszpanie
Spanish-American War	Wojna amerykańsko-hiszpańska
Sparta	Sparta
Spear	Włócznia
Special relativity	Szczególna teoria względności
Species	Gatunek (biologia)
Spectroscopy	Spektroskopia
Speed	Szybkość
Speed of light	Prędkość światła
Speleology	Speleologia
Spencer Tracy	Spencer Tracy
Sperm Whale	Kaszalot
Spermatophyte	Rośliny nasienne
Spermatozoon	Plemnik
Sphere	Sfera
Sphinx	Sfinks
Spice	Przyprawa
Spider	Pająki
Spin (physics)	Spin (fizyka)
Spinach	Szpinak
Spinal cord	Rdzeń kręgowy
Spiral galaxy	Galaktyka spiralna
Spleen	Śledziona
Split	Split (miasto)
Sponge	Gąbki
Sport	Sport
Spreadsheet	Arkusz kalkulacyjny
Spree	Sprewa
Spring (season)	Wiosna
Springfield	Springfield (Illinois)
Spyware	Spyware
Squamata	Łuskonośne
Square (geometry)	Kwadrat
Square metre	Metr kwadratowy
Squash (sport)	Squash
Squirrel	Wiewiórka
Sri Lanka	Sri Lanka
Sri Lanka	Kategoria:Sri Lanka
St. Louis	Saint Louis (Missouri)
Stadium	Stadion
Stained glass	Witraż
Stainless steel	Stal nierdzewna
Stalinism	Stalinizm
Standard Generalized Markup Language	Standard Generalized Markup Language
Standard deviation	Odchylenie standardowe
Stanford University	Uniwersytet Stanforda
Stanley Kubrick	Stanley Kubrick
Star	Gwiazda
Star of David	Gwiazda Dawida
Starch	Skrobia
Starfish	Rozgwiazdy
State	Państwo
Staten Island	Staten Island
Statistical mechanics	Mechanika statystyczna
Statistics	Statystyka
Statistics	Kategoria:Statystyka
Statue of Liberty	Statua Wolności
Stavanger	Stavanger
Steam engine	Silnik parowy
Steel	Stal
Stefan Zweig	Stefan Zweig
Steffi Graf	Steffi Graf
Stegosaurus	Stegozaur
Stem cell	Komórki macierzyste
Stendhal	Stendhal
Stephen Hawking	Stephen Hawking
Steppe	Step
Steradian	Steradian
Sternum	Mostek (anatomia człowieka)
Steroid	Steroidy
Steven Spielberg	Steven Spielberg
Sting	Sting
Stock exchange	Giełda
Stockholm	Sztokholm
Stoicism	Stoicyzm
Stomach	Żołądek
Stone Age	Epoka kamienia
Stonehenge	Stonehenge
Stork	Bocianowate
Storm	Sztorm (meteorologia)
Strait	Cieśnina
Strait of Gibraltar	Cieśnina Gibraltarska
Strait of Hormuz	Ormuz (cieśnina)
Strait of Magellan	Cieśnina Magellana
Strait of Messina	Cieśnina Mesyńska
Straits	Kategoria:Cieśniny
Strasbourg	Strasburg
Strategy	Strategia organizacji
Stratigraphy	Stratygrafia
Stratosphere	Stratosfera
Strawberry	Poziomka
Stress (medicine)	Stres
String theory	Teoria strun
Stroke	Udar mózgu
Strong interaction	Oddziaływanie silne
Strontium	Stront
Structuralism	Strukturalizm (językoznawstwo)
Stub	Szablon:Stub
Student	Student
Stupa	Stupa
Sturmabteilung	Sturmabteilung
Stuttgart	Stuttgart
Styx	Styks
Sub-Saharan Africa	Czarna Afryka
Subculture	Subkultura
Sublimation (chemistry)	Sublimacja (fizyka)
Submarine	Okręt podwodny
Subset	Podzbiór
Subtraction	Odejmowanie
Subversion (software)	Subversion
Sucre	Sucre (miasto)
Sucrose	Sacharoza
Sudan	Sudan
Sudan	Kategoria:Sudan
Sudoku	Sudoku
Suez Canal	Kanał Sueski
Suffix	Przyrostek
Sufism	Sufizm
Sugar	Cukier spożywczy
Suharto	Suharto
Sukarno	Sukarno
Sulawesi	Celebes
Sulfur	Siarka
Sulfur dioxide	Tlenek siarki(IV)
Sulfur mustard	Iperyt
Sulfuric acid	Kwas siarkowy(VI)
Sultan	Sułtan
Sumatra	Sumatra
Sumer	Sumer
Summer	Lato
Sumo	Sumo
Sun	Słońce
Sun	Kategoria:Słońce
Sun Yat-sen	Sun Jat-sen
Sunday	Niedziela
Sundial	Zegar słoneczny
Sunflower	Słonecznik zwyczajny
Sunni Islam	Sunnici
Sunspot	Plama słoneczna
Supercomputer	Superkomputer
Superconductivity	Nadprzewodnictwo
Superman	Superman
Supernova	Supernowa
Supreme Court of the United States	Sąd Najwyższy Stanów Zjednoczonych
Sura	Sura (Koran)
Surface tension	Napięcie powierzchniowe
Surgeon	Chirurgia
Surgery	Chirurgia
Surgery	Kategoria:Chirurgia
Suriname	Surinam
Suriname	Kategoria:Surinam
Surrealism	Surrealizm
Surrey	Surrey (Wielka Brytania)
Susan Sontag	Susan Sontag
Sushi	Sushi
Suva	Suva
Svalbard	Svalbard
Swallow	Jaskółkowate
Swan	Łabędź
Swastika	Swastyka
Swaziland	Suazi
Swaziland	Kategoria:Suazi
Sweden	Szwecja
Sweden	Kategoria:Szwecja
Swedish krona	Korona szwedzka
Sweet potato	Batat
Swimming	Pływanie
Swimming	Kategoria:Pływanie
Swiss franc	Frank szwajcarski
Swiss people	Kategoria:Szwajcarzy
Switzerland	Szwajcaria
Switzerland	Kategoria:Szwajcaria
Sword	Miecz
Sydney	Sydney
Syllable	Sylaba
Sylvia Plath	Sylvia Plath
Symbiosis	Symbioza
Symbol	Symbol
Symphony	Symfonia
Symptom	Objaw (medycyna)
Synagogue	Synagoga
Syndicate	Syndykat
Synesthesia	Synestezja
Synonym	Synonim
Syntax	Syntaktyka (językoznawstwo)
Synthesizer	Syntezator
Syphilis	Kiła
Syracuse	Syrakuzy
Syria	Syria
Syria	Kategoria:Syria
System	System
Systematics	Systematyka (biologia)
T	T
T. E. Lawrence	Thomas Edward Lawrence
T. S. Eliot	Thomas Stearns Eliot
Table (furniture)	Stół
Table tennis	Tenis stołowy
Taboo	Tabu
Tacitus	Publiusz Korneliusz Tacyt
Taekwondo	Taekwondo
Tagus	Tag (rzeka)
Tahiti	Tahiti
Tai chi chuan	Taijiquan
Tail	Ogon
Taipei	Tajpej
Taiwan	Kategoria:Tajwan
Taiwan	Tajwan (wyspa)
Taj Mahal	Tadź Mahal
Tajikistan	Tadżykistan
Tajikistan	Kategoria:Tadżykistan
Talc	Talk
Taliban	Talibowie
Tallahassee	Tallahassee (Floryda)
Tallinn	Tallinn
Talmud	Talmud
Tamil Nadu	Tamil Nadu
Tampa	Tampa (Floryda)
Tampere	Tampere
Tanakh	Tanach
Tang Dynasty	Dynastia Tang
Tangier	Tanger
Tango (dance)	Tango (taniec towarzyski)
Tank	Czołg
Tantalum	Tantal (pierwiastek)
Tantalus	Tantal (mitologia)
Tanzania	Tanzania
Tanzania	Kategoria:Tanzania
Taoism	Taoizm
Tapir	Tapiry
Tardigrade	Niesporczaki
Tarn	Tarn (departament)
Tarragon	Bylica estragon
Tartarus	Tartar
Tartu	Tartu
Tashkent	Taszkent
Tasman Sea	Morze Tasmana
Tasmania	Tasmania
Tasmanian Devil	Diabeł tasmański
Taste	Smak (fizjologia)
Tattoo	Tatuaż
Tau	Tau
Taurus (constellation)	Byk (gwiazdozbiór)
Tawny Owl	Puszczyk
Tax	Podatek
Taxation	Kategoria:Podatki
Taxicab	Taksówka
Taxon	Takson
Taxonomy	Taksonomia
Taxus baccata	Cis pospolity
Tbilisi	Tbilisi
Tea	Herbata
Tea	Kategoria:Herbaty
Teacher	Nauczyciel
Technetium	Technet
Techno	Techno
Technology	Technologia
Technology	Kategoria:Technologia
Tegucigalpa	Tegucigalpa
Tehran	Teheran
Tel Aviv	Tel Awiw-Jafa
Telecommunication	Telekomunikacja
Telegraphy	Telegraf
Telepathy	Telepatia
Telephone	Telefon
Telescope	Teleskop
Telescopium	Luneta (gwiazdozbiór)
Television	Telewizja
Television	Kategoria:Telewizja
Tellurium	Tellur
Temperature	Temperatura
Temple	Świątynia
Temple of Artemis	Świątynia Artemidy w Efezie
Ten Commandments	Dekalog
Tenerife	Teneryfa
Tennessee	Tennessee
Tennessee	Kategoria:Tennessee
Tennessee Williams	Tennessee Williams
Tennis	Tenis
Tennis	Kategoria:Tenis ziemny
Tenor	Tenor
Tenzing Norgay	Tenzing Norgay
Tequila	Tequila
Terbium	Terb
Termite	Termity
Terpsichore	Terpsychora
Terrestrial planet	Planeta skalista
Terrorism	Terroryzm
Terrorism	Kategoria:Terroryzm
Tertullian	Tertulian
Tesla (unit)	Tesla (jednostka)
Testicle	Jądro (anatomia)
Testosterone	Testosteron
Tetanus	Tężec
Tethys (moon)	Tetyda (księżyc)
Tethys (mythology)	Tetyda (Tytanida)
Tetrahedron	Czworościan
Tetrahydrocannabinol	Tetrahydrokannabinol
Tetrapod	Czworonogie
Texas	Teksas
Texas	Kategoria:Teksas
Textile	Tkanina
Thailand	Tajlandia
Thailand	Kategoria:Tajlandia
Thales	Tales z Miletu
Thalia	Talia (muza)
Thallium	Tal
Thanatos	Tanatos (mitologia)
Thanksgiving	Dzień Dziękczynienia
Thanksgiving (Canada)	Dzień Dziękczynienia
Thanksgiving (United States)	Dzień Dziękczynienia
Thanksgiving (disambiguation)	Dzień Dziękczynienia
The Gambia	Gambia
The Gambia	Kategoria:Gambia
The Hague	Haga
The Star-Spangled Banner	Hymn Stanów Zjednoczonych Ameryki
Theatre	Teatr
Theatre	Kategoria:Teatr
Thebe (moon)	Tebe (księżyc)
Thebes	Teby (Grecja)
Thebes	Teby (Egipt)
Theia	Thea (mitologia)
Themis	Temida (bogini)
Themistocles	Temistokles
Theocracy	Teokracja
Theodolite	Teodolit
Theodor Mommsen	Theodor Mommsen
Theodore Roosevelt	Theodore Roosevelt
Theodosius I	Teodozjusz I Wielki
Theology	Teologia
Theology	Kategoria:Teologia
Theorem	Twierdzenie
Theory	Teoria
Theory of relativity	Teoria względności
Theravada	Theravada
Thermodynamics	Termodynamika
Thermodynamics	Kategoria:Termodynamika
Thermometer	Termometr
Theseus	Tezeusz
Thessaloniki	Saloniki
Thessaly	Tesalia
Theta	Theta
Thetis	Tetyda (mitologia)
Thiamine	Witamina B1
Think tank	Think tank
Third Crusade	III wyprawa krzyżowa
Third World	Trzeci Świat
Thirty Years' War	Wojna trzydziestoletnia
Thomas Aquinas	Tomasz z Akwinu
Thomas Edison	Thomas Alva Edison
Thomas Hardy	Thomas Hardy
Thomas Hobbes	Thomas Hobbes
Thomas Jefferson	Thomas Jefferson
Thomas Malthus	Thomas Malthus
Thomas Mann	Thomas Mann
Thomas More	Thomas More
Thomas Paine	Thomas Paine
Thomas Young (scientist)	Thomas Young
Thor	Thor
Thorium	Tor (pierwiastek)
Thoth	Thot
Thought	Myślenie
Thrace	Tracja
Thucydides	Tukidydes
Thulium	Tul
Thumb	Kciuk
Thuringia	Turyngia
Thuringia	Kategoria:Turyngia
Thursday	Czwartek
Thylacine	Wilk workowaty
Thyme	Macierzanka tymianek
Thymine	Tymina
Thyroid	Tarczyca
Tianjin	Tiencin
Tiber	Tyber
Tiberius	Tyberiusz
Tibet	Tybet (region)
Tibet	Kategoria:Tybet
Ticino	Ticino
Tide	Pływy morskie
Tierra del Fuego	Ziemia Ognista (archipelag)
Tiger	Tygrys
Tigris	Tygrys (rzeka)
Tilia	Lipa (drzewo)
Timbuktu	Timbuktu
Time	Czas
Time	Kategoria:Czas
Time (magazine)	Time (tygodnik)
Time zone	Strefa czasowa
Timor	Timor
Timur	Timur
Tin	Cyna
Tirana	Tirana
Tissue (biology)	Tkanka
Tit (bird)	Sikorowate
Titan (disambiguation)	Tytan
Titan (moon)	Tytan (księżyc)
Titan (mythology)	Tytan (bóg)
Titania (moon)	Tytania (księżyc)
Titanic (disambiguation)	Titanic (ujednoznacznienie)
Titanium	Tytan (pierwiastek)
Titian	Tycjan
Titus	Tytus Flawiusz
Tivoli	Tivoli (Włochy)
Tobacco	Tytoń
Tocantins (state)	Tocantins (stan)
Tocopherol	Witamina E
Tofu	Tofu
Togo	Togo
Togo	Kategoria:Togo
Tokyo	Tokio
Toledo	Toledo (Hiszpania)
Toluene	Toluen
Tom Hanks	Tom Hanks
Tom and Jerry	Tom i Jerry
Tomato	Pomidor zwyczajny
Ton	Tona
Tonga	Tonga
Tonga	Kategoria:Tonga
Tongue	Język (anatomia)
Toni Morrison	Toni Morrison
Tonne	Tona
Tony Blair	Tony Blair
Tool	Narzędzie
Tooth	Ząb (stomatologia)
Toothbrush	Szczoteczka do zębów
Topaz	Topaz
Topeka	Topeka (Kansas)
Topology	Topologia
Topology	Kategoria:Topologia
Torah	Tora
Tornado	Tornado
Toronto	Toronto
Torpedo	Torpeda
Torque	Moment siły
Tortoise	Żółwie lądowe
Torture	Tortura
Torus	Torus (matematyka)
Totalitarianism	Totalitaryzm
Toulon	Tulon
Toulouse	Tuluza
Tour de France	Tour de France
Tourism	Turystyka
Tourism	Kategoria:Turystyka
Tours	Tours
Tower	Wieża
Tower of Babel	Wieża Babel
Tower of London	Tower of London
Town	Miasto
Toxicity	Trucizna
Toxicology	Toksykologia
Toy	Zabawka
Toyota	Toyota
Tractor	Ciągnik
Trade	Handel
Trade union	Związek zawodowy
Trademark	Znak handlowy
Tradition	Tradycja
Tragedy	Tragedia
Train	Pociąg
Train station	Dworzec kolejowy
Trajan	Trajan
Tram	Tramwaj
Transcendental number	Liczba przestępna
Transformer	Transformator
Transistor	Tranzystor
Transliteration	Transliteracja
Transmission Control Protocol	TCP
Transportation	Kategoria:Transport
Transsexualism	Transseksualizm
Transylvania	Siedmiogród
Trapezoid	Trapez
Treaty	Umowa międzynarodowa
Treaty of Versailles	Traktat wersalski
Tree	Drzewo
Trento	Trydent
Trenton	Trenton (New Jersey)
Triangle	Trójkąt
Triangulum	Trójkąt (gwiazdozbiór)
Triangulum Australe	Trójkąt Południowy
Triassic	Trias
Tributary	Dopływ
Triceratops	Triceratops
Trier	Trewir
Trigonometric function	Funkcje trygonometryczne
Trigonometry	Trygonometria
Trigonometry	Kategoria:Trygonometria
Trilobite	Trylobity
Trilogy	Trylogia
Trinidad	Trynidad
Trinidad and Tobago	Trynidad i Tobago
Trinidad and Tobago	Kategoria:Trynidad i Tobago
Trinitrotoluene	Trotyl
Trinity	Trójca Święta
Tripoli	Trypolis
Triskelion	Triskelion
Tritium	Tryt
Triton (moon)	Tryton (księżyc)
Triton (mythology)	Tryton (mitologia)
Triumphal arch	Łuk triumfalny
Trojan Horse	Koń trojański
Trojan War	Wojna trojańska
Trojan horse (computing)	Koń trojański (informatyka)
Troll	Troll
Troll (Internet)	Trollowanie
Trolleybus	Trolejbus
Trombone	Puzon
Trondheim	Trondheim
Tropics	Strefa międzyzwrotnikowa
Troposphere	Troposfera
Trotskyism	Trockizm
Troy	Troja
Truck	Samochód ciężarowy
Truman Doctrine	Doktryna Trumana
Trumpet	Trąbka
Truth	Prawda
Trygve Lie	Trygve Lie
Tryptophan	Tryptofan
Tsar	Car
Tsunami	Tsunami
Tuareg	Tuaregowie
Tuba	Tuba
Tuber (genus)	Trufla (grzyb)
Tuberculosis	Gruźlica
Tucana	Tukan (gwiazdozbiór)
Tucson	Tucson
Tuesday	Wtorek
Tulip	Tulipan
Tumor	Guz (medycyna)
Tundra	Tundra
Tungsten	Wolfram
Tunicate	Osłonice
Tunis	Tunis
Tunisia	Tunezja
Tunisia	Kategoria:Tunezja
Tunnel	Tunel (budownictwo)
Turbine	Turbina
Turin	Turyn
Turing machine	Maszyna Turinga
Turkey	Turcja
Turkey	Kategoria:Turcja
Turkmenistan	Turkmenistan
Turkmenistan	Kategoria:Turkmenistan
Turmeric	Ostryż długi
Turtle	Żółwie
Tuscany	Toskania
Tuvalu	Tuvalu
Tuvalu	Kategoria:Tuvalu
Tux	Tux
Tycho Brahe	Tycho Brahe
Typewriter	Maszyna do pisania
Typhon	Tyfon
Typography	Typografia
Typography	Kategoria:Typografia
Tyrannosaurus	Tyranozaur
Tyre	Tyr (miasto)
Tyrol (state)	Tyrol (kraj związkowy)
Tyrrhenian Sea	Morze Tyrreńskie
U	U
UNESCO	UNESCO
Ufa	Ufa (miasto)
Uganda	Uganda
Uganda	Kategoria:Uganda
Ukraine	Ukraina
Ukraine	Kategoria:Ukraina
Ulan Bator	Ułan Bator
Ulster	Ulster
Ultrasound	Ultradźwięki
Ultraviolet	Ultrafiolet
Ulysses S. Grant	Ulysses Grant
Umbrella	Parasol
Umbria	Umbria
Uncertainty principle	Zasada nieoznaczoności
Unemployment	Bezrobocie
Unicorn	Jednorożec
Unidentified flying object	UFO
Uniform Resource Locator	Uniform Resource Locator
Union (set theory)	Suma zbiorów
United Arab Emirates	Zjednoczone Emiraty Arabskie
United Arab Emirates	Kategoria:Zjednoczone Emiraty Arabskie
United Arab Republic	Zjednoczona Republika Arabska
United Kingdom	Wielka Brytania
United Kingdom	Kategoria:Wielka Brytania
United Nations	Organizacja Narodów Zjednoczonych
United Nations	Kategoria:Organizacja Narodów Zjednoczonych
United Nations Children's Fund	UNICEF
United States	Stany Zjednoczone
United States	Kategoria:Stany Zjednoczone
United States Air Force	United States Air Force
United States Congress	Kongres Stanów Zjednoczonych
United States Constitution	Konstytucja Stanów Zjednoczonych
United States House of Representatives	Izba Reprezentantów Stanów Zjednoczonych
United States Military Academy	West Point
United States Navy	United States Navy
United States Senate	Senat Stanów Zjednoczonych
United States Virgin Islands	Wyspy Dziewicze Stanów Zjednoczonych
United States dollar	Dolar amerykański
Universe	Wszechświat
University	Uniwersytet
University of Chicago	Uniwersytet Chicagowski
University of Pennsylvania	Uniwersytet Pensylwanii
Unix	Unix
Unix	Kategoria:Unix
Ununbium	Ununbium
Ununhexium	Ununhexium
Ununpentium	Ununpentium
Ununquadium	Ununquadium
Ununtrium	Ununtrium
Upanishad	Upaniszady
Uppsala	Uppsala
Upsilon	Ipsylon
Ur	Ur (miasto)
Uracil	Uracyl
Ural Mountains	Ural (góry)
Urania	Urania
Uranium	Uran (pierwiastek)
Uranus	Uran
Uranus	Kategoria:Uran
Uranus (mythology)	Uranos
Urdu	Język urdu
Urea	Mocznik
Urine	Mocz
Ursa Major	Wielka Niedźwiedzica
Ursa Minor	Mała Niedźwiedzica
Uruguay	Urugwaj
Uruguay	Kategoria:Urugwaj
Utah	Utah
Utah	Kategoria:Utah
Uterus	Macica
Utilitarianism	Utylitaryzm
Utopia	Utopia (termin)
Utrecht (city)	Utrecht
Utrecht (province)	Utrecht (prowincja)
Uttar Pradesh	Uttar Pradesh
Uzbekistan	Uzbekistan
Uzbekistan	Kategoria:Uzbekistan
Vaccine	Szczepionka
Vacuole	Wakuola
Vacuum	Próżnia
Vacuum tube	Lampa elektronowa
Vaduz	Vaduz
Vagina	Pochwa (anatomia)
Valence	Valence (Drôme)
Valence (chemistry)	Wartościowość
Valencia	Walencja
Valencia	Walencja (ujednoznacznienie)
Valentina Tereshkova	Walentina Tierieszkowa
Valentine's Day	Walentynki
Valhalla	Walhalla
Valkyrie	Walkirie
Valletta	Valletta
Valley	Dolina
Vampire	Wampir
Vanadium	Wanad
Vancouver	Vancouver (Kolumbia Brytyjska)
Vancouver Island	Vancouver (wyspa)
Vandalism	Wandalizm
Vanir	Wanowie
Vanuatu	Vanuatu
Vanuatu	Kategoria:Vanuatu
Var (department)	Var (departament)
Variance	Wariancja
Varna	Warna
Vascular plant	Rośliny naczyniowe
Vatican City	Watykan
Vatican City	Kategoria:Watykan
Vector (spatial)	Wektor
Vega	Wega
Vegetable	Warzywa
Vegetarianism	Wegetarianizm
Vein	Żyła
Vela (constellation)	Żagiel (gwiazdozbiór)
Velociraptor	Welociraptor
Velocity	Prędkość
Veneto	Wenecja Euganejska
Venezuela	Wenezuela
Venezuela	Kategoria:Wenezuela
Venice	Wenecja
Venus	Wenus
Venus (disambiguation)	Wenus (ujednoznacznienie)
Venus (mythology)	Wenus (bogini)
Verb	Czasownik
Vermont	Vermont
Vermont	Kategoria:Vermont
Verona	Werona
Versailles	Wersal
Vertebra	Kręg
Vertebral column	Kręgosłup
Vertebrate	Kręgowce
Vespasian	Wespazjan
Vesta (mythology)	Westa
Veto	Weto
Vice President of the United States	Wiceprezydenci Stanów Zjednoczonych
Vichy	Vichy
Victor Hugo	Victor Hugo
Victoria	Victoria (Seszele)
Victoria	Victoria (Kolumbia Brytyjska)
Victoria	Wiktoria
Victoria (Australia)	Wiktoria (stan Australii)
Victoria Falls	Wodospady Wiktorii
Video game	Gry komputerowe i wideo
Vienna	Wiedeń
Vienna	Kategoria:Wiedeń
Vienne	Vienne (departament)
Vientiane	Wientian
Vietnam	Wietnam
Vietnam	Kategoria:Wietnam
Vietnam War	Wojna wietnamska
Viking	Wikingowie
Vilfredo Pareto	Vilfredo Pareto
Village	Wieś
Vilnius	Wilno
Vincent van Gogh	Vincent van Gogh
Vincenzo Bellini	Vincenzo Bellini
Vinegar	Ocet
Viola	Altówka
Violence	Przemoc
Violin	Skrzypce
Virgil	Wergiliusz
Virgin Islands	Wyspy Dziewicze
Virginia	Wirginia
Virginia	Kategoria:Wirginia
Virginia Woolf	Virginia Woolf
Virginity	Dziewictwo
Virgo (constellation)	Panna (gwiazdozbiór)
Virtual memory	Pamięć wirtualna
Virtual reality	Rzeczywistość wirtualna
Virtue	Cnota
Virus	Wirusy
Viscosity	Lepkość
Vishnu	Wisznu
Vistula	Wisła
Vitamin	Witaminy
Vitamin A	Witamina A
Vitamin B6	Witamina B6
Vitamin D	Witamina D
Vitamin K	Witamina K
Vittorio De Sica	Vittorio De Sica
Vitus Bering	Vitus Bering
Vivien Leigh	Vivien Leigh
Vladimir Lenin	Włodzimierz Lenin
Vladimir Nabokov	Władimir Nabokow
Vladimir Putin	Władimir Putin
Vladivostok	Władywostok
Vocative case	Wołacz
Vodka	Wódka
Volans	Ryba Latająca (gwiazdozbiór)
Volcano	Wulkan
Volcanology	Kategoria:Wulkanizm
Volcanology	Wulkanologia
Volga River	Wołga
Volgograd	Wołgograd
Volleyball	Piłka siatkowa
Volleyball	Kategoria:Piłka siatkowa
Volt	Wolt
Voltage	Napięcie elektryczne
Voltaire	Voltaire
Volume	Objętość (matematyka)
Vomiting	Wymioty
Voodoo	Voodoo
Vowel	Samogłoska
Vulcan (mythology)	Wulkan (bóg)
Vulgate	Wulgata
Vulpecula	Lisek (gwiazdozbiór)
Vulva	Srom
W	W
W. Somerset Maugham	William Somerset Maugham
WYSIWYG	WYSIWYG
Wahhabism	Wahhabizm
Wake Island	Wake
Wales	Walia
Wales	Kategoria:Walia
Walnut	Orzech (roślina)
Walrus	Mors
Walt Disney	Walt Disney
Walt Whitman	Walt Whitman
Walter Gropius	Walter Gropius
Walter Scott	Walter Scott
War	Wojna
War	Kategoria:Wojny
War crime	Zbrodnie wojenne
War of the Spanish Succession	Wojna o sukcesję hiszpańską
Wars of the Roses	Wojna Dwóch Róż
Warsaw	Warszawa
Wart	Brodawka
Washing machine	Pralka
Washington	Waszyngton
Washington	Waszyngton (stan w USA)
Washington	Kategoria:Waszyngton (stan)
Washington (disambiguation)	Waszyngton (ujednoznacznienie)
Wassily Kandinsky	Wasilij Kandinskij
Waste	Odpady
Water	Woda
Water	Kategoria:Woda
Water polo	Piłka wodna
Waterfall	Wodospad
Watergate scandal	Afera Watergate
Watermelon	Kawon
Watt	Wat
Watt-hour	Kilowatogodzina
Wave	Fala
Wavelength	Długość fali
Wax	Woski
Weak interaction	Oddziaływanie słabe
Weapon	Broń
Weather	Pogoda
Web browser	Przeglądarka internetowa
Web page	Strona internetowa
Webcam	Kamera internetowa
Weber (unit)	Weber (jednostka)
Website	Serwis internetowy
Wednesday	Środa
Week	Tydzień
Weight	Ciężar
Weightlifting	Podnoszenie ciężarów
Weimar	Weimar
Weimar Republic	Republika Weimarska
Welding	Połączenia spawane
Wellington	Wellington (Nowa Zelandia)
Werewolf	Wilkołak
Wernher von Braun	Wernher von Braun
Weser River	Wezera
West	Zachód (kierunek)
West Africa	Afryka Zachodnia
West Bank	Zachodni Brzeg
West Bengal	Bengal Zachodni
West Berlin	Berlin Zachodni
West Sussex	West Sussex
West Virginia	Wirginia Zachodnia
West Virginia	Kategoria:Wirginia Zachodnia
Western Australia	Australia Zachodnia
Western Roman Empire	Cesarstwo zachodniorzymskie
Western Sahara	Sahara Zachodnia
Western Sahara	Kategoria:Sahara Zachodnia
Westminster Abbey	Opactwo Westminsterskie
Whale	Wieloryb
Wheat	Pszenica
Wheel	Koło (technika)
Whisky	Whisky
White House	Biały Dom
White Sea	Morze Białe
White blood cell	Leukocyt
White dwarf	Biały karzeł
Whitehorse	Whitehorse
Wicca	Wicca
Wide area network	Sieć rozległa
Wiesbaden	Wiesbaden
Wildcat	Żbik
Wilhelm Ostwald	Wilhelm Ostwald
Will (law)	Testament
William Blake	William Blake
William Butler Yeats	William Butler Yeats
William Faulkner	William Faulkner
William Gladstone	William Ewart Gladstone
William Golding	William Golding
William Harvey	William Harvey
William Henry Harrison	William Henry Harrison
William Herschel	William Herschel
William Howard Taft	William H. Taft
William I	Wilhelm I Hohenzollern
William II	Wilhelm II Hohenzollern
William James	William James
William McKinley	William McKinley
William Rowan Hamilton	William Rowan Hamilton
William Shakespeare	William Szekspir
William Shockley	William Shockley
William Wordsworth	William Wordsworth
William of Ockham	William Ockham
Willow	Wierzba
Willy Brandt	Willy Brandt
Wind instrument	Instrument dęty
Wind power	Energia wiatru
Windhoek	Windhuk
Windmill	Wiatrak
Window	Okno
Wine	Wino
Winnipeg	Winnipeg
Winston Churchill	Winston Churchill
Winter	Zima
Winter Olympic Games	Zimowe igrzyska olimpijskie
Winter Olympic Games	Kategoria:Zimowe igrzyska olimpijskie
Wisconsin	Wisconsin
Wisconsin	Kategoria:Wisconsin
Wolfgang Amadeus Mozart	Wolfgang Amadeusz Mozart
Wolfgang Pauli	Wolfgang Pauli
Woman	Kobieta
Wood	Drewno (technika)
Woodrow Wilson	Woodrow Wilson
Woodwind instrument	Instrument dęty drewniany
Woody Allen	Woody Allen
Worcestershire	Worcestershire
Word	Wyraz
Word processor	Procesor tekstu
World	Świat
World Bank	Bank Światowy
World Health Organization	Światowa Organizacja Zdrowia
World Meteorological Organization	Światowa Organizacja Meteorologiczna
World Trade Center	World Trade Center
World Trade Organization	Światowa Organizacja Handlu
World War I	I wojna światowa
World War I	Kategoria:I wojna światowa
World War II	II wojna światowa
World War II	Kategoria:II wojna światowa
World Wide Web	World Wide Web
World Wide Web	Kategoria:World Wide Web
Worm	Robaki
Wormhole	Tunel czasoprzestrzenny
Writer	Pisarz
Writing system	Pismo
Wuhan	Wuhan
Wyoming	Wyoming
Wyoming	Kategoria:Wyoming
X-ray	Promieniowanie rentgenowskie
Xenarthra	Szczerbaki
Xenon	Ksenon
Xenophanes	Ksenofanes
Xenophobia	Ksenofobia
Xenophon	Ksenofont
Xi	Ksi
Xinjiang	Sinkiang
Xylophone	Ksylofon
Y	Y
Yahweh	Jahwe
Yak	Jak
Yakuza	Yakuza
Yale University	Uniwersytet Yale'a
Yalta	Jałta
Yalta Conference	Konferencja jałtańska
Yangon	Rangun
Yangtze River	Jangcy
Yard	Jard
Yasser Arafat	Jaser Arafat
Year	Rok
Yeast	Drożdże
Yellow	Barwa żółta
Yellow River	Huang He
Yellow Sea	Morze Żółte
Yellowstone National Park	Park Narodowy Yellowstone
Yemen	Jemen
Yemen	Kategoria:Jemen
Yenisei River	Jenisej
Yerevan	Erywań
Yeti	Yeti
Yggdrasil	Yggdrasil
Yo-yo	Jojo (zabawka)
Yoga	Joga
Yoghurt	Jogurt
Yoko Ono	Yoko Ono
Yokohama	Jokohama
Yom Kippur	Jom Kippur
Yom Kippur War	Wojna Jom Kippur
York	York
Yosemite National Park	Park Narodowy Yosemite
Young's modulus	Moduł Younga
Ytterbium	Iterb
Yttrium	Itr
Yuan Dynasty	Dynastia Yuan
Yugoslavia	Jugosławia
Yugoslavia	Kategoria:Jugosławia
Yukon	Jukon (terytorium Kanady)
Yunnan	Junnan
Yuri Gagarin	Jurij Gagarin
Z	Z
Zachary Taylor	Zachary Taylor
Zagreb	Zagrzeb
Zambezi	Zambezi
Zambia	Zambia
Zambia	Kategoria:Zambia
Zanzibar	Zanzibar
Zaragoza	Saragossa
Zealand	Zelandia (wyspa)
Zen	Zen
Zenith	Zenit (astronomia)
Zeno (emperor)	Zenon Izauryjczyk
Zeno of Citium	Zenon z Kition
Zeno of Elea	Zenon z Elei
Zeta	Dzeta
Zeus	Zeus
Zeus (disambiguation)	Zeus
Ziggurat	Ziggurat
Zimbabwe	Zimbabwe
Zimbabwe	Kategoria:Zimbabwe
Zinc	Cynk
Zionism	Syjonizm
Zirconium	Cyrkon (pierwiastek)
Zodiac	Zodiak
Zombie	Zombie
Zoo	Ogród zoologiczny
Zoology	Zoologia
Zoology	Kategoria:Zoologia
Zoroaster	Zaratusztra
Zoroastrianism	Zaratusztrianizm
Zulu	Zulusi
