English	Danish
0 (number)	0 (tal)
1	1
1 (number)	1 (tal)
10	10
10 (number)	10 (tal)
100	100
100 (number)	100 (tal)
1000	1000
1000 (number)	Tusind
101	101
105	105
11	11
11 (number)	11 (tal)
110	110
115	115
12	12
12 (number)	12 (tal)
120	120
125	125
13	13
13 (number)	13 (tal)
130	130
135	135
14	14
14	Kategori:14
14 (number)	14 (tal)
140	140
144	144
145	145
15	15
15 (number)	15 (tal)
150	150
1530s	1530'erne
155	155
16	16
16 (number)	16 (tal)
160	160
165	165
17	17
17	Kategori:17
17 (number)	17 (tal)
170	170
1728	1728
1728	Kategori:1728
175	175
1750s	1750'erne
1760s	1760'erne
1770s	1770'erne
1780s	1780'erne
1790s	1790'erne
18	18
18 (number)	18 (tal)
180	180
1820s	1820'erne
1830s	1830'erne
1840s	1840'erne
1850s	1850'erne
1860s	1860'erne
1870s	1870'erne
1880s	1880'erne
1890s	1890'erne
19	19
19 (number)	19 (tal)
190	190
1900s	1900'erne
1920s	1920'erne
1930s	1930'erne
1940s	1940'erne
1950s	1950'erne
1960s	1960'erne
1970s	1970'erne
1980s	1980'erne
1990s	1990'erne
2	2
2 (number)	2 (tal)
20	20
20 (number)	20 (tal)
200	200
21	21
21 (number)	21 (tal)
22	22
22 (number)	22 (tal)
23	23
23 (number)	23 (tal)
24	24
24 (TV series)	24 Timer
24 (number)	24 (tal)
25	25
25 (number)	25 (tal)
26	26
26 (number)	26 (tal)
27	27
27 (number)	27 (tal)
28	28
28 (number)	28 (tal)
29	29
29 (number)	29 (tal)
3	3
3 (number)	3 (tal)
30	30
30 (number)	30 (tal)
300	300
31	31
31 (number)	31 (tal)
32	32
32 (number)	32 (tal)
33	33
33 (number)	33 (tal)
34	34
34 (number)	34 (tal)
35	35
35 (number)	35 (tal)
36	36
36 (number)	36 (tal)
37	37
37 (number)	37 (tal)
38	38
38 (number)	38 (tal)
39	39
4	4
4 (number)	4 (tal)
40	40
40 (number)	40 (tal)
400	400
41	41
41 (number)	41 (tal)
42	42
42 (number)	42 (tal)
43	43
44	44
45	45
46	46
47	47
48	48
49	49
5	5
5 (number)	5 (tal)
50	50
50 (number)	50 (tal)
500	500
500	Kategori:500
51	51
52	52
53	53
54	54
55	55
56	56
57	57
58	58
59	59
6	6
6 (number)	6 (tal)
60	60
60 (number)	60 (tal)
61	61
62	62
63	63
64	64
65	65
66	66
67	67
68	68
69	69
7	7
7 (number)	7 (tal)
70	70
71	71
72	72
73	73
74	74
75	75
76	76
77	77
78	78
79	79
8	8
8 (number)	8 (tal)
80	80
80 (number)	80 (tal)
81	81
82	82
83	83
84	84
85	85
86	86
87	87
88	88
89	89
9	9
9 (number)	9 (tal)
90	90
91	91
92	92
93	93
94	94
95	95
96	96
97	97
98	98
99	99
A	A
ABC	ABC
AIDS	Aids
ALGOL	ALGOL
ATP	ATP
AZ (football club)	AZ Alkmaar
Aachen	Aachen
Aalborg	Aalborg
Aar	Aare
Aardvark	Jordsvin
Aarhus	Århus
Aaron	Aron
Abacus	Abacus (regnemaskine)
Abadan	Abadan
Abbot	Abbed
Abbreviation	Forkortelse
Abdomen	Bughule
Abel Tasman	Abel Tasman
Abelian group	Abelsk gruppe
Aberdeen	Aberdeen
Abidjan	Abidjan
Abkhazia	Abkhasien
Abolitionism	Abolitionist
Abortion	Provokeret abort
Abraham	Abraham
Abraham Lincoln	Abraham Lincoln
Absinthe	Absint
Absolute magnitude	Absolut størrelsesklasse
Absolute zero	Absolut nulpunkt
Absolutism (European history)	Enevælde
Abstract art	Abstrakt kunst
Abstraction	Abstraktion
Abu Dhabi	Abu Dhabi
Abu Dhabi (emirate)	Abu Dhabi
Abuja	Abuja
Acacia	Akacie
Academy Award	Oscaruddelingen
Acapulco	Acapulco
Acceleration	Acceleration
Accipitridae	Accipitridae
Accordion	Harmonika
Accountancy	Regnskab
Accountancy	Kategori:Regnskabsvæsen
Accra	Accra
Accusative case	Akkusativ
Acetaldehyde	Ethanal
Acetic acid	Eddikesyre
Acetone	Acetone
Acetylene	Acetylen
Achillea millefolium	Almindelig Røllike
Achilles	Achilleus
Acid	Syre
Acid rain	Sur nedbør
Acne vulgaris	Akne
Aconcagua	Aconcagua
Acorn	Agern
Acoustics	Akustik
Acoustics	Kategori:Akustik
Acre	Acre (arealenhed)
Acre	Akko
Acropolis	Akropolis
Actinide	Actinid
Actinium	Actinium
Actor	Skuespiller
Acts of the Apostles	Apostlenes Gerninger
Acupuncture	Akupunktur
Ada (programming language)	Ada (programmeringssprog)
Adam	Adam (bibelsk person)
Adam Smith	Adam Smith
Adana	Adana
Adansonia	Baobab
Addis Ababa	Addis Ababa
Addition	Addition
Adelaide	Adelaide (Australien)
Aden	Aden
Adenine	Adenin
Adenosine triphosphate	Adenosintrifosfat
Adiabatic process	Adiabatisk proces
Adige	Adige
Adjective	Tillægsord
Admiral	Admiral (søofficer)
Adolf Eichmann	Adolf Eichmann
Adolf Hitler	Adolf Hitler
Adonis	Adonis
Adoption	Adoption
Adrenal gland	Binyre
Adriatic Sea	Adriaterhavet
Adsorption	Adsorption
Adult	Voksen
Advent	Advent
Adverb	Biord
Advertising	Reklame
Aegean Sea	Ægæiske Hav
Aeneas	Æneas
Aeneid	Æneiden
Aeolus	Aiolos
Aerodynamics	Aerodynamik
Aerosol	Aerosol
Aeschylus	Aischylos
Aesop	Æsop
Aesthetics	Æstetik
Afghanistan	Afghanistan
Afghanistan	Kategori:Afghanistan
Africa	Afrika
Africa	Kategori:Afrika
African American	Afroamerikaner
Afrikaans	Afrikaans
Agamemnon	Agamemnon
Agar	Agar
Agate	Agat
Agatha Christie	Agatha Christie
Agnosticism	Agnosticisme
Agoraphobia	Agorafobi
Agra	Agra
Agriculture	Landbrug
Agriculture	Kategori:Jordbrug
Agrigento	Agrigento (by)
Aikido	Aikido
Ain	Ain (departement)
Air force	Luftvåben
Airbus	Airbus
Aircraft	Luftfartøj
Aircraft	Kategori:Luftfartøjer
Aircraft carrier	Hangarskib
Airline	Flyselskab
Airport	Lufthavn
Ajax	Ajax (flertydig)
Ajax (mythology)	Ajax
Ajax (programming)	Ajax (programmering)
Akhenaten	Akhnaton
Akira Kurosawa	Akira Kurosawa
Al Capone	Al Capone
Al Gore	Al Gore
Al-Qaeda	Al-Qaida
Alabama	Alabama
Alabama	Kategori:Alabama
Alan Shepard	Alan B. Shepard
Alan Turing	Alan Turing
Alanine	Alanin
Alaska	Alaska
Alaska	Kategori:Alaska
Alban Berg	Alban Berg
Albania	Albanien
Albania	Kategori:Albanien
Albany	Albany (New York)
Albatross	Albatrosser
Albedo	Albedo
Albert Abraham Michelson	Albert Abraham Michelson
Albert Camus	Albert Camus
Albert Einstein	Albert Einstein
Albert Schweitzer	Albert Schweitzer
Albert Speer	Albert Speer
Alberta	Alberta
Albinism	Albinisme
Album	Album
Albuquerque	Albuquerque
Alchemy	Alkymi
Alcohol	Alkohol (stofklasse)
Alcoholic beverage	Alkoholiske drikkevarer
Alcoholism	Alkoholisme
Aldehyde	Aldehyd
Alder	Elleslægten
Aldous Huxley	Aldous Huxley
Alec Guinness	Alec Guinness
Aleksandr Solzhenitsyn	Aleksandr Isajevitj Solsjenitsyn
Aleppo	Aleppo
Aleutian Islands	Aleuterne
Alexander	Alexander
Alexander Fleming	Alexander Fleming
Alexander Graham Bell	Alexander Graham Bell
Alexander Hamilton	Alexander Hamilton
Alexander Pope	Alexander Pope
Alexander Pushkin	Aleksandr Sergejevitj Pusjkin
Alexander the Great	Alexander den Store
Alexandre Dumas	Alexandre Dumas, den ældre
Alexandre Dumas	Alexandre Dumas, den yngre
Alexandria	Alexandria
Alexis de Tocqueville	Alexis de Tocqueville
Alfred Dreyfus	Alfred Dreyfus
Alfred Hitchcock	Alfred Hitchcock
Alfred Nobel	Alfred Nobel
Alfred North Whitehead	Alfred North Whitehead
Algae	Alge
Algebra	Algebra
Algebra	Kategori:Algebra
Algebraic number	Algebraiske tal
Algeria	Algeriet
Algeria	Kategori:Algeriet
Algiers	Algier
Algorithm	Algoritme
Alhambra	Alhambra
Ali	Ali
Alkali metal	Alkalimetal
Alkaloid	Alkaloid
Alkane	Alkan
Alkene	Alken
Alkyne	Alkyn
Allah	Allah
Allegory	Allegori
Allele	Allel
Allen Ginsberg	Allen Ginsberg
Allergy	Allergi
Allophone	Allofon
Allosaurus	Allosaurus
Alloy	Legering
Almanac	Almanak
Almaty	Almaty
Almond	Mandel
Aloe	Aloe
Alpha (letter)	Alfa (bogstav)
Alpha particle	Alfastråling
Alphabet	Alfabet
Alps	Alperne
Alps	Kategori:Alperne
Alsace	Alsace
Altar	Alter
Altay Mountains	Altai
Alternating current	Vekselstrøm
Alternative medicine	Kategori:Alternativ behandling
Alternative medicine	Alternativ behandling
Altruism	Altruisme
Aluminium	Aluminium
Aluminium oxide	Aluminiumoxid
Alvar Aalto	Alvar Aalto
Alzheimer's disease	Alzheimers sygdom
Amaryllidaceae	Påskelilje-familien
Amaterasu	Amaterasu
Amazon River	Amazonfloden
Ambassador	Ambassadør
Amber	Rav
Ambrose	Skt. Ambrosius
Amedeo Avogadro	Amedeo Avogadro
Amelia Earhart	Amelia Earhart
American Bison	Amerikansk bison
American Black Bear	Amerikansk sortbjørn
American Civil War	Den amerikanske borgerkrig
American Revolutionary War	USA's uafhængighedskrig
American Samoa	Amerikansk Samoa
American Standard Code for Information Interchange	ASCII
American football	Amerikansk fodbold
American football	Kategori:Amerikansk fodbold
Americium	Americium
Amerigo Vespucci	Amerigo Vespucci
Amethyst	Ametyst
Amharic	Amharisk
Amide	Amid (funktionel gruppe)
Amino acid	Aminosyre
Amish	Amish
Amman	Amman
Ammeter	Amperemeter
Ammonia	Ammoniak
Amnesia	Amnesi
Amnesty	Amnesti
Ampere	Ampere
Amphetamine	Amfetamin
Amphibian	Padde
Amphitheatre	Amfiteater
Amphora	Amfora
Amplitude	Amplitude
Amsterdam	Amsterdam
Amsterdam	Kategori:Amsterdam
Amun	Amon
Amur	Amur
Anabaptist	Gendøber
Anagram	Anagram
Anaheim	Anaheim
Anal sex	Analsex
Anarchism	Anarkisme
Anarchism	Kategori:Anarkisme
Anarchy	Anarki
Anatidae	Egentlige andefugle
Anatomy	Kategori:Anatomi
Anatomy	Anatomi
Anaxagoras	Anaxagoras
Anaximander	Anaximander
Anchor	Anker (søfart)
Anchorage	Anchorage
Ancient Greek	Oldgræsk
Ancient history	Kategori:Antikken
Andalusia	Andalusien
Andaman Sea	Andamanhavet
Anders Celsius	Anders Celsius
Andes	Andesbjergene
Andhra Pradesh	Andhra Pradesh
Andorra	Andorra
Andorra	Kategori:Andorra
Andrea Palladio	Andrea Palladio
Andrei Sakharov	Andrej Sakharov
Andrei Tarkovsky	Andrej Tarkovskij
Andrew Jackson	Andrew Jackson
Andrew Johnson	Andrew Johnson
Andrew Lloyd Webber	Andrew Lloyd Webber
Andromeda	Andromeda
Andromeda (constellation)	Andromeda (stjernebillede)
Andromeda (mythology)	Andromeda (mytologi)
Andromeda Galaxy	Andromedagalaksen
Andy Warhol	Andy Warhol
Anemia	Anæmi
Anemometer	Anemometer
Anesthesia	Anæstesi
Angel	Engel
Angel Falls	Salto del Angel
Angle	Vinkel
Angola	Angola
Angola	Kategori:Angola
Anguilla	Anguilla (land)
Angular momentum	Impulsmoment
Angular velocity	Vinkelhastighed
Anicius Manlius Severinus Boethius	Anicius Manlius Severinus Boëthius
Aniline	Anilin
Animal	Dyr
Animation	Animation
Anime	Anime
Anime	Kategori:Anime
Animism	Animisme
Anise	Anis
Ankara	Ankara
Annapolis	Annapolis
Annapurna	Annapurna (bjerg)
Anne Boleyn	Anne Boleyn
Annelid	Ledorme
Anno Domini	Anno Domini
Anode	Anode
Anorexia nervosa	Anoreksi
Anseriformes	Andefugle
Anseriformes	Kategori:Andefugle
Ant	Myre
Antakya	Antiokia
Antalya	Antalya
Antananarivo	Antananarivo
Antarctica	Antarktis
Antarctica	Kategori:Antarktis
Antares	Antares
Antenna (radio)	Radioantenne
Anthony Hopkins	Anthony Hopkins
Anthrax	Miltbrand
Anthropology	Antropologi
Anthropology	Kategori:Antropologi
Anthroposophy	Antroposofi
Antibiotic	Antibiotikum
Antibody	Antistof (biologi)
Antichrist	Antikrist
Anticyclone	Anticyklon
Antigen	Antigen
Antigua and Barbuda	Antigua og Barbuda
Antigua and Barbuda	Kategori:Antigua og Barbuda
Antimatter	Antistof (fysik)
Antimony	Antimon
Antioxidant	Antioxidant
Antipope	Modpave
Antisemitism	Antisemitisme
Antisemitism	Kategori:Antisemitisme
Antlia	Luftpumpen
Antoine Lavoisier	Antoine Laurent Lavoisier
Anton Bruckner	Anton Bruckner
Anton Chekhov	Anton Tjekhov
Antonio Stradivari	Antonio Stradivari
Antonio Vivaldi	Antonio Vivaldi
Antonym	Antonym
Antwerp	Antwerpen
Anubis	Anubis
Anus	Endetarmsåbningen
Aorta	Aorta
Apache	Apache
Aphrodite	Afrodite
Apiaceae	Skærmplante-familien
Apocrypha	Apokryfe skrifter
Apollo	Apollon
Apollo (disambiguation)	Apollo
Apollo program	Apollo-programmet
Apollo program	Kategori:Apollo-programmet
Apoptosis	Apoptosis
Appalachian Mountains	Appalacherne
Appendicitis	Blindtarmsbetændelse
Apple	Æble (frugt)
Applied mathematics	Anvendt matematik
Apricot	Abrikos (træ)
April	April
April 14	14. april
April Fools' Day	Aprilsnar
Apse	Apsis
Apulia	Apulien
Apus	Paradisfuglen
Aqaba	Akaba
Aqua regia	Kongevand
Aquamarine	Akvamarin
Aquarium	Akvarium
Aquarius (constellation)	Vandmanden (stjernebillede)
Aqueduct	Akvædukt
Aquila (constellation)	Ørnen (stjernebillede)
Aquitaine	Aquitaine
Ara (constellation)	Alteret
Arab	Araber
Arab League	Den Arabiske Liga
Arabian Peninsula	Arabiske Halvø
Arabian Sea	Arabiske Hav
Arabic alphabet	Arabiske alfabet
Arabic language	Arabisk (sprog)
Araceae	Arum-familien
Arachnid	Spindlere
Aragon	Aragonien
Aral Sea	Aralsøen
Aram Khachaturian	Aram Khatjaturian
Arcadia	Arkadien
Arcangelo Corelli	Arcangelo Corelli
Archaeology	Arkæologi
Archaeology	Kategori:Arkæologi
Archaeopteryx	Archaeopteryx
Archangel	Ærkeengel
Archbishop	Ærkebiskop
Archean	Arkæikum
Archetype	Arketype
Archimedes	Arkimedes
Archipelago	Arkipelag
Architect	Arkitekt
Architecture	Arkitektur
Architecture	Kategori:Arkitektur
Arctic	Arktis
Arctic Circle	Nordlige polarcirkel
Arctic Ocean	Ishavet
Arctic fox	Polarræv
Ardennes	Ardennerne
Ardennes (department)	Ardennes
Are	Ar (enhed)
Area	Areal
Arecaceae	Palme-familien
Ares	Ares
Argentina	Argentina
Argentina	Kategori:Argentina
Argon	Argon
Argos	Argos
Aria	Arie
Ariadne	Ariadne
Arianism	Arianisme
Aries (constellation)	Vædderen
Aristarchus of Samos	Aristarchos
Aristocracy	Aristokrati
Aristophanes	Aristofanes
Aristotle	Aristoteles
Arithmetic	Aritmetik
Arithmetic	Kategori:Aritmetik
Arithmetic progression	Differensrække
Arius	Arius
Arizona	Arizona
Arizona	Kategori:Arizona
Ark of the Covenant	Pagtens Ark
Arkansas	Arkansas
Arkansas	Kategori:Arkansas
Arles	Arles
Armadillo	Bæltedyr
Armenia	Armenien
Armenia	Kategori:Armenien
Armenian language	Armensk (sprog)
Armour	Rustning
Army	Hær
Arnhem	Arnhem
Arno River	Arno
Arnold Schoenberg	Arnold Schönberg
Arquebus	Arkebuse
Arras	Arras
Arrow	Pil (våben)
Arsenic	Arsen
Art	Kunst
Art Deco	Art deco
Art Nouveau	Jugendstil
Art history	Kategori:Kunsthistorie
Art history	Kunsthistorie
Artemis	Artemis
Artemisia (plant)	Bynke
Artemisia absinthium	Have-Malurt
Artery	Arterie
Arthritis	Gigt
Arthropod	Leddyr
Arthur Compton	Arthur Compton
Arthur Conan Doyle	Arthur Conan Doyle
Arthur Miller	Arthur Miller
Arthur Rimbaud	Arthur Rimbaud
Arthur Schopenhauer	Arthur Schopenhauer
Arthur Wellesley	Arthur Wellesley
Artificial intelligence	Kunstig intelligens
Artificial intelligence	Kategori:Kunstig intelligens
Artillery	Artilleri
Artist	Kunstner
Arts	Kategori:Kunst
Arturo Toscanini	Arturo Toscanini
Aruba	Aruba
Asbestos	Asbest
Asclepius	Æskulap
Asexuality	Aseksualitet
Asgard	Asgård
Ash Wednesday	Askeonsdag
Asia	Asien
Asia	Kategori:Asien
Asmara	Asmara
Aspartame	Aspartam
Asphalt	Asfalt
Aspirin	Aspirin
Assam	Assam
Assassination	Attentat
Assembly language	Assemblersprog
Association of Southeast Asian Nations	ASEAN
Assyria	Assyrien
Astana	Astana
Astatine	Astat
Asteraceae	Kurvblomstfamilien
Asteroid	Asteroide
Asteroid belt	Asteroidebælte
Asthenosphere	Asthenosfære
Asthma	Astma
Astrakhan	Astrakan
Astrobiology	Liv i rummet
Astrology	Astrologi
Astrology	Kategori:Astrologi
Astronaut	Astronaut
Astronomer	Astronom
Astronomical unit	Astronomisk enhed
Astronomy	Astronomi
Astronomy	Kategori:Astronomi
Astronomy	Portal:Astronomi
Astrophysics	Astrofysik
Astrophysics	Kategori:Astrofysik
Aswan	Aswan
Asymptote	Asymptote
Atacama Desert	Atacamaørkenen
Aten	Aton (gud)
Atheism	Kategori:Ateisme
Athena	Athene
Athens	Athen
Athletics	Kategori:Atletik
Athletics (track and field)	Atletik
Atlanta	Atlanta
Atlantic Ocean	Atlanterhavet
Atlantic Ocean	Kategori:Atlanterhavet
Atlantis	Atlantis
Atlas (disambiguation)	Atlas
Atlas (moon)	Atlas (måne)
Atlas (mythology)	Atlas (mytologi)
Atlas Mountains	Atlasbjergene
Atmosphere	Atmosfære (himmellegeme)
Atmosphere (unit)	Atmosfære (enhed)
Atoll	Atol
Atom	Atom
Atomic clock	Atomur
Atomic mass	Atomvægt
Atomic mass unit	Dalton (kemisk enhed)
Atomic number	Atomnummer
Atomic physics	Kategori:Atomfysik
Atomic physics	Atomfysik
Atreus	Atreus
Atropine	Atropin
Attica	Attika
Attila the Hun	Attila
Au	AU
Auckland	Auckland
Auction	Auktion
August	August
August 1	1. august
August 15	15. august
August 6	6. august
August Strindberg	August Strindberg
Augusta	Augusta (Maine)
Auguste Comte	Auguste Comte
Auguste Rodin	Auguste Rodin
Augustine of Hippo	Augustin
Augustus	Augustus
Auriga (constellation)	Kusken
Aurora	Aurora
Aurora (astronomy)	Polarlys
Austin	Austin (Texas)
Australia	Australien
Australia	Kategori:Australien
Australian dollar	Australske dollar
Australopithecus	Australopithecus
Austria	Østrig
Austria	Kategori:Østrig
Austria-Hungary	Østrig-Ungarn
Author	Forfatter
Authority	Autoritet
Autism	Autisme
Autobiography	Selvbiografi
Automobile	Bil
Autonomic nervous system	Autonome nervesystem
Autotroph	Autotrof
Autumn	Efterår
Auvergne (region)	Auvergne
Avalanche	Lavine
Avant-garde	Avantgarde
Avatar	Avatar
Avena	Havre
Averroes	Averröes
Avesta	Zend Avesta
Aviation	Kategori:Luftfart
Aviation	Luftfart
Avicenna	Avicenna
Avignon	Avignon
Avocado	Avocado
Axe	Økse
Axiom	Aksiom
Axon	Akson
Ayatollah	Ayatollah
Ayn Rand	Ayn Rand
Azerbaijan	Aserbajdsjan
Azerbaijan	Kategori:Aserbajdsjan
Azimuth	Azimut (astronomi)
Azores	Azorerne
Aztec	Azteker
B	B
BASIC	BASIC
Baal	Baal
Baboon	Savannebavianer
Babylon	Babylon
Babylonia	Babylonien
Backgammon	Backgammon
Bacteria	Bakterie
Bacteria	Kategori:Bakterier
Bacteriophage	Bakteriofag
Bactrian Camel	Kamel
Badminton	Badminton
Baffin Bay	Baffinbugten
Baffin Island	Baffin Island
Baghdad	Bagdad
Bahamas	Kategori:Bahamas
Bahrain	Bahrain
Bahrain	Kategori:Bahrain
Baja California	Baja California
Baklava	Baklava
Baku	Baku
Balalaika	Balalajka
Balance sheet	Balance (regnskab)
Baldr	Balder
Balearic Islands	Baleariske Øer
Baleen whale	Bardehvaler
Bali	Bali
Balkan Mountains	Balkanbjergene
Balkans	Balkanhalvøen
Ball	Bold
Ballet	Ballet
Ballet	Kategori:Ballet
Ballistic missile	Ballistisk missil
Ballpoint pen	Kuglepen
Baltic Sea	Østersøen
Baltimore	Baltimore
Bamako	Bamako
Bamboo	Bambus
Banana	Banan
Bangalore	Bangalore
Bangkok	Bangkok
Bangladesh	Bangladesh
Bangladesh	Kategori:Bangladesh
Bangui	Bangui
Banjul	Banjul
Bank	Bank
Banknote	Pengeseddel
Banks	Kategori:Banker
Baptism	Dåb
Baptist	Baptistkirken
Barbados	Barbados
Barbados	Kategori:Barbados
Barbra Streisand	Barbra Streisand
Barcelona	Barcelona
Barcelona	Kategori:Barcelona
Barents Sea	Barentshavet
Bari	Bari
Barium	Barium
Barley	Almindelig Byg
Barn Owl	Slørugle
Barn Swallow	Landsvale
Barometer	Barometer
Baron	Baron
Baroque	Barok
Barrel (unit)	Tønde (rummål)
Basalt	Basalt
Base (chemistry)	Base (kemi)
Baseball	Baseball
Baseball	Kategori:Baseball
Basel	Basel
Basidiomycota	Basidiesvampe
Basil	Basilikum
Basilica	Basilika
Basilicata	Basilicata
Basilisk	Basilisk (mytologi)
Basketball	Basketball
Basketball	Kategori:Basketball
Basra	Basra
Bass guitar	El-bas
Basse-Normandie	Basse-Normandie
Basseterre	Basseterre
Bassoon	Fagot
Bast (mythology)	Bastet
Bastille	Bastillen
Bat	Flagermus
Bath	Bath
Batman	Batman
Baton Rouge	Baton Rouge
Bats	Kategori:Flagermus
Battalion	Bataljon
Battery (electricity)	Batteri (elektricitet)
Battle of Austerlitz	Slaget ved Austerlitz
Battle of Britain	Slaget om England
Battle of Hastings	Slaget ved Hastings
Battle of Lepanto (1571)	Lepanto
Battle of Marathon	Slaget ved Marathon
Battle of Midway	Slaget om Midway
Battle of Thermopylae	Slaget ved Thermopylæ
Battle of Trafalgar	Slaget ved Trafalgar
Battle of Verdun	Slaget ved Verdun
Battle of Waterloo	Slaget ved Waterloo
Battle of the Bulge	Ardenneroffensiven
Battle of the Somme	Slaget ved Somme
Battleship	Slagskib
Bauhaus	Bauhaus
Bauxite	Bauxit
Bavaria	Bayern
Bavaria	Kategori:Bayern
Bay Laurel	Ægte Laurbær
Bay of Bengal	Bengalske Bugt
Bay of Biscay	Biscayabugten
Bayer	Bayer
Bayonet	Bajonet
Beach	Strand
Beagle	Beagle
Beak	Næb
Bear	Bjørne
Beaufort Sea	Beauforthavet
Beaufort scale	Beaufort-skalaen
Beaver	Bæver
Bebop	Bebop
Becquerel	Becquerel
Bed	Seng (møbel)
Bede	Beda
Bedouin	Beduin
Beech	Bøg
Beekeeping	Kategori:Biavl
Beer	Øl
Beer	Kategori:Øl
Beetle	Biller
Behaviorism	Behaviorisme
Beijing	Beijing
Beirut	Beirut
Belarus	Hviderusland
Belarus	Kategori:Hviderusland
Belfast	Belfast
Belgium	Belgien
Belgium	Kategori:Belgien
Belgrade	Beograd
Belisarius	Belisar
Belize	Belize
Belize	Kategori:Belize
Bellerophon	Bellerofon
Belly dance	Mavedans
Belo Horizonte	Belo Horizonte
Beluga	Hvidhval
Benelux	Benelux
Bengal	Bengalen
Benin	Benin
Benin	Kategori:Benin
Benito Mussolini	Benito Mussolini
Benjamin Britten	Benjamin Britten
Benjamin Disraeli	Benjamin Disraeli
Benjamin Franklin	Benjamin Franklin
Benjamin Harrison	Benjamin Harrison
Benny Goodman	Benny Goodman
Beowulf	Beovulf-kvadet
Bergen	Bergen
Bering Sea	Beringshavet
Bering Strait	Beringstrædet
Berkelium	Berkelium
Berkshire	Berkshire, England
Berlin	Berlin
Berlin	Kategori:Berlin
Bermuda	Bermuda
Bermuda	Kategori:Bermuda
Bermuda Triangle	Bermudatrekanten
Bernardo Bertolucci	Bernardo Bertolucci
Berne	Bern
Bernhard Riemann	Bernhard Riemann
Berry	Bær
Bertolt Brecht	Bertolt Brecht
Bertrand Russell	Bertrand Russell
Beryllium	Beryllium
Beta (letter)	Beta
Beta decay	Betahenfald
Betelgeuse	Betelgeuse
Bethlehem	Betlehem
Bette Davis	Bette Davis
Beverly Hills	Beverly Hills
Bhutan	Bhutan
Bhutan	Kategori:Bhutan
Bible	Bibelen
Bible	Kategori:Bibelen
Bibliography	Bibliografi
Bicycle	Cykel
Big Bang	Big Bang
Bihar	Bihar
Bikini	Bikini
Bile	Galde
Bill Clinton	Bill Clinton
Bill Gates	Bill Gates
Billy Wilder	Billy Wilder
Binary star	Dobbeltstjerne
Biochemistry	Biokemi
Biochemistry	Kategori:Biokemi
Biodiversity	Biodiversitet
Biography	Biografi
Biological warfare	Biologiske våben
Biology	Biologi
Biology	Kategori:Biologi
Biomass	Biomasse
Biome	Biom
Biometrics	Biometrisk information
Biopsy	Biopsi
Biosphere	Biosfære
Biotechnology	Bioteknologi
Bipolar disorder	Bipolær affektiv sindslidelse
Birch	Birk
Bird	Fugl
Birmingham	Birmingham (Alabama)
Birth control	Prævention
Bisexuality	Biseksualitet
Bishkek	Bisjkek
Bishop	Biskop
Bishop (chess)	Løber (skak)
Bismarck	Bismarck (North Dakota)
Bismarck (disambiguation)	Bismarck
Bismuth	Bismuth
Bissau	Bissau
Bit	Bit
Bithynia	Bithynien
Bivalvia	Muslinger
Black	Sort
Black Death	Den sorte død
Black Forest	Schwarzwald
Black Kite	Sort glente
Black Sea	Sortehavet
Black body	Sortlegeme
Black hole	Sort hul
Black pepper	Sort Peber
Blackbird	Solsort
Blaise Pascal	Blaise Pascal
Blender (software)	Blender (computerprogram)
Blindness	Blindhed
Blitzkrieg	Blitzkriegdoktrinen
Bloemfontein	Bloemfontein
Blog	Blog
Blood	Blod
Blood plasma	Blodplasma
Blood pressure	Blodtryk
Blood type	Blodtype
Blood vessel	Blodåre
Blue	Blå
Blue Whale	Blåhval
Blues	Blues
Boar	Vildsvin
Board game	Brætspil
Boat	Båd
Bob Dylan	Bob Dylan
Bob Marley	Bob Marley
Bobby Fischer	Bobby Fischer
Bobsleigh	Bobslæde (sportsgren)
Bodhisattva	Bodhisattva
Body mass index	Body Mass Index
Bodybuilding	Bodybuilding
Bohemia	Bøhmen
Bohrium	Bohrium
Boiling point	Kogepunkt
Boise	Boise
Boletus edulis	Karl Johan (svamp)
Bolivia	Bolivia
Bolivia	Kategori:Bolivia
Bollywood	Bollywood
Bologna	Bologna
Bolshevik	Bolsjevik
Bolzano	Bolzano
Bomb	Bombe
Bomber	Bombefly
Bond (finance)	Obligation
Bone	Knogle (anatomi)
Bone marrow	Knoglemarv
Bonn	Bonn
Bonsai	Bonsai
Book	Bog
Book of Esther	Esters Bog
Book of Joshua	Josvabogen
Book of Judges	Dommerbogen
Book of Mormon	Mormons Bog
Book of Numbers	Fjerde Mosebog
Book of Revelation	Johannes' Åbenbaring
Book of Ruth	Ruths bog
Boomerang	Boomerang
Bordeaux	Bordeaux (by)
Boris Pasternak	Boris Pasternak
Boris Spassky	Boris Spasskij
Borneo	Borneo
Boron	Bor (grundstof)
Bosnia and Herzegovina	Bosnien-Hercegovina
Bosnia and Herzegovina	Kategori:Bosnien-Hercegovina
Bosporus	Bosporus
Boston	Boston
Boston Tea Party	Teselskabet i Boston
Bot	Skabelon:Bot
Botanical garden	Botanisk have
Botany	Botanik
Botany	Kategori:Botanik
Botswana	Botswana
Botswana	Kategori:Botswana
Bottle	Flaske
Bottlenose Dolphin	Øresvin
Bourgeoisie	Borgerskab
Bourgogne	Bourgogne
Bouvet Island	Bouvetøen
Bovid	Skedehornede
Bow (weapon)	Bue (våben)
Bowling	Bowling
Boxers	Kategori:Boksere
Boxing	Boksning
Boxing	Kategori:Boksning
Boyle's law	Boyles lov
Bracket	Parentes
Braga	Braga
Brahma	Brahma
Brahmaputra River	Brahmaputra
Braille	Braille-alfabetet
Brain	Hjerne
Brainstorming	Brainstorming
Bram Stoker	Bram Stoker
Brandenburg	Brandenburg
Brass	Messing
Brassicaceae	Korsblomst-familien
Brassiere	Brystholder
Bratislava	Bratislava
Braunschweig	Braunschweig
Brazil	Brasilien
Brazil	Kategori:Brasilien
Brazzaville	Brazzaville
Bread	Brød
Breast	Bryst
Breast cancer	Brystkræft
Bremen (state)	Bremen
Bremerhaven	Bremerhaven
Brescia	Brescia
Brest	Brest
Brest	Brest (Hviderusland)
Brest	Brest (flertydig)
Bretagne	Bretagne
Brick	Mursten
Bridge	Bro (konstruktion)
Bridges	Kategori:Broer
Bridgetown	Bridgetown
Brigade	Brigade
Brighton	Brighton
Brindisi	Brindisi
Brisbane	Brisbane
Bristol	Bristol
British Columbia	Britisk Columbia
British Empire	Britiske Imperium
British Isles	Britiske Øer
British Virgin Islands	Britiske Jomfruøer
British people	Kategori:Briter
Brno	Brno
Broadway (New York City)	Broadway
Broccoli	Broccoli
Bromine	Brom
Bronze	Bronze
Bronze Age	Bronzealder
Brooklyn	Brooklyn
Brooklyn Bridge	Brooklyn Bridge
Brown	Brun
Brown Bear	Brun bjørn
Brownian motion	Brownske bevægelser
Bruce Lee	Bruce Lee
Bruges	Brugge
Brunei	Brunei
Brussels	Bruxelles
Bubonic plague	Byldepest
Bucharest	Bukarest
Buckingham Palace	Buckingham Palace
Buckminster Fuller	Buckminster Fuller
Buckwheat	Almindelig Boghvede
Budapest	Budapest
Buddha	Buddha
Buddhism	Buddhisme
Buddhism	Kategori:Buddhisme
Buddy Holly	Buddy Holly
Buenos Aires	Buenos Aires
Buffalo	Buffalo (New York)
Building	Bygning
Bujumbura	Bujumbura
Bulgaria	Bulgarien
Bulgaria	Kategori:Bulgarien
Bumblebee	Humlebi
Buoyancy	Opdrift (statisk)
Bureaucracy	Bureaukrati
Burgomaster	Borgmester
Burkina Faso	Burkina Faso
Burkina Faso	Kategori:Burkina Faso
Burma	Burma
Burma	Kategori:Burma
Burqa	Burka
Burundi	Kategori:Burundi
Bus	Bus
Bus (computing)	Bus (datakommunikation)
Business	Erhvervsliv
Businesspeople	Kategori:Erhvervsfolk
Buster Keaton	Buster Keaton
Butane	Butan
Butter	Smør
Butterfly	Sommerfugl
Bydgoszcz	Bydgoszcz
Byte	Byte
Byzantine Empire	Kategori:Østromerske Kejserdømme
C	C
C (programming language)	C (programmeringssprog)
C. S. Lewis	C.S. Lewis
CD (disambiguation)	Cd (flertydig)
CHAOS (Linux distribution)	CHAOS
CN Tower	CN Tower
COBOL	COBOL
Cabaret	Kabaret
Cacao	Kakao
Cache	Cache
Cactus	Kaktus-familien
Cadmium	Cadmium
Cadmus	Kadmos
Caelum	Mejslen
Caesium	Cæsium
Caffeine	Koffein
Cairo	Kairo
Cake	Kage
Calabria	Calabrien
Calais	Calais
Calcite	Kalk (mineral)
Calcium	Calcium
Calcium carbonate	Calciumcarbonat
Calcium oxide	Kalciumoxid
Calculator	Lommeregner
Calculus	Infinitesimalregning
Caldera	Caldera
Calendar	Kalender
Caliber	Kaliber
California	Californien
California	Kategori:Californien
Californium	Californium
Caligula	Caligula
Caliph	Kalif
Caliphate	Kalifat
Calligraphy	Kalligrafi
Calliope	Kalliope
Callisto (moon)	Callisto (måne)
Calorie	Kalorie
Calvados	Calvados (departement)
Calvin Coolidge	Calvin Coolidge
Calvinism	Calvinisme
Calypso (mythology)	Kalypso (mytologi)
Cambodia	Cambodja
Cambodia	Kategori:Cambodja
Cambrian	Kambrium
Cambridge	Cambridge
Cambridge (disambiguation)	Cambridge (flertydig)
Camera	Kamera
Cameroon	Cameroun
Cameroon	Kategori:Cameroun
Campania	Campania
Canada	Canada
Canada	Kategori:Canada
Canadian dollar	Canadiske dollar
Canal	Kanal
Canary Islands	Kanariske Øer
Canberra	Canberra
Cancer	Kræft
Cancer (constellation)	Krebsen
Candela	Candela
Canidae	Hundefamilien
Canis Major	Store Hund
Canis Minor	Lille Hund
Cannabis	Cannabis
Cannes	Cannes
Cannibalism	Kannibalisme
Cannon	Kanon (våben)
Canoe	Kano
Canon (company)	Canon
Canopus	Canopus
Cantata	Kantate
Canterbury	Canterbury
Canute the Great	Knud den Store
Capacitance	Kapacitans
Capacitor	Elektrisk kondensator
Cape Canaveral	Cape Canaveral
Cape Horn	Kap Horn
Cape Town	Kapstaden
Cape Verde	Kap Verde
Cape Verde	Kategori:Kap Verde
Cape of Good Hope	Kap Det Gode Håb
Capital	Hovedstad
Capital (economics)	Kapital
Capital punishment	Dødsstraf
Capitalism	Kapitalisme
Cappadocia	Kappadokien
Capricornus	Stenbukken
Caracal	Karakal
Caracas	Caracas
Carambola	Karambol
Carat (mass)	Karat (masseenhed)
Carat (purity)	Karat (masseenhed)
Caravaggio	Michelangelo di Caravaggio
Carbohydrate	Kulhydrat
Carbon	Carbon
Carbon cycle	Kulstofkredsløb
Carbon dioxide	Kuldioxid
Carbon monoxide	Kulilte
Carbonic acid	Kulsyre
Carboniferous	Karbon (geologisk periode)
Carboxylic acid	Carboxylsyre
Carburetor	Karburator
Card game	Kortspil
Cardiff	Cardiff
Cardinal (Catholicism)	Kardinal (katolske kirke)
Cardinal Richelieu	Armand-Jean du Plessis de Richelieu
Cardiology	Kategori:Kardiologi
Caribbean	Caribien
Caribbean	Kategori:Caribien
Caribbean Sea	Caribiske Hav
Caricature	Karikaturtegner
Carina (constellation)	Kølen
Carl David Anderson	Carl David Anderson
Carl Jung	Carl Gustav Jung
Carl Lewis	Carl Lewis
Carl Maria von Weber	Carl Maria von Weber
Carl Orff	Carl Orff
Carnival	Fastelavn
Carnivora	Rovdyr (orden)
Carnivore	Zoofag
Carnivorous plant	Kødædende plante
Carolingian dynasty	Karolingerne
Carolus Linnaeus	Carl von Linné
Carpathian Mountains	Karpaterne
Carrot	Gulerod
Carson City	Carson City
Cartesian coordinate system	Kartesisk koordinatsystem
Carthage	Karthago
Cartography	Kartografi
Cartography	Kategori:Kartografi
Cary Grant	Cary Grant
Caryophyllales	Nellike-ordenen
Casablanca	Casablanca
Casino	Kasino
Caspian Sea	Kaspiske Hav
Cassandra	Kassandra
Cassiopeia (constellation)	Cassiopeia
Caste	Kaste
Castile (historical region)	Kastilien
Castle	Borg
Castling	Rokade
Casus belli	Casus belli
Cat	Kat
Catalonia	Catalonien
Catalysis	Katalysator
Cataphract	Katafrakt
Catfish	Malle
Catharism	Katharisme
Cathedral	Domkirke
Catherine Parr	Catherine Parr
Catherine of Aragon	Katharina af Aragonien
Cathode	Katode
Catholicism	Katolicisme
Cattle	Tamkvæg
Catullus	Gaius Valerius Catullus
Caucasus	Kaukasus
Caucasus	Kategori:Kaukasus
Caucasus Mountains	Kaukasus
Cauliflower	Blomkål
Causality	Kausalitet
Cavalry	Kavaleri
Cave	Hule
Caviar	Kaviar
Cayenne	Cayenne
Cayman Islands	Caymanøerne
Cecil Rhodes	Cecil Rhodes
Cedar	Ceder
Celery	Bladselleri
Celestial equator	Himlens ækvator
Celestial mechanics	Kategori:Himmelmekanik
Celestial mechanics	Himmelmekanik
Celestial sphere	Himmelkuglen
Celibacy	Cølibat
Cell (biology)	Celle (biologi)
Cell membrane	Cellemembran
Cell nucleus	Cellekerne
Cell wall	Cellevæg
Cello	Cello
Cellulose	Cellulose
Celsius	Celsius
Cement	Cement
Cemetery	Kirkegård
Cenozoic	Kænozoikum
Census	Folketælling
Centaur	Kentaur
Centaurus	Kentauren
Central Africa	Centralafrika
Central African Republic	Centralafrikanske Republik
Central African Republic	Kategori:Centralafrikanske Republik
Central America	Mellemamerika
Central America	Kategori:Mellemamerika
Central Intelligence Agency	CIA
Central Park	Central Park
Central Powers	Centralmagterne
Central bank	Centralbank
Central nervous system	Centralnervesystemet
Central processing unit	Central Processing Unit
Centre	Centre
Centriole	Centriole
Century	Århundrede
Cephalopod	Cephalopoda
Cepheus (constellation)	Cepheus
Ceramic	Keramik
Cerberus	Kerberos
Cereal	Korn
Cerebellum	Lillehjerne
Ceres	Ceres
Ceres (dwarf planet)	Ceres (dværgplanet)
Ceres (mythology)	Ceres (gudinde)
Cerium	Cerium
Cesare Borgia	Cesare Borgia
Cetacea	Hvaler
Cetus	Hvalfisken
Chad	Tchad
Chad	Kategori:Tchad
Chaffinch	Bogfinke
Chair	Stol (møbel)
Chamaeleon	Kamæleonen
Champagne (wine)	Champagne
Champagne-Ardenne	Champagne-Ardenne
Channel Tunnel	Eurotunnelen
Chaos (mythology)	Chaos
Charadriiformes	Mågevadefugle-ordenen
Charlemagne	Karl den Store
Charles	Charles, prins af Wales
Charles Baudelaire	Charles Baudelaire
Charles Darwin	Charles Darwin
Charles Dickens	Charles Dickens
Charles Fourier	Charles Fourier
Charles Lindbergh	Charles Lindbergh
Charles Peirce	Charles Sanders Peirce
Charles Thomson Rees Wilson	Charles Thomson Rees Wilson
Charles de Gaulle	Charles de Gaulle
Charles the Bald	Karl den Skaldede
Charleston	Charleston (West Virginia)
Charlie Chaplin	Charlie Chaplin
Charlie Parker	Charlie Parker
Charlotte	Charlotte (North Carolina)
Charmed	Heksene fra Warren Manor
Charon (moon)	Charon (måne)
Charon (mythology)	Charon (mytologi)
Che Guevara	Che Guevara
Chechnya	Tjetjenien
Cheese	Ost
Cheetah	Gepard
Chemical compound	Kemisk forbindelse
Chemical element	Grundstof
Chemical formula	Sumformel
Chemical reaction	Kemisk reaktion
Chemical warfare	Kemiske våben
Chemistry	Kemi
Chemistry	Kategori:Kemi
Chemnitz	Chemnitz
Chemotherapy	Kemoterapi
Chennai	Chennai
Chernobyl	Tjernobyl
Cherry	Kirsebær (frugt)
Chert	Flint
Cherub	Kerub
Chess	Skak
Chess	Kategori:Skak
Chess opening	Åbning (skak)
Chester A. Arthur	Chester A. Arthur
Chestnut	Kastanje
Chewing gum	Tyggegummi
Cheyenne	Cheyenne
Chi (letter)	Chi
Chiang Kai-shek	Chiang Kai-shek
Chicago	Chicago
Chicken	Høns
Chickenpox	Skoldkopper
Chickpea	Kikært
Chihuahua	Chihuahua (delstat)
Child	Barn
Chile	Chile
Chile	Kategori:Chile
Chimera (mythology)	Kimære (uhyre)
Chimpanzee	Chimpanser
China	Kategori:Kina
China	Kina (kulturområde)
Chios	Chios
Chiron	Chiron
Chitin	Kitin
Chlorine	Klor
Chloroform	Kloroform
Chlorophyll	Klorofyl
Chloroplast	Grønkorn
Chocolate	Chokolade
Choir	Kor
Cholera	Kolera
Cholesterol	Kolesterol
Chondrichthyes	Bruskfisk
Chongqing	Chongqing
Chord (music)	Akkord (musik)
Chordate	Chordater
Christchurch	Christchurch
Christiaan Huygens	Christiaan Huygens
Christian Dior	Christian Dior
Christianity	Kristendom
Christianity	Kategori:Kristendom
Christmas	Jul
Christmas	Kategori:Jul
Christmas Eve	Juleaften
Christmas tree	Juletræ
Christopher Columbus	Christoffer Columbus
Christopher Marlowe	Christopher Marlowe
Chromium	Krom
Chromosome	Kromosom
Chuck Berry	Chuck Berry
Church	Kirken
Church (building)	Kirke (bygning)
Church of England	Den anglikanske kirke
Cicero	Marcus Tullius Cicero
Ciconiiformes	Storkefugle
Cider	Cider
Cigarette	Cigaret
Cinderella	Askepot
Cinnabar	Cinnober
Cinnamon	Kanel
Circe	Kirke (græsk mytologi)
Circinus	Passeren
Circle	Cirkel
Circulatory system	Blodkredsløbet
Circumcision	Omskæring
Circus	Cirkus
Cirrhosis	Skrumpelever
Citizenship	Statsborgerskab
Citric acid	Citronsyre
Citric acid cycle	Citronsyrecyklus
Citrus	Citrus
City-state	Bystat
Civil war	Borgerkrig
Civilization	Civilisation
Civilization (computer game)	Civilization
Clarinet	Klarinet
Clark Gable	Clark Gable
Class	Klasse
Class (biology)	Klasse (biologi)
Class (computer science)	Klasse (datalogi)
Classical mechanics	Klassisk mekanik
Classical music	Klassisk musik
Classical music	Kategori:Klassisk musik
Classicism	Klassicismen
Claude Monet	Claude Monet
Claudio Monteverdi	Claudio Monteverdi
Claudius	Claudius
Clavicle	Clavicula
Clay	Ler
Clef	Nøgle (musik)
Clement Attlee	Clement Attlee
Clergy	Gejstlighed
Cleveland	Cleveland
Climate	Klima
Climate	Kategori:Klima
Climate change	Klimaændring
Climatology	Klimatologi
Climatology	Kategori:Klimatologi
Clinical depression	Depression
Clitoris	Klitoris
Clock	Ur (kronometer)
Clock Tower	Big Ben
Cloning	Kloning
Clothing	Kategori:Beklædning
Clothing	Tøj
Cloud	Sky (meteorologi)
Clover	Kløver
Clovis I	Klodevig 1.
Cnidaria	Nældecelledyr
Coal	Kul (bjergart)
Coast	Kyst
Coat of arms	Våben (heraldisk)
Cobalt	Kobolt
Cocaine	Kokain
Coccinellidae	Mariehøne
Cockatoo	Kakadue
Cockroach	Kakerlak
Coconut	Kokos
Cocos (Keeling) Islands	Cocosøerne
Codeine	Kodein
Coffea	Kaffe-slægten
Coffee	Kaffe
Coffee	Kategori:Kaffe
Cognac (drink)	Cognac
Cognitive psychology	Kognitionspsykologi
Coin	Mønt
Cola	Cola
Cold War	Den kolde krig
Cold War	Kategori:Den kolde krig
Colin Powell	Colin Powell
Collage	Collage
Collagen	Kollagen
Colloid	Kolloid
Cologne	Köln
Colombia	Colombia
Colombia	Kategori:Colombia
Colombo	Colombo
Colonel	Oberst
Colony	Koloni (magtområde)
Color	Farve
Color blindness	Farveblindhed
Colorado	Colorado
Colorado	Kategori:Colorado
Colorado River	Colorado River
Colosseum	Colosseum
Colossus of Rhodes	Kolossen på Rhodos
Columba (constellation)	Duen
Columbia	Columbia (South Carolina)
Columbia	Columbia
Columbia University	Columbia University
Columbidae	Due
Columbiformes	Kategori:Duefugle
Columbus	Columbus (Ohio)
Columbus	Columbus
Coma	Koma
Coma Berenices	Berenikes Lokker
Combustion	Forbrænding
Comedy	Komedie
Comet	Komet
Comma (punctuation)	Komma
Commedia dell'arte	Commedia dell'arte
Common cold	Forkølelse
Commonwealth of Independent States	SNG
Commonwealth of Nations	Commonwealth of Nations
Communication	Kategori:Kommunikation
Communication	Kommunikation
Communism	Kommunisme
Communism	Kategori:Kommunisme
Comoros	Comorerne
Comoros	Kategori:Comorerne
Compact Disc	Cd
Company (military unit)	Kompagni (militær enhed)
Compass	Kompas
Compass (drafting)	Passer
Competition	Konkurrence
Compiler	Compiler
Complex instruction set computer	CISC
Complex number	Komplekse tal
Composer	Komponist
Composite material	Komposit
Computational linguistics	Datalingvistik
Computer	Computer
Computer display	Skærm (monitor)
Computer file	Fil (dataobjekt)
Computer hardware	Hardware
Computer hardware	Kategori:Computerhardware
Computer network	Datanet
Computer programming	Computerprogrammering
Computer programming	Kategori:Programmering
Computer science	Datalogi
Computer science	Kategori:Datalogi
Computer software	Computerprogram
Computer virus	Computervirus
Computer-aided design	Computer aided design
Computing	Kategori:Datalogi
Conakry	Conakry
Concerto	Koncert (komposition)
Concord	Concord
Concrete	Beton
Condom	Kondom
Cone (geometry)	Kegle (geometri)
Confederate States of America	Amerikas Konfødererede Stater
Confederation	Konføderation
Confession	Konfession
Confirmation	Konfirmation
Conflict	Konflikt
Confucianism	Konfucianisme
Confucius	Konfutse
Congo	Congo
Congo River	Congofloden
Conic section	Keglesnit
Connecticut	Connecticut
Connecticut	Kategori:Connecticut
Connective tissue	Bindevæv
Conquistador	Conquistador
Consensus	Konsensus
Conservation of energy	Termodynamikkens 1. lov
Conservatism	Konservatisme
Consonant	Konsonant
Constantine I	Konstantin den Store
Constellation	Stjernebillede
Constitution (political)	Forfatning
Consul	Consul
Consumption (economics)	Forbrug (økologi)
Contact lens	Kontaktlinse
Continent	Verdensdel
Continental drift	Kontinentaldrift
Continental shelf	Kontinentalsokkel
Contract bridge	Bridge
Convection	Konvektion
Cooking	Madlavning
Coordinate system	Koordinatsystem
Coordinated Universal Time	UTC
Copenhagen	København
Copper	Kobber
Copyright	Ophavsret
Coraciiformes	Skrigefugle
Coral	Koral (dyr)
Coral reef	Koralrev
Corinth	Korinth
Coriolis effect	Corioliseffekten
Cork (city)	Cork
Cormorant	Skarver
Cornwall	Cornwall
Corona Borealis	Nordlige Krone
Corrosion	Korrosion
Corsica	Korsika
Corundum	Korund
Corvette	Korvet
Corvidae	Kragefugle
Corvus (constellation)	Ravnen (stjernebillede)
Cosmic microwave background radiation	Kosmisk baggrundsstråling
Cosmic ray	Kosmisk stråling
Cosmology	Kosmologi (astronomi)
Cosmology	Kategori:Kosmologi
Costa Rica	Costa Rica
Costa Rica	Kategori:Costa Rica
Cotonou	Cotonou
Cotton	Bomuld
Cougar	Puma
Coulomb	Coulomb
Council of Ephesus	Koncilet i Efesus
Council of Trent	Tridentinerkoncilet
Country music	Country
Court	Domstol
Covalent bond	Kovalent binding
Coventry	Coventry
Coyote	Prærieulv
Crab	Krabbe
Crab Nebula	Krabbetågen
Crane (bird)	Traner
Crater (constellation)	Bægeret
Creationism	Kreationisme
Cretaceous	Kridt (geologisk periode)
Crete	Kreta
Cricket	Kricket
Crime	Kriminalitet
Crimea	Krim
Crimean War	Krimkrigen
Criminology	Kriminologi
Croatia	Kroatien
Croatia	Kategori:Kroatien
Crocodile	Krokodille
Cronus	Kronos
Cross	Kors
Cross product	Krydsprodukt
Crossbow	Armbrøst
Crossword	Krydsordsopgave
Crucifixion	Korsfæstelse
Cruiser	Krydser
Crustacean	Krebsdyr
Crux	Sydkorset
Cryptography	Kryptografi
Cryptography	Kategori:Kryptologi
Crystal	Krystal
Crystallography	Krystallografi
Ctenophore	Ribbegople
Cuba	Cuba
Cuba	Kategori:Cuba
Cube	Terning
Cubism	Kubisme
Cucumber	Almindelig Agurk
Cucurbitaceae	Græskar-familien
Cultural Revolution	Kulturrevolutionen
Culture	Kultur
Culture	Kategori:Kultur
Cumulus cloud	Cumulus
Cupressaceae	Cypres-familien
Curitiba	Curitiba
Curium	Curium
Curling	Curling
Currency	Kategori:Møntenheder
Currency	Valuta
Curry	Karry
Curve	Kurve
Cusco	Cusco
Cyan	Cyan
Cyanide	Cyanid
Cyanobacteria	Cyanobakterie
Cybele	Kybele
Cybernetics	Kybernetik
Cyberpunk	Cyberpunk
Cyclades	Kykladerne
Cycling	Cykling
Cycling	Kategori:Cykling
Cyclone	Cyklon
Cyclops	Kyklop
Cygnus (constellation)	Svanen
Cylinder (geometry)	Cylinder (geometri)
Cyperaceae	Halvgræs-familien
Cypriniformes	Karpefisk
Cyprus	Cypern
Cyprus	Kategori:Cypern
Cyrillic alphabet	Kyrilliske alfabet
Cyrus the Great	Kyros 2.
Cystic fibrosis	Cystisk fibrose
Cytoplasm	Cytoplasma
Cytosine	Cytosin
Cytoskeleton	Cytoskelet
Czech Republic	Tjekkiet
Czech Republic	Kategori:Tjekkiet
Czechoslovakia	Tjekkoslovakiet
Czechoslovakia	Kategori:Tjekkoslovakiet
D	D
D. W. Griffith	D.W. Griffith
DDT	DDT
DNA	DNA
DOS	DOS
DVD	Dvd
Dachshund	Gravhund
Dada	Dadaisme
Daedalus	Daidalos
Dahlia	Dahlia
Dakar	Dakar
Dalai Lama	Dalai Lama
Dallas	Dallas
Dalmatia	Dalmatien
Dam	Dæmning
Damascus	Damaskus
Dance	Dans
Dance	Kategori:Dans
Dandelion	Mælkebøtte
Daniel Bernoulli	Daniel Bernoulli
Daniel Defoe	Daniel Defoe
Daniel Ortega	Daniel Ortega
Danish krone	Danske kroner
Dante Alighieri	Dante Alighieri
Danube	Donau
Dar es Salaam	Dar es-Salaam
Dardanelles	Dardanellerne
Darfur	Darfur
Darjeeling	Darjeeling
Dark matter	Mørkt stof
Darmstadtium	Darmstadtium
Darwin	Darwin (Australien)
Darwin	Darwin
Das Kapital	Kapitalen
Data	Data
Data mining	Data mining
Data structure	Datastruktur
Database	Database
Date Palm	Ægte Daddelpalme
Dative case	Dativ
Daugavpils	Daugavpils
David	Kong David
David Hilbert	David Hilbert
David Hume	David Hume
David Livingstone	David Livingstone
David Ricardo	David Ricardo
Davis Cup	Davis Cup
Day	Dag
Days	Kategori:Dage
De facto	De facto
Deacon	Diakon
Dead Sea	Det Døde Hav
Dead Sea scrolls	Dødehavsrullerne
Deadly nightshade	Galnebær
Death	Død
Death	Kategori:Død
Decade	Årti
December	December
December 31	31. december
December 8	8. december
Decibel	Bel
Decimal	Decimal
Decius (emperor)	Decius
Declination	Deklination (astronomi)
Deco	Deco
Deconstruction	Dekonstruktion
Deductive reasoning	Deduktion
Deer	Hjorte
Definition	Definition
Deflation	Deflation
Degree	Grad
Degree (angle)	Grad (vinkelmål)
Deimos (moon)	Deimos (måne)
Deism	Deisme
Delaware	Delaware
Delaware	Kategori:Delaware
Delft	Delft
Delhi	Delhi
Dell	Dell
Delphi	Delfi
Delphinus	Delfinen
Delta	Delta
Delta (letter)	Delta (bogstav)
Deluge (mythology)	Syndflod
Demagogy	Demagogi
Dementia	Demens
Demeter	Demeter (gudinde)
Democracy	Demokrati
Democratic Party (United States)	Demokratiske parti (USA)
Democratic Republic of the Congo	Demokratiske Republik Congo
Democratic Republic of the Congo	Kategori:Demokratiske Republik Congo
Democritus	Demokrit
Demography	Demografi
Demography	Kategori:Demografi
Demon	Dæmon
Demosthenes	Demosthenes
Deng Xiaoping	Deng Xiaoping
Dengue fever	Denguefeber
Denis Diderot	Denis Diderot
Denmark	Danmark
Denmark	Kategori:Danmark
Density	Massefylde
Dental caries	Caries
Dentistry	Kategori:Odontologi
Dentistry	Tandlæge
Denver	Denver
Derivative	Differentialregning
Dermatology	Dermatologi
Des Moines	Des Moines
Desert	Ørken
Deserts	Kategori:Ørkener
Desiderius Erasmus	Erasmus af Rotterdam
Design	Design
Design	Kategori:Design
Desmond Tutu	Desmond Tutu
Destroyer	Destroyer
Determinant	Determinant
Determinism	Determinisme
Detroit	Detroit
Deuterium	Deuterium
Deuteronomy	Femte Mosebog
Developmental psychology	Udviklingspsykologi
Device driver	Hardwaredriver
Devonian	Devon (geologi)
Dew	Dug (vand)
Dew point	Dugpunkt
Dewey Decimal Classification	Dewey Decimal Classification
Dhaka	Dhaka
Dharma	Dharma
Dhole	Dhole
Diabetes mellitus	Sukkersyge
Diacritic	Accenttegn
Dialect	Dialekt
Dialectic	Dialektik
Dialectical materialism	Dialektisk materialisme
Diameter	Diameter
Diamond	Diamant
Diana	Prinsesse Diana
Diana (mythology)	Diana (gudinde)
Diarrhea	Diarre
Diaspora	Diaspora
Diatom	Kiselalge
Dicotyledon	Tokimbladede
Dictatorship	Diktatur
Dictionary	Ordbog
Diego Rivera	Diego Rivera
Diesel	Dieselolie
Diesel engine	Dieselmotor
Dietrich Bonhoeffer	Dietrich Bonhoeffer
Differential equation	Differentialligning
Diffraction	Diffraktion
Diffusion	Diffusion
Digestion	Fordøjelse
Digestive system	Kategori:Fordøjelsessystemet
Digital camera	Digitalkamera
Digital subscriber line	Digital subscriber line
Dijon	Dijon
Dimension	Dimension
Dingo	Dingo
Dinosaur	Dinosaurus
Diocese	Stift
Diocletian	Diocletian
Diode	Diode
Dionysus	Dionysos
Diphtheria	Difteri
Diphthong	Diftong (sproglyd)
Diplomacy	Diplomati
Diplomacy	Kategori:Diplomati
Dire Straits	Dire Straits
Direct current	Jævnstrøm
Disambiguation	Kategori:Flertydig
Disc jockey	Dj
Discourse	Diskurs
Discrimination	Diskrimination
Disease	Sygdom
Distance	Distance
Distillation	Destillation
Division (mathematics)	Division (matematik)
Division (military)	Division (militær)
Divorce	Skilsmisse
Dizzy Gillespie	Dizzy Gillespie
Djibouti	Kategori:Djibouti
Djibouti (city)	Djibouti (by)
Dmitri Mendeleev	Dmitrij Mendelejev
Dmitri Shostakovich	Dmitrij Sjostakovitj
Dnieper River	Dnepr
Dnipropetrovsk	Dnepropetrovsk
Doberman Pinscher	Dobermann
Doctor of the Church	Kirkelærer
Document	Dokument
Dodecahedron	Dodekaeder
Dodecanese	Dodekaneserne
Dodo	Dronte
Dodoma	Dodoma
Dog	Hund
Dogma	Dogme
Doha	Doha
Dollar	Dollar
Dolly (sheep)	Fåret Dolly
Dolmen	Dysse
Dolphin	Delfin
Domain (biology)	Domæne (biologi)
Domain name	Internetdomæne
Dome	Kuppel
Domestication	Domesticering
Dominica	Dominica
Dominican Order	Dominikanerordenen
Dominican Republic	Dominikanske Republik
Dominican Republic	Kategori:Dominikanske Republik
Domitian	Domitian
Don Quixote	Don Quijote
Don River (Russia)	Don
Donald Duck	Anders And
Donatello	Donatello
Donetsk	Donetsk
Donkey	Æsel
Door	Dør
Dopamine	Dopamin
Doppler effect	Dopplereffekt
Dorado	Guldfisken
Doric order	Dorisk søjle
Doris Lessing	Doris Lessing
Dortmund	Dortmund
Douala	Douala
Double bass	Kontrabas
Douglas MacArthur	Douglas MacArthur
Dover	Dover (Delaware)
Dover	Dover
Down syndrome	Downs syndrom
Draco (constellation)	Dragen
Dracula	Dracula (fiktion)
Dragon	Drage (fabeldyr)
Drainage basin	Afvandingsareal
Draughts	Dam (brætspil)
Dream	Drøm
Dresden	Dresden
Drink	Drik
Dromedary	Dromedar
Drought	Tørke
Drug addiction	Narkoman
Druid	Druide
Drum	Tromme
Dualism	Dualisme
Dualism (philosophy of mind)	Dualisme
Dubai	Dubai
Dublin	Dublin
Dubnium	Dubnium
Dubrovnik	Dubrovnik
Dugong	Dygong
Duke	Hertug
Duke Ellington	Duke Ellington
Dune	Klit
Dunkirk	Dunkerque
Duodenum	Tolvfingertarm
Durban	Durban
Dushanbe	Dusjanbe
Dustin Hoffman	Dustin Hoffman
Dutch people	Kategori:Nederlændere
Dwight D. Eisenhower	Dwight D. Eisenhower
Dynamics (physics)	Dynamik
Dynamite	Dynamit
Dynasty	Dynasti
Dyslexia	Ordblindhed
Dysprosium	Dysprosium
Dystopia	Dystopi
E	E
E (mathematical constant)	E (tal)
E-mail	E-mail
E. T. A. Hoffmann	E.T.A. Hoffmann
ETA	ETA
Eagle	Ørn
Ear	Øre
Eared seal	Øresæler
Earless seal	Ægte sæler
Earth	Jorden
Earth	Kategori:Jorden
Earthquake	Jordskælv
East Africa	Østafrika
East China Sea	Østkinesiske Hav
East Germany	DDR
East Sussex	East Sussex
East Timor	Østtimor
East Timor	Kategori:Østtimor
Easter	Påske
Eastern Orthodox Church	De ortodokse kirker
Ebola	Ebola
Ebro	Ebro
Eccentricity (mathematics)	Excentricitet (matematik)
Ecclesiastes	Prædikerens Bog
Echidna	Myrepindsvin
Echidna (mythology)	Echidna (mytologi)
Eclipse	Solformørkelse
Eclipse (software)	Eclipse (program)
Ecliptic	Ekliptika
Ecological niche	Niche (økologi)
Ecology	Økologi
Ecology	Kategori:Økologi
Econometrics	Økonometri (økonomi)
Economics	Økonomi
Economics	Kategori:Økonomi
Economy	Økonomi
Ecosystem	Økosystem
Ecuador	Ecuador
Ecuador	Kategori:Ecuador
Ecumenical council	Økumenisk koncil
Edgar Allan Poe	Edgar Allan Poe
Edgar Degas	Edgar Degas
Edgar Rice Burroughs	Edgar Rice Burroughs
Edinburgh	Edinburgh
Edirne	Edirne (by)
Edmonton	Edmonton
Edmund Burke	Edmund Burke
Edmund Hillary	Edmund Hillary
Edmund Husserl	Edmund Husserl
Edo	Edo (Japan)
Education	Uddannelse
Education	Kategori:Uddannelse
Edvard Grieg	Edvard Grieg
Edvard Munch	Edvard Munch
Edward Gibbon	Edward Gibbon
Edward Jenner	Edward Jenner
Edward Teller	Edward Teller
Edward the Confessor	Edvard Bekenderen
Edwin Hubble	Edwin Hubble
Eel	Ålefisk
Egg (biology)	Æg
Eggplant	Aubergine
Egypt	Ægypten
Egypt	Kategori:Ægypten
Egyptology	Ægyptologi
Eiffel Tower	Eiffeltårnet
Eindhoven	Eindhoven
Einsteinium	Einsteinium
Ejaculation	Udløsning
El Cid	El Cid
El Greco	El Greco
El Paso	El Paso
El Salvador	El Salvador
El Salvador	Kategori:El Salvador
Elbe	Elben
Eleanor Roosevelt	Eleanor Roosevelt
Election	Valg
Electra	Elektra
Electric charge	Elektrisk ladning
Electric current	Elektrisk strøm
Electric guitar	Elektrisk guitar
Electric motor	Elektromotor
Electrical resistance	Elektrisk resistans
Electricity	Elektricitet
Electricity	Kategori:Elektricitet
Electrocardiogram	Elektrokardiogram
Electrochemistry	Kategori:Elektrokemi
Electrolysis	Elektrolyse
Electrolyte	Elektrolyt
Electromagnetic radiation	Elektromagnetisk stråling
Electromagnetic spectrum	Elektromagnetisk spektrum
Electromagnetism	Elektromagnetisme
Electromagnetism	Kategori:Elektromagnetisme
Electron	Elektron
Electron microscope	Elektronmikroskop
Electronegativity	Elektronegativitet
Electronics	Elektronik
Electronics	Kategori:Elektronik
Elegy	Elegi
Elementary particle	Elementarpartikel
Elephant	Elefant
Elevator	Elevator
Elf	Elverfolk
Elia Kazan	Elia Kazan
Elias Canetti	Elias Canetti
Elizabeth Taylor	Elizabeth Taylor
Ella Fitzgerald	Ella Fitzgerald
Ellipse	Ellipse (geometri)
Ellipsis	Udeladelsesprikker
Elm	Elm
Elvis Presley	Elvis Presley
Embryo	Embryon
Embryology	Embryologi
Emerald	Smaragd
Emilia-Romagna	Emilia-Romagna
Emiliano Zapata	Emiliano Zapata
Emily Dickinson	Emily Dickinson
Emir	Emir
Emma Goldman	Emma Goldman
Emoticon	Emoticon
Emotion	Følelse
Emotion	Kategori:Følelser
Empathy	Empati
Empedocles	Empedokles
Emperor	Kejser
Emperor Penguin	Kejserpingvin
Empire	Imperium
Empire State Building	Empire State Building
Empiricism	Empiri
Emu	Emu
Emulator	Emulator
Emulsion	Emulsion
Encyclopedia	Encyklopædi
Endemism	Endemisk
Endocrine system	Endokrine system
Endocrinology	Endokrinologi
Energy	Energi
Energy	Kategori:Energi
Energy (society)	Energi
Engine	Motor
Engineer	Ingeniør
Engineering	Ingeniørvidenskab
Engineering	Kategori:Ingeniørvirksomhed
England	England
England	Kategori:England
English Channel	Engelske Kanal
English Civil War	Engelske borgerkrig
English language	Engelsk (sprog)
English language	Kategori:Engelsk sprog
English people	Kategori:Englændere
Enki	Ea (gud)
Enrico Caruso	Enrico Caruso
Enrico Fermi	Enrico Fermi
Entertainment	Kategori:Underholdning
Enthalpy	Entalpi
Entomology	Entomologi
Entomology	Kategori:Entomologi
Entropy	Entropi
Environment	Kategori:Jordens biologiske miljø
Environment	Miljø
Enzyme	Enzym
Eocene	Eocæn
Eon (geology)	Æon
Eos	Eos
Ephesus	Efesus
Epic poetry	Epos
Epicenter	Epicenter
Epicurus	Epikur
Epidemic	Epidemi
Epidemiology	Epidemiologi
Epilepsy	Epilepsi
Epinephrine	Adrenalin
Epiphany (Christian)	Helligtrekongersdag
Epistemology	Erkendelsesteori
Epistle to the Galatians	Paulus' Brev til Galaterne
Epistle to the Romans	Paulus' Brev til Romerne
Epithelium	Epitel
Epsilon	Epsilon
Equation	Ligning
Equator	Ækvator
Equatorial Guinea	Ækvatorialguinea
Equatorial Guinea	Kategori:Ækvatorialguinea
Equidae	Hestefamilien
Equinox	Jævndøgn
Equisetum	Padderok
Erasure	Erasure
Erato	Erato
Eratosthenes	Eratosthenes
Erbium	Erbium
Erebus	Erebos
Erectile dysfunction	Impotens
Erection	Erektion
Ericaceae	Lyng-familien
Ericales	Lyng-ordenen
Eridanus (constellation)	Floden
Erik Axel Karlfeldt	Erik Axel Karlfeldt
Erik Satie	Erik Satie
Eris (dwarf planet)	136199 Eris
Eris (mythology)	Eris
Eritrea	Kategori:Eritrea
Ernest Hemingway	Ernest Hemingway
Ernest Rutherford	Ernest Rutherford
Ernst Werner von Siemens	Werner von Siemens
Eros (mythology)	Eros (gud)
Erosion	Erosion
Erotica	Erotik
Erwin Rommel	Erwin Rommel
Escape velocity	Undvigelseshastighed
Eschatology	Eskatologi
Escherichia coli	Escherichia coli
Esfahan	Isfahan
Esophagus	Spiserør
Esperanto	Esperanto
Esperanto	Kategori:Esperanto
Espionage	Spionage
Espoo	Espoo
Espresso	Espresso
Essay	Essay
Essen	Essen
Essential oil	Æterisk olie
Essex	Essex
Ester	Ester
Estonia	Kategori:Estland
Estrogen	Østrogen
Eta (letter)	Eta
Ethane	Ethan
Ethanol	Ætanol
Ether	Æter (kemi)
Ethernet	Ethernet
Ethics	Moral
Ethics	Kategori:Etik
Ethiopia	Etiopien
Ethiopia	Kategori:Etiopien
Ethnic group	Etnicitet
Ethnography	Etnografi
Ethnology	Kategori:Etnologi
Ethology	Etologi
Ethylene	Ethen
Etymology	Etymologi
Eucalyptus	Eukalyptus
Eucharist	Nadver
Euclid	Euklid
Euclidean geometry	Euklidisk geometri
Eukaryote	Eucaryota
Euphemism	Eufemisme
Euphrates	Eufrat
Eurasia	Eurasien
Eurasian Badger	Grævling
Euripides	Euripides
Euro	Euro
Europa (moon)	Europa (måne)
Europa (mythology)	Europa (mytologi)
Europe	Europa
Europe	Kategori:Europa
European Central Bank	Den Europæiske Centralbank
European Community	Europæiske Fællesskab
European Magpie	Husskade
European Union	Den Europæiske Union
European Union	Kategori:EU
Europium	Europium
Eusebius of Caesarea	Eusebius af Cæsarea
Euthanasia	Aktiv dødshjælp
Eva Braun	Eva Braun
Evanescence	Evanescence
Evangelista Torricelli	Evangelista Torricelli
Evaporation	Evaporation
Even-toed ungulate	Parrettåede hovdyr
Evolution	Evolution (biologi)
Excalibur	Excalibur
Exclamation mark	Udråbstegn
Excommunication	Ekskommunikation
Executive (government)	Udøvende magt
Exhibitionism	Ekshibitionisme
Existentialism	Eksistentialisme
Exodus	Anden Mosebog
Experiment	Eksperiment
Explosion	Eksplosion
Expo (exhibition)	Verdensudstilling
Exponential function	Eksponentialfunktion
Exponentiation	Potens (matematik)
Expressionism	Ekspressionisme
Extinction	Uddød
Eye	Øje
Ezra Pound	Ezra Pound
F	F
F. Scott Fitzgerald	Francis Scott Fitzgerald
Fabaceae	Ærteblomstfamilien
Fable	Fabel
Fact	Skabelon:Kilde mangler
Factorial	Fakultet (matematik)
Factory	Fabrik
Facula	Solplet
Fagales	Bøge-ordenen
Fahrenheit	Fahrenheit
Fair use	Fair use
Fairy tale	Eventyr
Falcon	Falk
Falconiformes	Falke-ordenen
Falkland Islands	Falklandsøerne
Fallopian tube	Æggeleder
Fallow Deer	Dådyr
Falun Gong	Falun Gong
Family	Kategori:Familie
Family (biology)	Familie (biologi)
Family history	Slægtsforskning
Family name	Efternavn
Fantasy	Fantasy
Far East	Fjernøsten
Farad	Farad
Faroe Islands	Kategori:Færøerne
Fascism	Fascisme
Fascism	Kategori:Fascisme
Fashion	Kategori:Mode
Fashion	Mode
Fast food	Fastfood
Fasting	Faste
Fatah	Fatah
Fatty acid	Fedtsyre
Fault (geology)	Forkastningszone
Fauna	Fauna
Feather	Fjer
February	Februar
February 12	12. februar
February 14	14. februar
February 2	2. februar
February 22	22. februar
February 29	29. februar
February Revolution	Februarrevolutionen (Rusland)
Feces	Afføring
Federal Bureau of Investigation	FBI
Federal Reserve System	USA's centralbank
Federated States of Micronesia	Mikronesien
Federated States of Micronesia	Kategori:Mikronesien
Federation	Føderation
Federico Fellini	Federico Fellini
Fedora (Linux distribution)	Fedora (Linux distribution)
Feedback	Feedback
Feldspar	Feldspat
Felidae	Kattefamilien
Felix Mendelssohn	Felix Mendelssohn
Feminism	Feminisme
Feminism	Kategori:Feminisme
Fencing	Fægtning
Feng shui	Feng Shui
Fennel	Fennikel
Fenrir	Fenrisulven
Fenugreek	Bukkehorn
Ferdinand II	Ferdinand 2. (Tysk-romerske rige)
Ferdinand Magellan	Ferdinand Magellan
Ferdinand de Saussure	Ferdinand de Saussure
Fermentation (biochemistry)	Fermentering
Fermentation (food)	Fermentering
Fermium	Fermium
Fern	Bregne
Ferrara	Ferrara
Ferry	Færge
Fertile Crescent	Frugtbare halvmåne
Fertilisation	Befrugtning
Fertilizer	Gødning
Fetus	Foster
Feudalism	Feudalisme
Fever	Feber
Fiat	Fiat
Fibonacci number	Fibonacci-tal
Fiction	Kategori:Fiktion
Fictional character	Fiktiv person
Fidel Castro	Fidel Castro
Field (mathematics)	Legeme (matematik)
Field hockey	Hockey
Fighter aircraft	Jagerfly
Fiji	Fiji
Fiji	Kategori:Fiji
File Allocation Table	FAT
File Transfer Protocol	FTP
File system	Filsystem
Filippo Brunelleschi	Filippo Brunelleschi
Film	Kategori:Film
Film	Film
Film	Portal:Film
Film director	Filminstruktør
Fin Whale	Finhval
Finance	Kategori:Finans
Finance	Finans
Finger	Finger
Fingerprint	Fingeraftryk
Finland	Finland
Finland	Kategori:Finland
Fir	Ædelgran
Fire	Ild
Firefighter	Brandvæsen
Firewall (networking)	Firewall
Firmware	Firmware
First Council of Constantinople	Første koncil i Konstantinopel
First Council of Nicaea	Første koncil i Nikæa
First Epistle to the Corinthians	Paulus' Første Brev til Korintherne
First aid	Førstehjælp
First language	Modersmål
Fish	Fisk
Fish	Kategori:Fisk
Fishing	Fiskeri
Fishing	Kategori:Fiskeri
Fjord	Fjord
Flag	Flag
Flamenco	Flamenco
Flamingo	Flamingo (fugl)
Flanders	Flandern
Flash memory	Flash-lager
Flatworm	Fladorme
Flea	Loppe
Flint	Flint
Flip-flop (electronics)	Flip-flop (digital elektronik)
Flood	Oversvømmelse
Floppy disk	Diskette
Florence	Firenze
Florence Nightingale	Florence Nightingale
Florida	Florida
Florida	Kategori:Florida
Flour	Mel
Flower	Blomst
Flowering plant	Dækfrøede planter
Fluid mechanics	Fluidmekanik
Flute	Fløjte
Fly	Tovinger
Fog	Tåge
Folic acid	Folsyre
Folk music	Folkemusik
Folklore	Folkeminde
Folklore	Kategori:Folkeminde
Food	Mad
Food additive	Tilsætningsstof
Food and Agriculture Organization	FAO
Food chain	Fødekæde
Foot (unit of length)	Fod (længdeenhed)
Football (soccer)	Fodbold
Football (soccer)	Kategori:Fodbold
Football (soccer) by country	Kategori:Fodbold efter land
Football (soccer) clubs	Kategori:Fodboldklubber
Football (soccer) managers	Kategori:Fodboldtrænere
Football (soccer) players	Kategori:Fodboldspillere
Football (soccer) venues	Kategori:Fodboldstadioner
Forbidden City	Den Forbudte By
Force	Kraft
Forest	Skov
Forestry	Skovbrug
Fork	Gaffel (bestik)
Form of government	Statsform
Formaldehyde	Formaldehyd
Formic acid	Myresyre
Fornax	Kemiske Ovn
Fort Worth	Fort Worth
Fortification	Fæstningsværk
Fortran	Fortran
Fossil	Fossil
Fossil fuel	Fossilt brændstof og brændsel
Fountain	Springvand
Fourier series	Fourierrække
Fox	Ræv
Fractal	Fraktal
Fraction (mathematics)	Brøk
France	Frankrig
France	Kategori:Frankrig
Francis Bacon	Francis Bacon (filosof)
Francis Crick	Francis Crick
Francis Drake	Francis Drake
Francis Ford Coppola	Francis Ford Coppola
Francis II	Frans 2. (Tysk-romerske rige)
Francis Poulenc	Francis Poulenc
Francis of Assisi	Frans af Assisi
Franciscan	Franciskanerordenen
Francisco Franco	Francisco Franco
Francisco Goya	Francisco Goya
Francisco Pizarro	Francisco Pizarro
Francium	Francium
Franco-Prussian War	Den fransk-preussiske krig
Frank Lloyd Wright	Frank Lloyd Wright
Frank Sinatra	Frank Sinatra
Frankfort	Frankfort
Frankfurt	Frankfurt am Main
Frankfurt	Kategori:Frankfurt am Main
Frankfurt (Oder)	Frankfurt (Oder)
Frankfurt (disambiguation)	Frankfurt
Franklin Pierce	Franklin Pierce
Franz Kafka	Franz Kafka
Franz Liszt	Franz Liszt
Franz Schubert	Franz Schubert
Fred Astaire	Fred Astaire
Frederick I	Frederik Barbarossa
Free State	Fristatprovinsen
Free will	Fri vilje
Freedom (philosophy)	Frihed
Freedom of speech	Ytringsfrihed
Freemasonry	Frimureri
Freetown	Freetown
Freeware	Freeware
French Polynesia	Fransk Polynesien
French Revolution	Den Franske Revolution
French people	Kategori:Franskmænd
Frequency	Frekvens
Fresco	Kalkmaleri
Freshwater	Ferskvand
Fresno	Fresno
Freyja	Freja (gudinde)
Freyr	Frej
Friction	Friktion
Friday	Fredag
Fridtjof Nansen	Fridtjof Nansen
Friedrich Engels	Friedrich Engels
Friesland	Frisland (Nederland)
Frigate	Fregat
Frigg	Frigg
Friuli-Venezia Giulia	Friuli-Venezia Giulia
Frog	Frøer og tudser
Fructose	Fruktose
Fruit	Frugt
Fruit	Kategori:Frugter
Fuel	Brændstof
Fuel cell	Brændselscelle
Fugue	Fuga
Fukuoka	Fukuoka
Function (mathematics)	Funktion (matematik)
Fundamental	Kategori:Kategorier
Fundamental interaction	Naturkræfter
Fundamentalism	Fundamentalisme
Fungi	Kategori:Svampe
Fungus	Svampe
Funicular	Kabelbane
Funk	Funk
Furniture	Kategori:Møbler
Furniture	Møbel
Future	Fremtiden
Futurism (art)	Futurisme
Fyodor Dostoevsky	Fjodor Mikhajlovitj Dostojevskij
G	G
GIMP	GIMP
GNOME	GNOME
GNU	GNU
Gabon	Gabon
Gabon	Kategori:Gabon
Gaborone	Gaborone
Gabriel	Gabriel
Gabriel Lippmann	Gabriel Lippmann
Gadolinium	Gadolinium
Gaetano Donizetti	Gaetano Donizetti
Gaia (mythology)	Gaia (gudinde)
Galatia	Galatien
Galaxy	Galakse
Galen	Galen
Galicia (Central Europe)	Galicien (Centraleuropa)
Galicia (Spain)	Galicien (Spanien)
Galilee	Galilæa
Galileo (spacecraft)	Galileo (rumsonde)
Galileo Galilei	Galileo Galilei
Galley	Galej
Galliformes	Hønsefugle
Galliformes	Kategori:Hønsefugle
Gallium	Gallium
Gallon	Gallon
Galway	Galway
Gamal Abdel Nasser	Gamal Abdel Nasser
Gambling	Hasardspil
Game	Spil (leg)
Game theory	Spilteori
Gamma	Gamma (bogstav)
Gamma ray	Gammastråling
Ganesha	Ganesha
Ganges	Ganges
Ganja	Gandja
Gansu	Gansu
Ganymede	Ganymedes (gud)
Ganymede (moon)	Ganymedes (måne)
Garden	Have
Gardening	Havebrug
Garfield	Garfield
Gargoyle	Gargoil
Garlic	Hvidløg
Garnet	Granat (mineral)
Garonne	Garonne
Gas	Gas
Gas constant	Gaskonstant
Gas giant	Gaskæmpe
Gasoline	Benzin
Gastropoda	Snegl
Gaul	Gallien
Gautama Buddha	Siddharta Gautama
Gaza Strip	Gazastriben
Gear	Tandhjul
Geb	Geb
Geisha	Geisha
Gemini (constellation)	Tvillingerne
Gemstone	Smykkesten
Gene	Gen
Genealogy	Slægtsforskning
Genealogy	Kategori:Slægtsforskning
General Officer	General
General relativity	Almen relativitetsteori
Genesis	Første Mosebog
Genetic code	Genetisk kode
Genetic engineering	Gensplejsning
Genetics	Genetik
Genetics	Kategori:Genetik
Geneva	Geneve
Genie	Djinni
Genitive case	Genitiv
Genoa	Genova
Genocide	Folkedrab
Genocide	Kategori:Folkedrab
Genome	Arvemasse
Genotype	Genotype
Genus	Slægt (biologi)
Geodesy	Geodæsi
Geoffrey Chaucer	Geoffrey Chaucer
Geography	Geografi
Geography	Kategori:Geografi
Geography	Portal:Geografi
Geology	Kategori:Geologi
Geology	Geologi
Geometric progression	Geometrisk række
Geometry	Geometri
Geometry	Kategori:Geometri
Geophysics	Geofysik
Geophysics	Kategori:Geofysik
Geopolitics	Geopolitik
Georg Philipp Telemann	Georg Philipp Telemann
Georg Wilhelm Friedrich Hegel	Georg Wilhelm Friedrich Hegel
George Berkeley	George Berkeley
George Bernard Shaw	George Bernard Shaw
George Bush	George Bush
George Frideric Handel	Georg Friedrich Händel
George Gershwin	George Gershwin
George Harrison	George Harrison
George Lucas	George Lucas
George Marshall	George Marshall
George Orwell	George Orwell
George Paget Thomson	George Paget Thomson
George Sand	George Sand
George Stephenson	George Stephenson
George W. Bush	George W. Bush
George Washington	George Washington
Georges Bizet	Georges Bizet
Georges Clemenceau	Georges Clemenceau
Georges Simenon	Georges Simenon
Georgetown	Georgetown (Guyana)
Georgia (U.S. state)	Georgia
Georgia (U.S. state)	Kategori:Georgia
Georgia (country)	Georgien
Georgia (country)	Kategori:Georgien
Gerald Ford	Gerald Ford
Gerard Kuiper	Gerard Kuiper
German Shepherd Dog	Schæferhund
German language	Tysk (sprog)
German language	Kategori:Tysk sprog
German mark	D-Mark
Germanium	Germanium
Germany	Tyskland
Germany	Kategori:Tyskland
Geronimo	Geronimo
Gestapo	Gestapo
Geyser	Gejser
Ghana	Ghana
Ghana	Kategori:Ghana
Ghent	Gent
Ghetto	Ghetto
Ghost	Spøgelse
Giacomo Puccini	Giacomo Puccini
Giant Panda	Panda
Gibbon	Gibboner
Gibraltar	Gibraltar
Gigabyte	Gigabyte
Gilgamesh	Gilgamesh
Ginger	Ægte Ingefær
Ginkgo	Tempeltræ
Giordano Bruno	Giordano Bruno
Giotto di Bondone	Giotto di Bondone
Giovanni Boccaccio	Giovanni Boccaccio
Giraffe	Giraf
Giraffidae	Giraffer
Girolamo Savonarola	Girolamo Savonarola
Gironde	Gironde
Giuseppe Garibaldi	Giuseppe Garibaldi
Giuseppe Verdi	Giuseppe Verdi
Giza	Giza
Glacier	Gletsjer
Gladiator	Gladiator
Gland	Kirtel
Glasgow	Glasgow
Glasnost	Glasnost
Glass	Glas
Glasses	Briller
Glider	Svævefly
Global Positioning System	Global Positioning System
Global warming	Global opvarmning
Globalization	Globalisering
Globe artichoke	Artiskok
Glucagon	Glukagon
Glucose	Glukose
Glutamic acid	Glutaminsyre
Glycerol	Glycerin
Glycine	Glycin
Glycogen	Glykogen
Glycolysis	Glykolyse
Gneiss	Gnejs
Gnosticism	Gnosticisme
Go (board game)	Go
Goa	Goa
Goalkeeper	Målmand
Goat	Ged
God	Gud
Golan Heights	Golanhøjderne
Gold	Guld
Golda Meir	Golda Meïr
Golden Eagle	Kongeørn
Golden Gate Bridge	Golden Gate-broen
Golden Retriever	Golden retriever
Golf	Golf
Golf	Kategori:Golf
Golgi apparatus	Golgiapparat
Gomel	Gomel
Good Friday	Langfredag
Google	Google
Google	Kategori:Google
Googol	Googol
Gorgon	Gorgonerne
Gorilla	Gorilla
Goshawk	Duehøg
Gospel	Evangelium
Gospel of Luke	Lukasevangeliet
Gothenburg	Göteborg
Gothic	Gotisk
Gothic architecture	Gotik
Gotthold Ephraim Lessing	Gotthold Ephraim Lessing
Gottlieb Daimler	Gottlieb Daimler
Gout	Gigt
Government	Regering
Grace Kelly	Grace Kelly
Graffiti	Graffiti
Graham Greene	Graham Greene
Gram	Gram (enhed)
Grammar	Grammatik
Grammar	Kategori:Grammatik
Grammatical gender	Grammatisk køn
Granada	Granada
Grand Canyon	Grand Canyon
Grand Slam (tennis)	Grand Slam
Grandmaster (chess)	Skakstormester
Granite	Granit
Grape	Vinstok
Grapefruit	Grapefrugt
Graphical user interface	Grafisk brugerflade
Graphite	Grafit
Gravitation	Gravitation
Gravitational constant	Den universelle gravitationskonstant
Graviton	Graviton
Gray (unit)	Gray
Gray Wolf	Ulv
Graz	Graz
Great Barrier Reef	Great Barrier Reef
Great Britain	Storbritannien (ø)
Great Crested Grebe	Toppet lappedykker
Great Depression	Depressionen
Great Lakes	Store søer (Nordamerika)
Great Rift Valley	Great Rift Valley
Great Wall of China	Den Kinesiske Mur
Great white shark	Hvid haj
Greater Antilles	Store Antiller
Greater London	Greater London
Grebe	Lappedykkere
Greece	Grækenland
Greece	Kategori:Grækenland
Greek alphabet	Græske alfabet
Greek alphabet	Kategori:Græske alfabet
Greek fire	Græsk ild
Greek mythology	Græsk mytologi
Greek mythology	Kategori:Græsk mytologi
Green	Grøn
Greenhouse	Drivhus
Greenhouse effect	Drivhuseffekt
Greenhouse gas	Drivhusgas
Greenland	Grønland
Greenland	Kategori:Grønland
Greenland Sea	Grønlandshavet
Greenpeace	Greenpeace
Greenwich	Greenwich
Gregor Mendel	Gregor Mendel
Gregorian calendar	Gregorianske kalender
Grenada	Kategori:Grenada
Grenoble	Grenoble
Greta Garbo	Greta Garbo
Grey	Grå
Greylag Goose	Grågås
Griffin	Grif
Gross domestic product	BNI per indbygger
Group	Gruppe
Group (mathematics)	Gruppe (matematik)
Group theory	Gruppeteori
Grover Cleveland	Grover Cleveland
Grozny	Grosnij
Gruiformes	Tranefugle
Grus (constellation)	Tranen
Guadeloupe	Guadeloupe
Guam	Guam
Guangdong	Guangdong
Guangzhou	Guangzhou
Guanine	Guanin
Guano	Guano
Guatemala	Kategori:Guatemala
Guatemala City	Ciudad Guatemala
Guayaquil	Guayaquil
Guernsey	Guernsey
Guglielmo Marconi	Guglielmo Marconi
Guild	Lav (organisation)
Guillotine	Guillotine
Guinea	Guinea
Guinea	Kategori:Guinea
Guinea pig	Marsvin (gnaver)
Guinea-Bissau	Guinea-Bissau
Guinea-Bissau	Kategori:Guinea-Bissau
Guitar	Guitar
Gujarat	Gujarat
Gulag	Gulag
Gulf Stream	Golfstrømmen
Gulf War	Golfkrigen
Gulf of Aden	Adenbugten
Gulf of Aqaba	Akababugten
Gulf of Bothnia	Den Botniske Bugt
Gulf of Finland	Den Finske Bugt
Gulf of Guinea	Guineabugten
Gulf of Mexico	Mexicanske Golf
Gulf of Oman	Omanbugten
Gulf of Riga	Rigabugten
Gull	Måge
Gunpowder	Krudt
Gunpowder Plot	Krudtsammensværgelsen
Guppy	Guppy
Gustav Klimt	Gustav Klimt
Gustav Ludwig Hertz	Gustav Ludwig Hertz
Gustav Mahler	Gustav Mahler
Guy Fawkes	Guy Fawkes
Guy de Maupassant	Guy de Maupassant
Guyana	Kategori:Guyana
Gymnastics	Gymnastik
Gymnosperm	Nøgenfrøede
Gynaecology	Gynækologi
Gypsum	Gips
Gyroscope	Gyroskop
H	H
H. G. Wells	H.G. Wells
HIV	HIV
HTML	Hypertext Markup Language
Habitat	Habitat
Hacker	Hacker
Hadean	Hadal
Hades	Hades
Hadith	Hadith
Hadrian	Hadrian
Hadrian's Wall	Hadrians mur
Hadron	Hadron
Haemophilia	Hæmofili
Hafnium	Hafnium
Hagia Sophia	Hagia Sophia
Haifa	Haifa
Haiku	Haiku
Hail	Hagl (nedbør)
Hail Mary	Hill dig, Maria
Hair	Hår
Haiti	Haiti
Haiti	Kategori:Haiti
Hajj	Hadj
Halal	Halal
Halberd	Hellebard
Half-life	Halveringstid
Halle	Halle (Sachsen-Anhalt)
Halloween	Allehelgensaften
Hallucination	Hallucination
Halogen	Halogener
Hamas	Hamas
Hamburg	Hamborg
Hamburg	Kategori:Hamburg
Hamburger	Hamburger
Hamlet	Hamlet
Hammer	Hammer
Hammer and sickle	Hammer og segl
Hammurabi	Hammurabi
Hamster	Hamster
Han Dynasty	Han-dynastiet
Hand	Hånd
Hand grenade	Håndgranat
Handgun	Pistol
Hanging	Hængning
Hanging Gardens of Babylon	Babylons hængende haver
Hannah Arendt	Hannah Arendt
Hannibal	Hannibal
Hanoi	Hanoi
Hanover	Hannover
Hans Bethe	Hans Albrecht Bethe
Hans Christian Andersen	H.C. Andersen
Hanseatic League	Hanseforbundet
Hanukkah	Chanukka
Hanuman	Hanuman
Happiness	Lykke
Harare	Harare
Hardness	Hårdhed
Harem	Harem
Harlem	Harlem
Harmonica	Mundharmonika
Harmony	Harmonilære
Harold Pinter	Harold Pinter
Harp	Harpe
Harpsichord	Cembalo
Harpy	Harpy
Harriet Beecher Stowe	Harriet Beecher-Stowe
Harriet Tubman	Harriet Tubman
Harrisburg	Harrisburg
Harry Houdini	Harry Houdini
Hartford	Hartford
Hassium	Hassium
Hatred	Had
Haute-Normandie	Haute-Normandie
Havana	Havana
Hawaii	Hawaii
Hawaii	Kategori:Hawaii
Head	Hoved
Head of state	Statsoverhoved
Health	Sundhed
Health	Kategori:Sundhed
Heart	Hjerte (organ)
Heat	Varme
Heat engine	Varmekraftmaskine
Heaven	Himmelen (religion)
Heavy metal	Kategori:Heavy metal
Heavy metal music	Heavy metal
Heavy water	Tungt vand
Hebe (mythology)	Hebe
Hebei	Hebei
Hebrew alphabet	Hebraisk alfabet
Hebrew calendar	Den jødiske kalender
Hebrides	Hebriderne
Hecate	Hekate
Hectare	Hektar
Hector	Hektor
Hector Berlioz	Hector Berlioz
Hedgehog	Pindsvin
Hedonism	Hedonisme
Heimdall	Hejmdal
Heinrich Hertz	Heinrich Rudolf Hertz
Heinrich Himmler	Heinrich Himmler
Heinrich Schliemann	Heinrich Schliemann
Hel (being)	Hel (Lokes datter)
Helen	Helena (græsk mytologi)
Helen Keller	Helen Keller
Helena	Helena (Montana)
Helicopter	Helikopter
Helios	Helios
Helium	Helium
Hell	Helvede
Helmut Schmidt	Helmut Schmidt
Helsinki	Helsinki
Hemoglobin	Hæmoglobin
Henri Becquerel	Henri Becquerel
Henri Bergson	Henri Bergson
Henri Matisse	Henri Matisse
Henrik Ibsen	Henrik Ibsen
Henry David Thoreau	Henry David Thoreau
Henry Fonda	Henry Fonda
Henry Ford	Henry Ford
Henry Kissinger	Henry Kissinger
Henry Miller	Henry Miller
Henry Purcell	Henry Purcell
Hepatitis	Hepatitis
Hephaestus	Hefaistos
Hera	Hera
Heracles	Herakles
Heraclitus	Heraklit
Heraldry	Heraldik
Heraldry	Kategori:Heraldik
Herbert Hoover	Herbert Hoover
Herbert Marcuse	Herbert Marcuse
Herbert Spencer	Herbert Spencer
Hercules	Herakles
Hercules (constellation)	Herkules (stjernebillede)
Heresy	Kætteri
Herman Melville	Herman Melville
Hermann Hesse	Hermann Hesse
Hermann von Helmholtz	Hermann von Helmholtz
Hermaphrodite	Hermafrodit
Hermeneutics	Hermeneutik
Hermes	Hermes
Hero	Helt
Hero of Alexandria	Heron
Herod the Great	Herodes den Store
Herodotus	Herodot
Heroin	Heroin
Heron	Hejrer
Herring Gull	Sølvmåge
Hertfordshire	Hertfordshire
Hertz	Hertz
Hesiod	Hesiod
Hesse	Hessen
Hesse	Kategori:Hessen
Hestia	Hestia
Heterosexuality	Heteroseksualitet
Heterotroph	Heterotrof
Hexadecimal	Hexadecimale talsystem
Hexagon	Sekskant
Hezbollah	Hizbollah
Hibernation	Dvale
Hieronymus Bosch	Hieronymus Bosch
Hilbert space	Hilbertrum
Himalayas	Himalaya
Hindu Kush	Hindu Kush
Hinduism	Hinduisme
Hinduism	Kategori:Hinduisme
Hipparchus	Hipparchos
Hippie	Hippie
Hippocrates	Hippokrates
Hippocratic Oath	Lægeløftet
Hippopotamus	Flodhest
Hirohito	Hirohito
Hiroshima	Hiroshima
Hispaniola	Hispaniola
Histidine	Histidin
Histology	Histologi
Histology	Kategori:Histologi
Histone	Histon
History	Historie
History	Kategori:Historie
History	Portal:Historie
Ho Chi Minh	Ho Chi Minh
Ho Chi Minh City	Ho Chi Minh-byen
Hobart	Hobart
Hobbit	Hobbit
Hobby	Hobby
Hokusai	Hokusai
Holiday	Helligdag
Hollywood	Hollywood
Holmium	Holmium
Holocene	Holocæn
Holy Grail	Den hellige gral
Holy Roman Empire	Tysk-romerske rige
Holy Spirit	Helligånden
Homeopathy	Homøopati
Homeostasis	Homøostase
Homer	Homer
Hominidae	Menneskeabe
Homo (genus)	Homo (slægten)
Homo erectus	Homo erectus
Homo habilis	Homo habilis
Homonym	Homonym
Homophobia	Homofobi
Homosexuality	Homoseksualitet
Honduras	Honduras
Honduras	Kategori:Honduras
Honey	Honning
Honey Buzzard	Hvepsevåge
Hong Kong	Hongkong
Honiara	Honiara
Honolulu	Honolulu
Hookah	Vandpibe
Hooke's law	Hookes lov
Hoopoe	Hærfugl
Horace	Horats
Horatio Nelson	Horatio Nelson
Horizon	Horisont (geografi)
Hormone	Hormon
Horn (instrument)	Valdhorn
Horn of Africa	Afrikas Horn
Horoscope	Horoskop
Horse	Hest
Horsepower	Hestekraft
Horus	Horus
Hosni Mubarak	Hosni Mubarak
Hospital	Sygehus
Hotel	Hotel
Hour	Time (enhed)
Hourglass	Timeglas
House	Hus
House Mouse	Lys husmus
House Sparrow	Gråspurv
Houston	Houston
Howard Carter (archaeologist)	Howard Carter
Hubble's law	Hubbles lov
Hudson Bay	Hudsonbugten
Hudson River	Hudson River
Hugo Grotius	Hugo Grotius
Huguenot	Huguenot
Human	Menneske
Humanism	Humanisme
Humanities	Kategori:Humaniora
Humerus	Humerus
Humidity	Luftfugtighed
Hummingbird	Kolibrier
Humor	Kategori:Humor
Humour	Humor
Humpback Whale	Pukkelhval
Humphrey Bogart	Humphrey Bogart
Humus	Humus
Hunan	Hunan
Hundred Years' War	Hundredårskrigen
Hungary	Ungarn
Hungary	Kategori:Ungarn
Hunger	Sult
Hunting	Jagt
Hutu	Hutu
Hybrid	Krydsning
Hyderabad	Hyderabad
Hydra (constellation)	Søslangen
Hydrocarbon	Kulbrinte
Hydrochloric acid	Saltsyre
Hydroelectricity	Vandkraft
Hydrogen	Brint
Hydrogen bond	Hydrogenbinding
Hydrogen cyanide	Blåsyre
Hydrogen peroxide	Hydrogenperoxid
Hydrology	Hydrologi
Hydrology	Kategori:Hydrologi
Hydrolysis	Hydrolyse
Hydrosphere	Hydrosfære
Hydroxide	Hydroxid
Hydrus	Lille Søslange
Hyena	Hyæner
Hygiene	Kategori:Hygiejne
Hymen	Jomfruhinde
Hymn	Hymne
Hyperbola	Hyperbel
Hyperion (moon)	Hyperion (måne)
Hyperion (mythology)	Hyperion (mytologi)
Hypertext	Hypertekst
Hypertext Transfer Protocol	HTTP
Hypnos	Hypnos
Hypnosis	Hypnose
Hypothalamus	Hypothalamus
Hypothesis	Hypotese
I	I
IPod	IPod
Ian Fleming	Ian Fleming
Iapetus (moon)	Iapetus (måne)
Iapetus (mythology)	Iapetos
Iberian Peninsula	Den Iberiske Halvø
Ibuprofen	Ibuprofen
Ice	Is (vand)
Ice age	Istid
Ice cream	Is (mad)
Ice hockey	Ishockey
Ice hockey	Kategori:Ishockey
Iceberg	Isbjerg
Iceland	Island
Iceland	Kategori:Island
Icon	Ikon (billede)
Idaho	Idaho
Idaho	Kategori:Idaho
Idealism	Idealisme
Identity matrix	Identitetsmatrix
Ideology	Ideologi
Ido	Ido
Igloo	Iglo
Ignatius of Loyola	Ignatius Loyola
Igor Stravinsky	Igor Stravinskij
Iguazu Falls	Iguazú-vandfaldene
Iliad	Iliaden
Illinois	Illinois
Illinois	Kategori:Illinois
Illyria	Illyrien
Image scanner	Scanner (computer)
Imam	Imam
Immanuel Kant	Immanuel Kant
Immune system	Immunforsvar
Immunology	Immunologi
Imperialism	Imperialisme
Impressionism	Impressionisme
Incest	Incest
Inch	Tomme
Incheon	Incheon
Independence	Uafhængighed (politik)
India	Indien
India	Kategori:Indien
Indian Ocean	Indiske Ocean
Indiana	Indiana
Indiana	Kategori:Indiana
Indianapolis	Indianapolis
Indira Gandhi	Indira Gandhi
Indium	Indium
Indochina	Indokina
Indonesia	Indonesien
Indonesia	Kategori:Indonesien
Indra	Indra
Inductive reasoning	Induktion (metode)
Inductor	Elektrisk spole
Indulgence	Aflad
Indus (constellation)	Indianeren
Indus River	Indus
Industrial Revolution	Den industrielle revolution
Industry	Industri
Industry	Kategori:Industri
Inequality	Ulighed (matematik)
Inertia	Inerti
Infantry	Infanteri
Infinitive	Infinitiv
Infinity	Uendelig
Inflammation	Betændelse
Inflation	Inflation
Influenza	Influenza
Information	Information
Information technology	Informationsteknologi
Infrared	Infrarød stråling
Infrastructure	Infrastruktur
Ingmar Bergman	Ingmar Bergman
Ingrid Bergman	Ingrid Bergman
Inner Mongolia	Indre Mongoliet
Innovation	Innovation
Innsbruck	Innsbruck
Inorganic chemistry	Uorganisk kemi
Inorganic chemistry	Kategori:Uorganisk kemi
Inquisition	Inkvisition
Insect	Insekt
Insecticide	Insekticid
Institution	Institution
Insulin	Insulin
Insurance	Forsikring
Integer	Heltal
Integral	Integralregning
Integrated circuit	Integreret kredsløb
Intellectual property	Immaterialret
Intelligence	Intelligens
Intelligence quotient	Intelligenskvotient
Intercontinental ballistic missile	Interkontinentalt ballistisk missil
Interference	Interferens
Interjection	Udråbsord
International Atomic Energy Agency	Det Internationale Atomenergiagentur
International Civil Aviation Organization	International Civil Aviation Organisation
International Court of Justice	Den Internationale Domstol
International Date Line	Datolinjen
International Labour Organization	International Labour Organization
International Monetary Fund	Internationale Valutafond
International System of Units	Système International d'Unités
International organization	International organisation
Internet	Internet
Internet	Kategori:Internet
Internet Explorer	Internet Explorer
Internment	Koncentrationslejr
Interpreter (computing)	Fortolker
Interval (music)	Toneinterval
Intestine	Tarm (anatomi)
Intranet	Intranet
Invention	Opfindelse
Invertebrate	Hvirvelløse dyr
Io (moon)	Io (måne)
Io (mythology)	Io (græsk mytologi)
Iodine	Jod
Ion	Ion
Ionian Sea	Ioniske Hav
Ionosphere	Ionosfære
Iota	Iota
Iowa	Iowa
Iowa	Kategori:Iowa
Iran	Iran
Iran	Kategori:Iran
Iran-Iraq War	Iran-Irak-krigen
Iraq	Irak
Iraq	Kategori:Irak
Ireland	Irland (ø)
Ireland	Kategori:Irland
Irenaeus	Irenæus
Iridium	Iridium
Iris (anatomy)	Regnbuehinden (iris)
Iris (mythology)	Iris (mytologi)
Irish Republican Army	IRA
Irish Sea	Irske Hav
Irish people	Kategori:Irere
Iron	Jern
Iron Age	Jernalder
Iron Curtain	Jerntæppet
Iron Maiden	Iron Maiden
Irony	Ironi
Irrational number	Irrationale tal
Irredentism	Irredentisme
Isaac Asimov	Isaac Asimov
Isaac Newton	Isaac Newton
Isadora Duncan	Isadora Duncan
Ishmael	Ismael
Isis	Isis
Islam	Islam
Islam	Kategori:Islam
Islamabad	Islamabad
Islamic calendar	Islamisk kalender
Island	Ø
Isle of Man	Isle of Man
Isle of Man	Kategori:Isle of Man
Isle of Wight	Isle of Wight
Isomer	Isomer
Isoroku Yamamoto	Isoroku Yamamoto
Isotope	Isotop
Israel	Israel
Israel	Kategori:Israel
Istanbul	Istanbul
Isthmus	Tange
Isthmus of Panama	Panamatangen
Italian Peninsula	Apenniniske halvø
Italy	Italien
Italy	Kategori:Italien
Ithaca	Ithaka
Ivan Lendl	Ivan Lendl
Ivan Pavlov	Ivan Petrovitj Pavlov
Ivan Turgenev	Ivan Turgenjev
Ivory	Elfenben
Ivy League	Ivy League
J	J
J. D. Salinger	J.D. Salinger
J. M. Barrie	J.M. Barrie
Jack Kerouac	Jack Kerouac
Jack London	Jack London
Jack the Ripper	Jack the Ripper
Jackdaw	Allike
Jackson Pollock	Jackson Pollock
Jacksonville	Jacksonville
Jacob	Jakob (patriark)
Jacques Cartier	Jacques Cartier
Jacques Derrida	Jacques Derrida
Jacques Offenbach	Jacques Offenbach
Jade	Jade
Jaguar	Jaguar (dyr)
Jainism	Jainisme
Jakarta	Jakarta
Jalalabad	Jalalabad
Jamaica	Jamaica
Jamaica	Kategori:Jamaica
James	Jakob den Ældre
James A. Garfield	James A. Garfield
James Bond	James Bond
James Buchanan	James Buchanan
James Clerk Maxwell	James Clerk Maxwell
James Cook	James Cook
James Franck	James Franck
James Joyce	James Joyce
James K. Polk	James Polk
James Madison	James Madison
James Monroe	James Monroe
James Naismith	James Naismith
James Prescott Joule	James Prescott Joule
James Watt	James Watt
Jan Hus	Jan Hus
Jane Austen	Jane Austen
Jane Fonda	Jane Fonda
Jane Seymour	Jane Seymour
Janis Joplin	Janis Joplin
January	Januar
January 1	1. januar
January 19	19. januar
January 20	20. januar
January 6	6. januar
Janus (moon)	Janus (måne)
Janus (mythology)	Janus (gud)
Japan	Japan
Japan	Kategori:Japan
Jason	Jason
Jaundice	Gulsot
Java	Java (ø)
Java (disambiguation)	Java
Java (programming language)	Java (programmeringssprog)
Jawaharlal Nehru	Jawaharlal Nehru
Jazz	Jazz
Jazz	Kategori:Jazz
Jean Auguste Dominique Ingres	Jean Auguste Dominique Ingres
Jean Cocteau	Jean Cocteau
Jean Piaget	Jean Piaget
Jean Sibelius	Jean Sibelius
Jean de La Fontaine	Jean de La Fontaine
Jean-Jacques Rousseau	Jean-Jacques Rousseau
Jean-Paul Sartre	Jean-Paul Sartre
Jean-Philippe Rameau	Jean-Philippe Rameau
Jeddah	Jeddah
Jefferson City	Jefferson City
Jefferson Davis	Jefferson Davis
Jehovah's Witnesses	Jehovas Vidner
Jena	Jena
Jeremy Bentham	Jeremy Bentham
Jerez de la Frontera	Jerez de la Frontera
Jericho	Jeriko
Jerome	Hieronymus
Jersey	Jersey
Jerusalem	Jerusalem
Jerusalem	Kategori:Jerusalem
Jesus	Jesus fra Nazaret
Jet engine	Jetmotor
Jew	Jøde
Jew's harp	Jødeharpe
Jihad	Jihad
Jimi Hendrix	Jimi Hendrix
Jimmy Carter	Jimmy Carter
Joan of Arc	Jeanne d'Arc
Johann Bernoulli	Johann Bernoulli
Johann Sebastian Bach	Johann Sebastian Bach
Johann Wolfgang von Goethe	Johann Wolfgang von Goethe
Johannes Brahms	Johannes Brahms
Johannes Diderik van der Waals	Johannes Diderik van der Waals
Johannes Gutenberg	Johann Gutenberg
Johannes Kepler	Johannes Kepler
Johannes Vilhelm Jensen	Johannes V. Jensen
Johannesburg	Johannesburg
John Adams	John Adams
John Cage	John Cage
John Calvin	Jean Calvin
John Chrysostom	Johannes Chrysostomos
John Dalton	John Dalton
John Dewey	John Dewey
John Herschel	John Herschel
John Lennon	John Lennon
John Locke	John Locke
John Major	John Major
John Maynard Keynes	John Maynard Keynes
John Milton	John Milton
John Quincy Adams	John Quincy Adams
John Ruskin	John Ruskin
John Steinbeck	John Steinbeck
John Stuart Mill	John Stuart Mill
John Tyler	John Tyler
John Wayne	John Wayne
John Wycliffe	John Wycliffe
John the Baptist	Johannes Døberen
John von Neumann	John von Neumann
Johnny Cash	Johnny Cash
Joint	Led (anatomi)
Jonathan Swift	Jonathan Swift
Jordan	Jordan
Jordan	Kategori:Jordan
Jordan River	Jordan (flod)
Jorge Luis Borges	Jorge Luis Borges
Joseph Conrad	Joseph Conrad
Joseph Goebbels	Joseph Goebbels
Joseph Haydn	Joseph Haydn
Joseph McCarthy	Joseph McCarthy
Joseph Priestley	Joseph Priestley
Joseph Schumpeter	Joseph Schumpeter
Joseph Smith	Joseph Smith
Joseph Stalin	Josef Stalin
Josephus	Josefus
Joule	Joule
Journalism	Kategori:Journalistik
Journalist	Journalist
Judaism	Jødedom
Judaism	Kategori:Jødedom
Judas Iscariot	Judas Iskariot
Judea	Judæa
Judo	Judo
Judy Garland	Judy Garland
Jujutsu	Ju-jutsu
Jules Verne	Jules Verne
Julian calendar	Julianske kalender
Julian the Apostate	Julian den Frafaldne
Julius Caesar	Julius Cæsar
July	Juli
July 1	1. juli
July 4	4. juli
June	Juni
June 14	14. juni
June 21	21. juni
June 23	23. juni
June 24	24. juni
June 29	29. juni
June 3	3. juni
Juneau	Juneau
Juniper	Enebær
Juno (mythology)	Juno
Jupiter	Jupiter (planet)
Jupiter	Kategori:Jupiter
Jupiter (disambiguation)	Jupiter
Jupiter (mythology)	Jupiter (gud)
Jurassic	Jura (geologi)
Justinian I	Justinian 1.
Jutland	Jylland
K	K
K2	K2
KGB	KGB
Kaaba	Ka'ba
Kabbalah	Kabbala
Kabul	Kabul
Kalahari Desert	Kalahari-ørkenen
Kamchatka Peninsula	Kamtjatka
Kamikaze	Kamikaze
Kampala	Kampala
Kandahar	Kandahar
Kangaroo	Kænguru
Kansas	Kansas
Kansas	Kategori:Kansas
Kappa	Kappa
Kara Sea	Karahavet
Karachi	Karachi
Karate	Karate
Karen Blixen	Karen Blixen
Karl Barth	Karl Barth
Karl Jaspers	Karl Jaspers
Karl Marx	Karl Marx
Karl Popper	Karl Popper
Karma	Karma
Karnataka	Karnataka
Katharine Hepburn	Katharine Hepburn
Kathmandu	Katmandu
Katowice	Katowice
Kaunas	Kaunas
Kayak	Kajak
Kazakhstan	Kasakhstan
Kazakhstan	Kategori:Kasakhstan
Kazan	Kazan
Kelvin	Kelvin
Kent	Kent
Kentucky	Kentucky
Kentucky	Kategori:Kentucky
Kenya	Kenya
Kenya	Kategori:Kenya
Kernel (computer science)	Kerne (styresystem)
Kerosene	Petroleum
Ketchup	Ketchup
Ketone	Keton
Keyboard (computing)	Tastatur
Keyboard instrument	Keyboard (instrument)
Khan	Khan
Kharkiv	Kharkiv
Khartoum	Khartoum
Khmer Rouge	De Røde Khmerer
Khufu	Keops
Kibbutz	Kibbutz
Kidney	Nyre
Kiev	Kiev
Kigali	Kigali
Kilobyte	Kilobyte
Kilogram	Kilogram
Kimono	Kimono
Kindergarten	Børnehave
Kinematics	Kinematik
Kinetic energy	Kinetisk energi
King (chess)	Konge (skak)
King Arthur	Kong Arthur
Kingston	Kingston (Jamaica)
Kinshasa	Kinshasa
Kiribati	Kiribati
Kiribati	Kategori:Kiribati
Kirkuk	Kirkuk
Kiss	Kys
Kite	Drage (snorholdt)
Kiwi	Kiwier
Knesset	Knesset
Knife	Kniv
Knight	Ridder
Knight (chess)	Springer (skak)
Knossos	Knossos
Knot (speed)	Knob (skibsterminologi)
Knowledge	Viden
Knut Hamsun	Knut Hamsun
Koala	Koala
Kobe	Kobe
Kola Peninsula	Kolahalvøen
Kolkata	Calcutta
Komodo dragon	Komodovaran
Konqueror	Konqueror
Konrad Adenauer	Konrad Adenauer
Korea	Korea
Korea	Kategori:Korea
Korean War	Koreakrigen
Kosovo	Kosovo
Kosovo	Kategori:Kosovo
Krakatoa	Krakatau
Kremlin	Kreml
Krishna	Krishna
Krypton	Krypton
Ku Klux Klan	Ku Klux Klan
Kuala Lumpur	Kuala Lumpur
Kublai Khan	Kublai Khan
Kuiper belt	Kuiperbæltet
Kumquat	Limequat
Kung fu (term)	Kungfu
Kuomintang	Kuomintang
Kura River	Mtkvari
Kurdistan	Kurdistan
Kurdistan	Kategori:Kurdistan
Kurdistan Workers Party	PKK
Kurt Vonnegut	Kurt Vonnegut
Kurt Waldheim	Kurt Waldheim
Kuwait	Kuwait
Kuwait	Kategori:Kuwait
KwaZulu-Natal	KwaZulu-Natal
Kyoto	Kyoto
Kyrgyzstan	Kirgisistan
Kyrgyzstan	Kategori:Kirgisistan
L	L
LAMP (software bundle)	LAMP
La Paz	La Paz
La Plata	La Plata
La Spezia	La Spezia
LaTeX	LaTeX
Laboratory	Laboratorium
Labour Party (UK)	Labour
Labrador Retriever	Labrador retriever
Lacerta	Firbenet
Lactic acid	Mælkesyre
Lactose	Laktose
Lady Jane Grey	Lady Jane Grey
Lagomorpha	Støttetandede
Lagos	Lagos
Lahore	Lahore
Laissez-faire	Laissez faire
Lake	Sø
Lake Baikal	Bajkalsøen
Lake Chad	Tchad-søen
Lake Constance	Bodensøen
Lake Erie	Lake Erie
Lake Eyre	Lake Eyre
Lake Geneva	Genevesøen
Lake Huron	Lake Huron
Lake Ladoga	Ladoga
Lake Malawi	Lake Nyasa
Lake Michigan	Lake Michigan
Lake Onega	Onega
Lake Ontario	Lake Ontario
Lake Superior	Øvre sø
Lake Tanganyika	Tanganyikasøen
Lake Victoria	Victoriasøen
Lakshmi	Lakshmi
Lambda	Lambda (bogstav)
Lamiaceae	Læbeblomst-familien
Lamprey	Lampret
Lancashire	Lancashire
Landfill	Losseplads
Language	Sprog
Languedoc-Roussillon	Languedoc-Roussillon
Lansing	Lansing
Lanthanide	Lanthanider
Lanthanum	Lanthan
Laos	Laos
Laos	Kategori:Laos
Laptev Sea	Laptevhavet
Laptop	Bærbar computer
Larch	Lærk
Larva	Larve
Las Vegas	Las Vegas
Lascaux	Lascaux-hulerne
Laser	Laser
Lathe	Drejebænk
Latin	Latin
Latin America	Latinamerika
Latvia	Letland
Latvia	Kategori:Letland
Laughter	Latter
Laurasia	Laurasien
Lausanne	Lausanne
Lava	Lava
Law	Jura
Law	Kategori:Jura
Law enforcement	Kategori:Politi
Lawrencium	Lawrencium
Lawyer	Jurist
Lazio	Lazio
Le Corbusier	Le Corbusier
Le Havre	Le Havre
Lead	Bly
Leaf	Blad (plantedel)
League of Nations	Folkeforbundet
Leap year	Skudår
Learning	Læring
Lebanon	Libanon
Lebanon	Kategori:Libanon
Leda (mythology)	Leda
Lee Harvey Oswald	Lee Harvey Oswald
Leeds	Leeds
Left-handed	Venstrehåndet
Legend	Sagn
Legislature	Lovgivende magt
Lego	LEGO
Leicester	Leicester
Leiden	Leiden
Leipzig	Leipzig
Lemon	Citron
Length	Længde
Lens (optics)	Optisk linse
Lentil	Linser
Leo (constellation)	Løven (stjernebillede)
Leon Trotsky	Lev Trotskij
Leonard Bernstein	Leonard Bernstein
Leonardo da Vinci	Leonardo da Vinci
Leonhard Euler	Leonhard Euler
Leonid Brezhnev	Leonid Bresjnev
Leopard	Leopard
Lepidoptera	Natsværmere og sommerfugle
Leprosy	Spedalskhed
Lepton	Lepton
Lepus (constellation)	Haren
Lesotho	Lesotho
Lesotho	Kategori:Lesotho
Lesser Antilles	Små Antiller
Leto	Leto
Letter (alphabet)	Bogstav
Leukemia	Leukæmi
Lever	Vægtstang
Leviathan	Livjatan (havuhyre)
Leviticus	Tredje Mosebog
Lewis Carroll	Lewis Carroll
Lhasa	Lhasa
Lhotse	Lhotse
Liberalism	Liberalisme
Liberalism	Kategori:Liberalisme
Liberation Tigers of Tamil Eelam	De Tamilske Tigre
Liberia	Liberia
Liberia	Kategori:Liberia
Libra (constellation)	Vægten
Library	Bibliotek
Libretto	Libretto
Libreville	Libreville
Libya	Libyen
Libya	Kategori:Libyen
Lichen	Lav (symbiotisk organisme)
Lie	Løgn
Liechtenstein	Liechtenstein
Liechtenstein	Kategori:Liechtenstein
Lieutenant	Løjtnant
Life	Liv
Life	Kategori:Liv
Light	Lys
Light-emitting diode	Lysdiode
Light-year	Lysår
Lighter	Lighter
Lighthouse	Fyr (navigation)
Lightning	Lyn
Liguria	Liguria
Liliaceae	Lilje-familien
Lilith	Lilith
Lille	Lille
Lilongwe	Lilongwe
Lima	Lima
Limerick	Limerick (by)
Limit (mathematics)	Grænseværdi (matematik)
Limousin (region)	Limousin
Lincoln	Lincoln (Nebraska)
Lincoln	Lincoln
Line (mathematics)	Linje
Linear algebra	Lineær algebra
Linear algebra	Kategori:Lineær algebra
Lingua franca	Lingua franca
Linguistics	Sprogforskning
Linguistics	Kategori:Sprogforskning
Linus Pauling	Linus Pauling
Linux	Linux
Linux	Kategori:Linux
Linz	Linz
Lion	Løve
Lipid	Lipid
Liqueur	Likør
Liquid	Væske
Liquid crystal display	LCD
Liquorice	Glat Lakrids
Lisbon	Lissabon
Lise Meitner	Lise Meitner
Lisp (programming language)	Lisp
Literacy	Læsefærdighed
Literature	Litteratur
Literature	Kategori:Litteratur
Lithium	Lithium
Lithography	Litografi
Lithosphere	Lithosfære
Lithuania	Litauen
Lithuania	Kategori:Litauen
Litre	Liter
Little Owl	Kirkeugle
Liverpool	Liverpool
Livonia	Livland
Livy	Livius
Ljubljana	Ljubljana
Loanword	Låneord
Local area network	LAN
Loch Ness	Loch Ness
Loch Ness Monster	Loch Ness-uhyret
Locomotive	Lokomotiv
Logarithm	Logaritme
Logic	Logik
Logic	Kategori:Logik
Logic gate	Gate (digital elektronik)
Logistics	Logistik
Logo	Logo
Loire	Loire (departement)
Loire River	Loire
Loki	Loke
Lolita	Lolita
Lombardy	Lombardiet
London	London
London	Kategori:London
Long Beach	Long Beach
Long Island	Long Island
Long jump	Længdespring
Long-eared Owl	Skovhornugle
Lord's Prayer	Fader vor
Lorraine (region)	Lorraine
Los Angeles	Los Angeles
Lot (department)	Lot (departement)
Loudspeaker	Højttaler
Louis Armstrong	Louis Armstrong
Louis Braille	Louis Braille
Louis Pasteur	Louis Pasteur
Louis the Pious	Ludvig den Fromme
Louis the Stammerer	Ludvig den Stammende
Louisiana	Louisiana
Louisiana	Kategori:Louisiana
Louisville	Louisville
Louvre	Louvre
Love	Kærlighed
Low German	Plattysk
Lower Saxony	Niedersachsen
Luanda	Luanda
Lublin	Lublin
Lucerne	Luzern
Luciano Pavarotti	Luciano Pavarotti
Lucifer	Lucifer
Lucretius	Lukrets
Lucrezia Borgia	Lucrezia Borgia
Ludwig Mies van der Rohe	Ludwig Mies van der Rohe
Ludwig Wittgenstein	Ludwig Wittgenstein
Ludwig van Beethoven	Ludwig van Beethoven
Luftwaffe	Luftwaffe
Luigi Galvani	Luigi Galvani
Luigi Pirandello	Luigi Pirandello
Lumen (unit)	Lumen
Luminescence	Luminescens
Lunar eclipse	Måneformørkelse
Lund	Lund (Sverige)
Lung	Lunge
Lung cancer	Lungekræft
Lungfish	Lungefisk
Lupus (constellation)	Ulven
Lusaka	Lusaka
Lusitania	Lusitania
Lute	Lut
Lutetium	Lutetium
Lutheranism	Lutheranisme
Lux	Lux
Luxembourg	Luxembourg
Luxembourg	Kategori:Luxembourg
Luxembourg (city)	Luxembourg (by)
Luxor	Luxor
Luzon	Luzon
Lychee	Litchi
Lydia	Lydien
Lymphatic system	Lymfesystem
Lynx (constellation)	Lossen
Lyon	Lyon
Lyra	Lyren
Lysergic acid diethylamide	LSD
Lysosome	Lysosom
M	M
MESSENGER	MESSENGER (rumsonde)
MS-DOS	MS-DOS
Macau	Macao
Macbeth	Macbeth
Macedonia	Makedonien (flertydig)
Macedonia (Greece)	Makedonien (græsk region)
Mach number	Mach
Machine	Maskine
Machine code	Maskinkode
Machine gun	Maskingevær
Machine translation	Maskinoversættelse
Machu Picchu	Machu Picchu
Macintosh	Apple Macintosh
Macroeconomics	Makroøkonomi
Macroeconomics	Kategori:Makroøkonomi
Madagascar	Madagaskar
Madagascar	Kategori:Madagaskar
Madeira	Madeira (ø)
Madison	Madison (Wisconsin)
Madonna (entertainer)	Madonna
Madrid	Madrid
Mafia	Mafia
Magazine	Tidsskrift
Maghreb	Maghreb
Magic (paranormal)	Magi
Magic square	Magisk kvadrat
Maginot Line	Maginot-linjen
Magma	Magma
Magna Carta	Magna Carta
Magnesium	Magnesium
Magnet	Magnet
Magnetic field	Magnetfelt
Magnetism	Magnetisme
Magnetism	Kategori:Magnetisme
Maharashtra	Maharashtra
Mahatma Gandhi	Mahatma Gandhi
Mahayana	Mahayana
Maimonides	Maimonides
Main	Main
Maine	Maine
Maine	Kategori:Maine
Mainframe computer	Mainframe
Maize	Majs
Major	Major
Major scale	Dur
Majorca	Mallorca
Makalu	Makalu
Malabo	Malabo
Malacostraca	Storkrebs
Malaria	Malaria
Malawi	Kategori:Malawi
Malay Peninsula	Malayahalvøen
Malayan Tapir	Skaberaktapir
Malaysia	Malaysia
Malaysia	Kategori:Malaysia
Malcolm X	Malcolm X
Maldives	Maldiverne
Maldives	Kategori:Maldiverne
Mali	Mali
Mali	Kategori:Mali
Mallard	Gråand
Malta	Malta
Malta	Kategori:Malta
Maltese language	Maltesisk (sprog)
Maltose	Maltose
Malvaceae	Katost-familien
Mammal	Pattedyr
Mammoth	Mammut
Management	Management
Managua	Managua
Manama	Manama
Manatee	Manater
Manchester	Manchester
Manchuria	Manchuriet
Mandala	Mandala
Mandarin (linguistics)	Mandarin (sprog)
Mandarin orange	Mandarin (frugt)
Manganese	Mangan
Mango	Mango
Manhattan	Manhattan
Manhattan Project	Manhattan Project
Manila	Manila
Manipur	Manipur
Manitoba	Manitoba
Mannerism	Manierisme
Mannheim	Mannheim
Mantle (geology)	Kappe (geologi)
Mantra	Mantra
Mantua	Mantova
Manuel de Falla	Manuel de Falla
Manuscript	Manuskript
Mao Zedong	Mao Zedong
Maoism	Maoisme
Map	Kort (geografi)
Maple	Løn-slægten
Maputo	Maputo
Marathon	Maratonløb
Marble	Marmor
Marc Chagall	Marc Chagall
Marcel Duchamp	Marcel Duchamp
Marcel Marceau	Marcel Marceau
Marcel Proust	Marcel Proust
March	Marts
March 17	17. marts
March 19	19. marts
March 2	2. marts
March 25	25. marts
Marche	Marche
Marco Polo	Marco Polo
Marcus Aurelius	Marcus Aurelius
Marcus Junius Brutus	Marcus Junius Brutus
Marcus Vipsanius Agrippa	Marcus Vipsanius Agrippa
Marduk	Marduk
Margaret Thatcher	Margaret Thatcher
Maria Callas	Maria Callas
Marie Antoinette	Marie-Antoinette
Marie Curie	Marie Curie
Mariehamn	Mariehamn
Marilyn Monroe	Marilyn Monroe
Mario Vargas Llosa	Mario Vargas Llosa
Mark Antony	Marcus Antonius
Mark Twain	Mark Twain
Marketing	Markedsføring
Marketing	Kategori:Markedsføring
Markup language	Opmærkningssprog
Marlene Dietrich	Marlene Dietrich
Marquis de Sade	Markis de Sade
Marrakech	Marrakech
Marriage	Ægteskab
Mars	Kategori:Mars
Mars (disambiguation)	Mars
Mars (mythology)	Mars (gud)
Marseille	Marseille
Marshall Islands	Marshalløerne
Marshall Islands	Kategori:Marshalløerne
Marshall Plan	Marshall-planen
Marsupial	Pungdyr
Martin Buber	Martin Buber
Martin Heidegger	Martin Heidegger
Martin Luther	Martin Luther
Martin Luther King	Martin Luther King
Martin Scorsese	Martin Scorsese
Martin Van Buren	Martin Van Buren
Martinique	Martinique
Martyr	Martyr
Marx Brothers	Marx Brothers
Marxism	Marxisme
Marxism	Kategori:Marxisme
Mary (mother of Jesus)	Jomfru Maria
Mary Magdalene	Maria Magdalene
Mary Shelley	Mary Shelley
Mary Wollstonecraft	Mary Wollstonecraft
Maryland	Maryland
Maryland	Kategori:Maryland
Maseru	Maseru
Mashhad	Mashhad
Mass	Masse (fysik)
Massachusetts	Massachusetts
Massachusetts	Kategori:Massachusetts
Massachusetts Institute of Technology	Massachusetts Institute of Technology
Masturbation	Onani
Mata Hari	Mata Hari
Match	Tændstik
Materialism	Materialisme
Mathematical proof	Bevis (matematik)
Mathematics	Matematik
Mathematics	Kategori:Matematik
Matrix (mathematics)	Matrix
Matter	Stof (fysik)
Matterhorn	Matterhorn
Mauna Kea	Mauna Kea
Mauna Loa	Mauna Loa
Maundy Thursday	Skærtorsdag
Maurice Ravel	Maurice Ravel
Mauritania	Mauretanien
Mauritania	Kategori:Mauretanien
Mauritius	Mauritius
Mauritius	Kategori:Mauritius
Max Bruch	Max Bruch
Max Planck	Max Planck
Max Weber	Max Weber
Maximian	Maximian Herculius
Maxwell's equations	Maxwells ligninger
May	Maj
May 1	1. maj
May 24	24. maj
Mayenne	Mayenne
Mayfly	Døgnflue
Mayonnaise	Mayonnaise
Mayor	Borgmester
Mbabane	Mbabane
McCarthyism	Mccarthyisme
Mead	Mjød
Measles	Mæslinger
Measure (mathematics)	Målteori
Measurement	Kategori:Mål
Meat	Kød
Mecca	Mekka
Mechanical engineering	Maskiningeniør
Mechanical engineering	Kategori:Maskinarbejde
Mechanics	Kategori:Mekanik
Mechanics	Mekanik
Medea	Medea
Median	Median
Medication	Lægemiddel
Medici	Medici
Medicine	Lægevidenskab
Medicine	Kategori:Lægevidenskab
Medina	Medina
Meditation	Meditation
Mediterranean Sea	Middelhavet
Medusa	Medusa
Meerkat	Surikat
Megabyte	Megabyte
Meiosis	Meiose
Meister Eckhart	Mester Eckehart
Meitnerium	Meitnerium
Mekong	Mekong
Mel Gibson	Mel Gibson
Melanesia	Melanesien
Melody	Melodi
Melpomene	Melpomene
Melting	Smeltning
Melting point	Smeltepunkt
Memory	Hukommelse
Memphis	Memphis (Tennessee)
Memphis	Memphis (Ægypten)
Menachem Begin	Menachem Begin
Mendelevium	Mendelevium
Menelaus	Menelaos
Meningitis	Meningitis
Mensa (constellation)	Taffelbjerget (stjernebillede)
Menstrual cycle	Menstruation
Menstruation	Menstruation
Mental disorder	Psykisk sygdom
Mentha	Mynte
Mercantilism	Merkantilisme
Mercenary	Lejesoldat
Mercury	Merkur
Mercury (element)	Kviksølv
Mercury (mythology)	Merkur (gud)
Mercury (planet)	Merkur (planet)
Meridian (geography)	Meridian
Meritocracy	Meritokrati
Mermaid	Havfrue
Merovingian	Merovinger
Meryl Streep	Meryl Streep
Mescaline	Meskalin
Mesolithic	Ældre stenalder
Mesopotamia	Mesopotamien
Mesopotamia	Kategori:Mesopotamien
Mesosphere	Mesosfære
Mesozoic	Mesozoikum
Messenger RNA	MRNA
Messiah	Messias
Messina	Messina
Metabolism	Stofskifte
Metadata	Metadata
Metal	Metal
Metalloid	Halvmetal
Metallurgy	Metallurgi
Metallurgy	Kategori:Metallurgi
Metaphor	Metafor
Metaphysics	Metafysik
Metaphysics	Kategori:Metafysik
Metastasis	Metastase
Meteoroid	Meteoroid
Meteorology	Kategori:Meteorologi
Meteorology	Meteorologi
Methadone	Metadon
Methamphetamine	Methamfetamin
Methanol	Metanol
Methodism	Metodisme
Metis (moon)	Metis (måne)
Metonymy	Metonymi
Metre	Meter
Metric space	Metrisk rum
Meuse	Meuse (departement)
Meuse River	Meuse
Mexico	Mexico
Mexico	Kategori:Mexico
Mexico City	Mexico City
Miami	Miami
Mica	Glimmer
Michael (archangel)	Ærkeenglen Mikael
Michael Faraday	Michael Faraday
Michel Ney	Michel Ney
Michelangelo	Michelangelo
Michigan	Michigan
Michigan	Kategori:Michigan
Mick Jagger	Mick Jagger
Mickey Mouse	Mickey Mouse
Microbiology	Mikrobiologi
Microbiology	Kategori:Mikrobiologi
Microeconomics	Mikroøkonomi
Microeconomics	Kategori:Mikroøkonomi
Micronesia	Mikronesien (område)
Microorganism	Mikroorganisme
Microphone	Mikrofon
Microprocessor	Mikroprocessor
Microscope	Mikroskop
Microscopium	Mikroskopet
Microwave	Mikrobølge
Microwave oven	Mikrobølgeovn
Middle Ages	Middelalderen
Middle Ages	Kategori:Middelalder
Middle East	Mellemøsten
Middle East	Kategori:Mellemøsten
Midnight sun	Midnatssol
Migraine	Migræne
Miguel de Cervantes	Miguel de Cervantes
Mike Tyson	Mike Tyson
Mikhail Bakunin	Mikhail Bakunin
Mikhail Glinka	Mikhail Glinka
Mikhail Gorbachev	Mikhail Gorbatjov
Milan	Milano
Mile	Mil
Miles Davis	Miles Davis
Military	Kategori:Militær
Military rank	Militær rang
Milk	Mælk
Milky Way	Mælkevejen
Millard Fillmore	Millard Fillmore
Millennium	Millennium
Million	Million
Millipede	Tusindben
Milton Friedman	Milton Friedman
Milwaukee	Milwaukee
Minaret	Minaret
Mindanao	Mindanao
Mineral	Mineral
Mineralogy	Mineralogi
Mineralogy	Kategori:Mineralogi
Minerva	Minerva
Ming Dynasty	Ming-dynastiet
Minimalism	Minimalisme
Mining	Minedrift
Minneapolis	Minneapolis
Minnesota	Minnesota
Minnesota	Kategori:Minnesota
Minoan civilization	Minoisk kultur
Minor scale	Mol (toneart)
Minos	Minos
Minotaur	Minotauros
Minsk	Minsk
Minute	Minut
Miocene	Miocæn
Miracle	Mirakel
Mirror	Spejl
Mishnah	Mishna
Mississippi	Kategori:Mississippi
Mississippi River	Mississippifloden
Missouri	Missouri
Missouri	Kategori:Missouri
Missouri River	Missouri-floden
Mitochondrion	Mitokondrie
Mnemosyne	Mnemosyne
Mobile phone	Mobiltelefon
Modem	Modem
Modernism	Modernisme
Modest Mussorgsky	Modest Mussorgskij
Modulation	Modulation
Mogadishu	Mogadishu
Mold	Skimmelsvamp
Moldova	Moldova
Moldova	Kategori:Moldova
Mole (unit)	Mol (enhed)
Molecular biology	Molekylærbiologi
Molecular biology	Kategori:Molekylærbiologi
Molecule	Molekyle
Molise	Molise
Mollusca	Bløddyr
Molotov cocktail	Molotovcocktail
Molybdenum	Molybdæn
Mombasa	Mombasa
Momentum	Impuls (fysik)
Monaco	Monaco
Monaco	Kategori:Monaco
Monarch	Monark
Monarchy	Monark
Monastery	Kloster
Monday	Mandag
Money	Penge
Mongolia	Mongoliet
Mongolia	Kategori:Mongoliet
Monocotyledon	Enkimbladede
Monopoly	Monopol
Monopoly (game)	Matador (brætspil)
Monosodium glutamate	Mononatriumglutamat
Monotheism	Monoteisme
Monotreme	Kloakdyr
Monroe Doctrine	Monroedoktrinen
Monrovia	Monrovia
Mons	Mons
Monsoon	Monsun
Mont Blanc	Mont Blanc
Montana	Montana
Montana	Kategori:Montana
Monte Carlo	Monte Carlo
Montenegro	Montenegro
Montenegro	Kategori:Montenegro
Monterrey	Monterrey
Montevideo	Montevideo
Montgomery	Montgomery
Month	Måned
Montpelier	Montpelier
Montreal	Montreal
Montserrat	Montserrat
Moon	Månen
Moose	Elg
Moravia	Mähren
Morocco	Marokko
Morocco	Kategori:Marokko
Morpheme	Morfem
Morphine	Morfin
Morphology	Morfologi
Morphology (linguistics)	Morfologi (lingvistik)
Morse code	Morsealfabet
Mortar (weapon)	Mortér
Mosaic	Mosaik
Moscow	Moskva
Moscow	Kategori:Moskva
Moselle	Moselle
Moses	Moses
Moshe Dayan	Moshe Dayan
Mosque	Moske
Mosquito	Stikmyg
Moss	Mosser
Mossad	Mossad
Mosul	Mosul
Motet	Motet
Mother Teresa	Moder Teresa
Mother's Day	Mors dag
Motorcycle	Motorcykel
Motto	Motto
Mount Ararat	Ararats bjerg
Mount Etna	Etna
Mount Everest	Mount Everest
Mount Fuji	Fuji
Mount Kilimanjaro	Kilimanjaro
Mount McKinley	Mount McKinley
Mount Olympus	Olympen
Mount Pinatubo	Pinatubo
Mount Rushmore	Mount Rushmore
Mount St. Helens	Mount St. Helens
Mount Vesuvius	Vesuv
Mountain	Bjerg
Mountain bike	Mountainbike
Mountain pass	Bjergpas
Mountain range	Bjergkæde
Mouse	Mus
Mouse (computing)	Computermus
Mozambique	Mozambique
Mozambique	Kategori:Mozambique
Mu (letter)	My (bogstav)
Muezzin	Muaddhin
Muhammad	Muhammed
Muhammad Ali	Muhammad Ali
Mulberry	Morbær
Mule	Muldyr
Multimedia	Multimedia
Multiple sclerosis	Multipel sklerose
Multiplication	Multiplikation
Mumbai	Mumbai
Mummy	Mumie
Munich	München
Municipality	Kommune
Murmansk	Murmansk
Murphy's law	Murphy's lov
Musa (genus)	Banan-slægten
Musca	Fluen
Muscat	Muscat
Muscle	Muskel
Muse	Muse
Museum	Museum
Mushroom	Svampe
Music	Musik
Music	Kategori:Musik
Musical Instrument Digital Interface	MIDI
Musical instrument	Musikinstrument
Musician	Musiker
Musicology	Musikvidenskab
Mustelidae	Mårfamilien
Mutation	Mutation
Mute Swan	Knopsvane
Myanmar	Kategori:Burma
Mycenae	Mykene
Myopia	Nærsynethed
Mysticism	Mystik
Myth	Myte
Mythology	Mytologi
Mythology	Kategori:Mytologi
N	N
N'Djamena	N'Djamena
NASDAQ	NASDAQ
NATO	NATO
NATO	Kategori:NATO
Nadir	Nadir
Nagasaki	Nagasaki
Nagoya	Nagoya
Nahuatl	Nahuatl
Nail (fastener)	Søm
Nairobi	Nairobi
Namib Desert	Namibørkenen
Namibia	Namibia
Namibia	Kategori:Namibia
Nancy	Nancy
Nanga Parbat	Nanga Parbat
Nanjing	Nanjing
Nanotechnology	Nanoteknologi
Nantes	Nantes
Napalm	Napalm
Naples	Napoli
Napoleonic Wars	Napoleonskrigene
Narcissus (mythology)	Narkissos
Nashville	Nashville
Nassau	Nassau (Bahamas)
Nathaniel Hawthorne	Nathaniel Hawthorne
Nation	Nation
National Security Agency	NSA
National anthem	Nationalsang
National park	Nationalpark
Nationalism	Nationalisme
Nationalism	Kategori:Nationalisme
Natural gas	Naturgas
Natural language processing	Sprogteknologi
Natural number	Naturligt tal
Natural science	Naturvidenskab
Natural selection	Naturlig selektion
Nature	Natur
Nature	Kategori:Natur
Naturism	Naturisme
Nauru	Nauru
Nauru	Kategori:Nauru
Nautical mile	Sømil
Navigation	Kategori:Navigation
Navigation	Navigation
Navy	Marine
Nazareth	Nazareth
Nazi Germany	Nazi-Tyskland
Nazi Germany	Kategori:Nazityskland
Nazi Party	NSDAP
Nazism	Kategori:Nazisme
Neanderthal	Neandertaler
Nebraska	Nebraska
Nebraska	Kategori:Nebraska
Nebuchadrezzar II	Nebukadnesar II
Nebula	Stjernetåge
Neckar	Neckar
Necktie	Slips
Nefertiti	Nefertiti
Negev	Negev
Neil Armstrong	Neil Armstrong
Nelson Mandela	Nelson Mandela
Nematode	Rundorme
Nemesis (mythology)	Nemesis
Neodymium	Neodym
Neolithic	Yngre stenalder
Neologism	Nydannelse
Neon	Neon
Neoplatonism	Neoplatonisme
Nepal	Nepal
Nepal	Kategori:Nepal
Nephthys	Nephthys
Neptune	Neptun (planet)
Neptunium	Neptunium
Nereid (moon)	Nereid
Nero	Nero
Nerva	Nerva
Nervous system	Nervesystemet
Nest	rede
Netherlands	Holland
Netherlands	Kategori:Nederlandene
Netherlands Antilles	Nederlandske Antiller
Neurology	Neuromedicin
Neuron	Neuron
Neurotransmitter	Neurotransmitter
Neutrino	Neutrino
Neutron	Neutron
Neutron star	Neutronstjerne
Neva River	Neva
Nevada	Nevada
Nevada	Kategori:Nevada
Neville Chamberlain	Neville Chamberlain
New Brunswick	New Brunswick
New Caledonia	Ny Kaledonien
New Delhi	New Delhi
New England	New England
New Guinea	Ny Guinea
New Hampshire	New Hampshire
New Hampshire	Kategori:New Hampshire
New Jersey	New Jersey
New Jersey	Kategori:New Jersey
New Mexico	New Mexico
New Mexico	Kategori:New Mexico
New Orleans	New Orleans
New South Wales	New South Wales
New Testament	Det Nye Testamente
New World	Nye Verden
New Year	Nytår
New York	New York (delstat)
New York	Kategori:New York
New York (disambiguation)	New York (flertydig)
New York City	New York
New York City	Kategori:New York City
New York Stock Exchange	New York Stock Exchange
New Zealand	New Zealand
New Zealand	Kategori:New Zealand
Newark	Newark
Newfoundland (island)	Newfoundland
Newfoundland and Labrador	Newfoundland og Labrador
Newport	Newport
Newton	Newton (enhed)
Niacin	Niacin
Niagara Falls	Niagaravandfaldene
Niamey	Niamey
Nicaragua	Nicaragua
Nicaragua	Kategori:Nicaragua
Nice	Nice
Nicene Creed	Den nikæno-konstantinopolitanske trosbekendelse
Nicholas	Petrović Njegoš
Nickel	Nikkel
Nicolas Poussin	Nicolas Poussin
Nicolaus Copernicus	Nicolaus Kopernikus
Nicosia	Nicosia
Nicotine	Nikotin
Niels Bohr	Niels Bohr
Niels Henrik Abel	Niels Henrik Abel
Niger	Niger
Niger	Kategori:Niger
Niger River	Niger (flod)
Nigeria	Nigeria
Nigeria	Kategori:Nigeria
Night	Nat (tidsrum)
Nightingale	Sydlig nattergal
Nihilism	Nihilisme
Nijmegen	Nijmegen
Nike	Nike, Inc.
Nike (mythology)	Nike (mytologi)
Nikita Khrushchev	Nikita Khrusjtjov
Nikola Tesla	Nikola Tesla
Nile	Nilen
Nineveh	Ninive
Ninja	Ninja
Niobium	Niobium
Nirvana	Nirvana
Nitric acid	Salpetersyre
Nitrogen	Kvælstof
Nitroglycerin	Nitroglycerin
Nix (moon)	Nix
Njord	Njord
Noah	Noa
Noam Chomsky	Noam Chomsky
Nobel Prize	Nobelprisen
Nobel Prize	Kategori:Nobelprisen
Nobelium	Nobelium
Nobility	Adel
Nobility	Kategori:Adel
Noble gas	Ædelgas
Nominative case	Nominativ
Nonmetal	Ikke-metal
Norfolk Island	Norfolk Island
Norma (constellation)	Vinkelmåleren
Normal distribution	Normalfordeling
Norman Mailer	Norman Mailer
Normandy	Normandiet
Norn	Norner
Norse mythology	Nordisk mytologi
Norse mythology	Kategori:Nordisk mytologi
North	Kompasretning#Nord
North America	Nordamerika
North America	Kategori:Nordamerika
North Carolina	North Carolina
North Carolina	Kategori:North Carolina
North Dakota	North Dakota
North Dakota	Kategori:North Dakota
North Island	Nordøen
North Korea	Nordkorea
North Korea	Kategori:Nordkorea
North Pole	Nordpolen
North Sea	Nordsøen
Northern Europe	Nordeuropa
Northern Hemisphere	Nordlige halvkugle
Northern Ireland	Nordirland
Northern Ireland	Kategori:Nordirland
Northern Mariana Islands	Nordmarianerne
Northern Territory	Northern Territory
Northern pike	Gedde
Northwest Territories	Northwest Territories
Norway	Norge
Norway	Kategori:Norge
Norwegian Sea	Norskehavet
Norwegian krone	Norske kroner
Nose	Næse
Nostradamus	Nostradamus
Note	Node
Nouakchott	Nouakchott
Noun	Navneord
Nova Scotia	Nova Scotia
Novaya Zemlya	Novaja Zemlja
Novel	Roman
November	November
November 1	1. november
November 11	11. november
November 2	2. november
November 5	5. november
Novial	Novial
Novosibirsk	Novosibirsk
Nuclear fission	Fission
Nuclear fusion	Fusion
Nuclear physics	Kernefysik
Nuclear physics	Kategori:Kernefysik
Nuclear power	Kernekraft
Nuclear weapon	Kernevåben
Nucleic acid	Nukleinsyre
Nucleon	Nukleon
Nucleotide	Nukleotid
Number	Tal
Numbers	Kategori:Tal
Numidia	Numidien
Numismatics	Numismatik
Numismatics	Kategori:Numismatik
Nunavut	Nunavut
Nuremberg	Nürnberg
Nut (fruit)	Nød
Nutmeg	Muskatnød
Nutrition	Kategori:Ernæring
Nymph	Nymfe (mytologi)
Nymphaeaceae	Nøkkerose-familien
Nyx (mythology)	Nyx
O	O
OPEC	OPEC
Oahu	Oahu
Oak	Eg
Oakland	Oakland
Oasis	Oase
Oat	Almindelig Havre
Oaxaca	Oaxaca (stat)
Ob River	Ob
Obelisk	Obelisk
Obesity	Overvægt
Object-oriented programming	Objektorienteret programmering
Oboe	Obo
Observatory	Observatorium
Obsidian	Obsidian
Occam's razor	Ockhams ragekniv
Ocean	Verdenshave
Ocean current	Havstrøm
Oceania	Oceanien
Oceania	Kategori:Oceanien
Oceanid	Okeanide
Oceanography	Oceanografi
Oceanography	Kategori:Oceanografi
Oceanus	Okeanos
Octal	Oktale talsystem
Octans	Oktanten
Octave	Oktav
October	Oktober
October 12	12. oktober
October 24	24. oktober
October Revolution	Oktoberrevolutionen
Ode	Ode
Oder River	Oder
Odessa	Odessa
Odin	Odin
Odonata	Guldsmede
Odysseus	Odysseus
Odyssey	Odysseen
Oedipus	Ødipus
Offside (football)	Offside
Ohio	Ohio
Ohio	Kategori:Ohio
Ohm	Ohm
Ohm's law	Ohms lov
Oil	Olie
Oil (disambiguation)	Olie (flertydig)
Okapi	Okapi
Oklahoma	Oklahoma
Oklahoma	Kategori:Oklahoma
Oklahoma City	Oklahoma City
Oktoberfest	Oktoberfest
Old Church Slavonic	Oldkirkeslavisk
Old Norse	Norrønt
Old Testament	Det Gamle Testamente
Oligarchy	Oligarki
Oligocene	Oligocæn
Oligopoly	Oligopol
Olive	Oliven
Olive oil	Olivenolie
Oliver Cromwell	Oliver Cromwell
Oliver Stone	Oliver Stone
Olivine	Olivin
Olympia	Olympia (Washington)
Olympia	Olympia (oldtiden)
Olympic Games	Olympiske lege
Olympics	Kategori:Olympiske lege
Omaha	Omaha
Oman	Oman
Oman	Kategori:Oman
Omega	Omega (bogstav)
Omicron	Omikron
Omsk	Omsk
Oncology	Kategori:Onkologi
Onion	Løg
Ontario	Ontario
Ontology	Ontologi (filosofi)
Oort cloud	Oortskyen
Opel	Opel
Opera	Opera
Opera (Internet suite)	Opera (browser)
Operating system	Styresystem
Operetta	Operette
Ophiuchus	Slangeholderen
Opium	Opium
Optical fiber	Lysleder
Optical illusion	Synsbedrag
Optics	Optik
Optics	Kategori:Optik
Optimization (mathematics)	Optimering (matematik)
Oral sex	Oralsex
Orange (colour)	Orange
Orange (fruit)	Appelsin
Orangutan	Orangutang
Oratorio	Oratorium
Orbit	Omløbsbane
Orca	Spækhugger
Orchestra	Orkester
Orchidaceae	Gøgeurt-familien
Order (biology)	Orden (biologi)
Order of Saint Benedict	Benediktinerordenen
Ordovician	Ordovicium
Oregano	Almindelig Merian
Oregon	Oregon
Oregon	Kategori:Oregon
Orestes (mythology)	Orestes
Organ (anatomy)	Organ
Organ (music)	Orgel
Organelle	Organel
Organic chemistry	Organisk kemi
Organic chemistry	Kategori:Organisk kemi
Organic compound	Organisk forbindelse
Organism	Organisme
Organization	Organisation
Organization of American States	Organisationen af Amerikanske Stater
Orgasm	Orgasme
Origami	Origami
Origen	Origenes
Original sin	Arvesynd
Orinoco	Orinoco
Orion (constellation)	Orion (stjernebillede)
Orissa	Orissa
Orlando	Orlando (Florida)
Ornithology	Ornitologi
Ornithology	Kategori:Ornitologi
Orpheus	Orfeus
Orson Welles	Orson Welles
Orthography	Retskrivning
Osaka	Osaka
Osama bin Laden	Osama bin Laden
Oscar Wilde	Oscar Wilde
Oscillation	Oscillator
Osiris	Osiris
Oslo	Oslo
Osman I	Osman 1.
Osmium	Osmium
Osprey	Fiskeørn
Osteichthyes	Benfisk
Osteoporosis	Osteoporose
Ostrava	Ostrava
Ostrich	Struds
Otho	Otho
Ottawa	Ottawa
Otto Hahn	Otto Hahn
Otto I	Otto den Store
Otto von Bismarck	Otto von Bismarck
Ottoman Empire	Osmanniske Rige
Ounce	Unse
Ovary	Æggestok
Ovid	Publius Ovidius Naso
Ovum	Æg (fysiologi)
Owl	Ugle-ordenen
Oxford	Oxford
Oxidation state	Oxidationstrin
Oxide	Oxid
Oxygen	Ilt
Oxymoron	Oxymoron
Oxytocin	Oxytocin
Ozone	Ozon
Ozone layer	Ozonlaget
P	P
PAL	PAL
PH	PH og pOH
Pablo Neruda	Pablo Neruda
Pablo Picasso	Pablo Picasso
Pacific Ocean	Stillehavet
Pacifism	Pacifisme
Padua	Padova
Paganism	Hedenskab
Painting	Kategori:Maleri
Pakistan	Pakistan
Pakistan	Kategori:Pakistan
Palace of Versailles	Versailles
Palau	Palau
Palau	Kategori:Palau
Paleocene	Paleocæn
Paleolithic	Ældste stenalder
Paleontology	Palæontologi
Paleontology	Kategori:Palæontologi
Paleozoic	Palæozoikum
Palermo	Palermo
Palestine	Palæstina
Palestine	Kategori:Palæstina
Palestine Liberation Organization	PLO
Palestinian National Authority	Det palæstinensiske selvstyre
Pali	Pali
Palindrome	Palindrom
Palladium	Palladium
Palm Sunday	Palmesøndag
Pamir Mountains	Pamir
Pan (mythology)	Pan
Panama	Panama
Panama	Kategori:Panama
Panama Canal	Panamakanalen
Panama City	Panama City
Pancreas	Bugspytkirtlen
Pandemic	Pandemi
Pandora	Pandoras æske
Pangaea	Pangæa
Pantheism	Panteisme
Pantheon	Pantheon
Panthera	Panthera
Papal States	Kirkestaten
Papua New Guinea	Papua Ny Guinea
Papua New Guinea	Kategori:Papua Ny Guinea
Papyrus	Papyrus
Parabola	Parabel
Paracelsus	Paracelsus
Parachute	Faldskærm
Paradigm	Paradigme
Paradox	Paradoks
Paragliding	Paragliding
Paraguay	Paraguay
Paraguay	Kategori:Paraguay
Parallax	Parallakse
Parallelogram	Parallelogram
Paramaribo	Paramaribo (by)
Paranoia	Paranoid psykose
Paraphilia	Parafili
Parasitism	Snylter
Parchment	Pergament
Paris	Paris
Paris	Kategori:Paris
Paris (mythology)	Prins Paris
Parity (mathematics)	Lige og ulige tal
Parkinson's disease	Parkinsons sygdom
Parliament	Parlament
Parmenides	Parmenides
Parody	Parodi
Parrot	Papegøje
Parsec	Parsec
Parsley	Persille
Parthenon	Parthenon
Parthia	Partherriget
Particle physics	Partikelfysik
Particle physics	Kategori:Subatomar fysik
Parvati	Parvati
Pascal	Pascal
Pascal (programming language)	Pascal (programmeringssprog)
Pascal (unit)	Pascal (enhed)
Passeriformes	Kategori:Spurvefugle
Passerine	Spurvefugle
Passover	Pesach
Passport	Pas (legitimation)
Password	Adgangskode
Pasteurization	Pasteurisering
Patent	Patent
Pathology	Patologi
Patras	Patras
Patriarch	Patriark (titel)
Patriotism	Patriotisme
Paul Gauguin	Paul Gauguin
Paul Klee	Paul Klee
Paul McCartney	Paul McCartney
Paul Newman	Paul Newman
Paul the Apostle	Paulus (Bibelen)
Paul von Hindenburg	Paul von Hindenburg
Pauli exclusion principle	Paulis udelukkelsesprincip
Pavo (constellation)	Påfuglen
Pawn (chess)	Bonde (skak)
Pays de la Loire	Pays de la Loire
Pea	Almindelig Ært
Peace	Fred
Peace of Westphalia	Westfalske fred
Peach	Fersken
Peanut	Jordnød
Pear	Pære
Pearl	Perle
Pearl Harbor	Pearl Harbor
Peat	Tørv
Pedagogy	Pædagogik
Pedagogy	Kategori:Pædagogik
Pediatrics	Pædiatri
Pedophilia	Pædofili
Pedunculate Oak	Stilk-Eg
Pegasus	Pegasus
Pegasus (constellation)	Pegasus (stjernebillede)
Peloponnese	Peloponnes
Peloponnesian War	Peloponnesiske Krig
Pencil	Blyant
Pendulum	Matematisk pendul
Penelope	Penelope
Penguin	Pingvin
Penicillin	Penicillin
Peninsula	Halvø
Pennsylvania	Pennsylvania
Pennsylvania	Kategori:Pennsylvania
Pentagon	Femkant
Pentagram	Pentagram
Pentecost	Pinse
Pentecostalism	Pinsebevægelsen
People	Kategori:Personer
People's Republic of China	Folkerepublikken Kina
Pepin the Short	Pipin den lille
Pepsi	Pepsi
Peptide	Peptid
Percentage	Procent
Perception	Perception
Perciformes	Pigfinnefisk
Percussion instrument	Perkussion
Percy Bysshe Shelley	Percy Bysshe Shelley
Peregrine Falcon	Vandrefalk
Perestroika	Perestrojka
Perfume	Parfume
Pericles	Perikles
Periodic table	Periodiske system
Permafrost	Permafrost
Permian	Perm (geologi)
Permutation	Permutation
Perpetual motion	Evighedsmaskine
Persephone	Persefone
Persepolis	Persepolis
Perseus	Perseus
Perseus (constellation)	Perseus (stjernebillede)
Persian Empire	Persien
Persian Gulf	Persiske Bugt
Personal digital assistant	Håndholdt computer
Perth	Perth (Australien)
Peru	Peru
Peru	Kategori:Peru
Pesticide	Pesticid
Peter Abelard	Peter Abelard
Peter Paul Rubens	Peter Paul Rubens
Peter Sellers	Peter Sellers
Petrarch	Francesco Petrarca
Petroleum	Råolie
Phanerozoic	Phanerozoikum
Pharaoh	Farao
Pharmacology	Farmakologi
Pharmacology	Kategori:Farmakologi
Phase (matter)	Fase (stof)
Phenol	Fenol
Phenomenology	Fænomenologi
Phenotype	Fænotype
Phenylalanine	Fenylalanin
Phenylketonuria	Fenylketonuri
Phi (letter)	Phi
Philadelphia	Philadelphia
Philately	Filateli
Philately	Kategori:Filateli
Philip II of Macedon	Philip 2. af Makedonien
Philip II of Spain	Filip 2. af Spanien
Philipp Lenard	Philipp Lenard
Philippines	Filippinerne
Philippines	Kategori:Filippinerne
Philology	Filologi
Philology	Kategori:Filologi
Philosophy	Filosofi
Philosophy	Kategori:Filosofi
Phnom Penh	Phnom Penh
Phobia	Fobi
Phobos (moon)	Phobos (måne)
Phoenicia	Fønikerne
Phoenix	Phoenix
Phoenix	Føniks (flertydig)
Phoenix (constellation)	Føniks (stjernebillede)
Phoenix (mythology)	Fugl Føniks
Phoenix (spacecraft)	Phoenix (rumsonde)
Phoneme	Fonem
Phonetics	Fonetik
Phonetics	Kategori:Fonetik
Phonology	Fonologi
Phosphate	Fosfat
Phosphoric acid	Fosforsyre
Phosphorus	Fosfor
Photography	Fotografi
Photography	Kategori:Fotografi
Photon	Foton
Photosphere	Fotosfære
Photosynthesis	Fotosyntese
Phylum	Række (biologi)
Physical chemistry	Fysisk kemi
Physical chemistry	Kategori:Fysisk kemi
Physician	Læge
Physics	Fysik
Physics	Kategori:Fysik
Physiology	Fysiologi
Physiology	Kategori:Fysiologi
Pi	Pi (tal)
Pi (letter)	Pi (bogstav)
Piano	Klaver
Picardie	Pikardiet
Piciformes	Spættefugle
Pictor	Staffeliet
Pidgin (software)	Pidgin
Piedmont	Piemonte
Pierre	Pierre (South Dakota)
Pierre Curie	Pierre Curie
Pierre de Fermat	Pierre de Fermat
Piet Mondrian	Piet Mondrian
Pieter Zeeman	Pieter Zeeman
Pigment	Pigment
Pilsen	Plzeň
Pinaceae	Gran-familien
Pindar	Pindar
Pine	Fyrreslægten
Pineapple	Almindelig Ananas
Pinniped	Sæler
Piracy	Pirat
Pisa	Pisa
Pisces (constellation)	Fiskene
Piston	Stempel (motordel)
Pittsburgh	Pittsburgh
Pituitary gland	Hypofyse
Pixel	Pixel
Pizza	Pizza
Plagiarism	Plagiat
Plane (mathematics)	Plan (matematik)
Planet	Planet
Plankton	Plankton
Plant	Plante
Plasma (physics)	Plasma
Plasmid	Plasmid
Plastic	Plastic
Plastid	Plastid
Platelet	Blodplade
Platinum	Platin
Plato	Platon
Platypus	Næbdyr
Playing card	Spillekort
Pleiades (star cluster)	Plejaderne (stjernehob)
Pleistocene	Pleistocæn
Pliny the Elder	Plinius den Ældre
Pliny the Younger	Plinius den Yngre
Pliocene	Pliocæn
Plotinus	Plotin
Plum	Blommetræ
Plutarch	Plutarch
Pluto	Pluto (dværgplanet)
Pluto (disambiguation)	Pluto
Plutonium	Plutonium
Plymouth	Plymouth
Pneumonia	Lungebetændelse
Po River	Po
Poaceae	Græs-familien
Podcast	Podcasting
Poetry	Kategori:Poesi
Pogrom	Pogrom
Point (geometry)	Punkt
Poison	Gift
Poitiers	Poitiers
Poitou-Charentes	Poitou-Charentes
Poker	Poker
Poland	Polen
Poland	Kategori:Polen
Polar bear	Isbjørn
Polaris	Nordstjernen
Police	Politi
Poliomyelitis	Polio
Political party	Politisk parti
Political science	Statskundskab
Political science	Kategori:Statskundskab
Politician	Politiker
Politics	Politik
Politics	Kategori:Politik
Pollen	Pollen
Pollination	Bestøvning
Pollution	Forurening
Polo	Polo
Polonium	Polonium
Polyethylene	Polyethylen
Polygamy	Polygami
Polygon	Polygon
Polyhedron	Polyeder
Polymer	Polymer
Polynesia	Polynesien
Polynomial	Polynomium
Polytheism	Polyteisme
Polyvinyl chloride	Polyvinylchlorid
Pomegranate	Granatæble
Pomelo	Pomelo
Pompeii	Pompeji
Pompey	Pompejus
Pontius Pilate	Pontius Pilatus
Pop art	Popkunst
Pop music	Popmusik
Pope	Pave
Pope Alexander VI	Pave Alexander 6.
Poplar	Poppel
Population	Befolkning
Populism	Populisme
Porcelain	Porcelæn
Pornography	Pornografi
Port	Havn
Port Louis	Port Louis
Port Moresby	Port Moresby
Port of Spain	Port-of-Spain
Port-au-Prince	Port-au-Prince
Portland	Portland
Porto	Porto
Portsmouth	Portsmouth
Portugal	Portugal
Portugal	Kategori:Portugal
Poseidon	Poseidon
Postage stamp	Frimærke
Postal code	Postnummer
Postmodernism	Postmodernisme
Potassium	Kalium
Potassium nitrate	Kaliumnitrat
Potato	Kartoffel
Potential energy	Potentiel energi
Potsdam	Potsdam
Pound (mass)	Pund (masseenhed)
Pound sterling	Engelsk pund (møntenhed)
Poverty	Fattigdom
Power (physics)	Effekt (fysik)
Power station	Kraftværk
Praetor	Praetor
Prague	Prag
Prague	Kategori:Prag
Praia	Praia
Praseodymium	Praseodym
Prayer	Bøn
Precambrian	Prækambrium
Precession	Præcession
Precipitation (meteorology)	Nedbør
Pregnancy	Graviditet
Prehistory	Menneskets urhistorie og forhistorie
Prehistory	Kategori:Urhistorie og forhistorie
President	Præsident
President of the United States	Amerikanske præsidenter
Pressure	Tryk (fysik)
Pretoria	Pretoria
Priam	Priamos
Priest	Præst
Primate	Primater
Primates	Kategori:Primater
Prime Meridian	Nulmeridianen
Prime minister	Statsminister
Prime number	Primtal
Prince Edward Island	Prince Edward Island
Prince Philip	Prins Philip, hertug af Edinburgh
Prince of Wales	Prins af Wales
Princeton University	Princeton University
Principle of relativity	Relativitetsteori
Printing	Bogtryk
Prism (optics)	Optisk prisme
Prison	Fængsel
Prisoner of war	Krigsfange
Prix Goncourt	Goncourtprisen
Probability theory	Sandsynlighedsregning
Probability theory	Kategori:Sandsynlighedsregning
Procyonidae	Halvbjørne
Professor	Professor
Programmer	Programmør
Programming language	Programmeringssprog
Progressive rock	Progressiv rock
Project	Projekt
Prokaryote	Prokaryot
Prolog	Prolog (programmeringssprog)
Prometheus	Prometheus
Promethium	Promethium
Pronoun	Stedord
Propaganda	Propaganda
Propane	Propan
Prophet	Profet
Prose	Prosa (skriveform)
Prostate	Blærehalskirtel
Protactinium	Protactinium
Protectorate	Protektorat
Protein	Protein
Proterozoic	Proterozoikum
Protestant Reformation	Reformationen
Protestantism	Protestantisme
Protist	Protist
Protista	Kategori:Protister
Protocol	Protokol
Proton	Proton
Protozoa	Protozo
Providence	Providence
Proxima Centauri	Proxima Centauri
Prunus	Kirsebær
Prussia	Preussen
Psalms	Salmernes Bog
Pseudonym	Pseudonym
Pseudoscience	Kategori:Pseudovidenskab
Pseudoscience	Pseudovidenskab
Psi (letter)	Psi (bogstav)
Psoriasis	Psoriasis
Psychiatry	Psykiatri
Psychiatry	Kategori:Psykiatri
Psychoanalysis	Psykoanalyse
Psychology	Psykologi
Psychology	Kategori:Psykologi
Psychosis	Psykose
Psychotherapy	Psykoterapi
Ptah	Ptah
Pterosaur	Flyveøgler
Ptolemy	Ptolemæus
Puberty	Pubertet
Public domain	Public domain
Public relations	Spin (kommunikation)
Puerto Rico	Puerto Rico
Puerto Rico	Kategori:Puerto Rico
Pula	Pula
Pulley	Talje (gearing)
Pulsar	Pulsar
Pump	Pumpe
Punctuation	Tegnsætning
Punjab (India)	Punjab (Indien)
Punk	Kategori:Punk
Punk rock	Punk
Pupil	Pupil
Puppis	Agterstavnen
Pyongyang	Pyongyang
Pyramid	Pyramide
Pyrenees	Pyrenæerne
Pyrite	Pyrit
Pyrrhic victory	Pyrrhussejr
Pythagoras	Pythagoras
Python (programming language)	Python (programmeringssprog)
Pyxis	Kompasset
Q	Q
Qatar	Qatar
Qatar	Kategori:Qatar
Qin Dynasty	Qin-dynastiet
Qing Dynasty	Qing-dynastiet
Quadratic equation	Andengradspolynomium
Quadrilateral	Firkant
Quaestor	Kvæstor
Quantum field theory	Kvantefeltteori
Quantum mechanics	Kvantemekanik
Quantum mechanics	Kategori:Kvantemekanik
Quarantine	Karantæne
Quark	Kvark (fysik)
Quartz	Kvarts
Quaternary	Kvartær
Quaternion	Kvaternioner
Quebec	Quebec
Quebec City	Québec (by)
Quechua	Quechua
Queen (chess)	Dronning (skak)
Queens	Queens
Queensland	Queensland
Quentin Tarantino	Quentin Tarantino
Question mark	Spørgsmålstegn
Quetzalcoatl	Quetzalcoatl
Quince	Kvæde
Quito	Quito
R	R
RAF (disambiguation)	RAF
RAID	RAID
RNA	RNA
Ra	Ra
Rabat	Rabat (Marokko)
Rabbi	Rabbiner
Rabindranath Tagore	Rabindranath Tagore
Raccoon Dog	Mårhund
Race	Race
Rachel Carson	Rachel Carson
Racism	Racisme
Racism	Kategori:Racisme
Radar	Radar
Radian	Radian
Radio	Kategori:Radio
Radioactive decay	Radioaktivitet
Radiocarbon dating	Kulstof 14-datering
Radiology	Radiologi
Radium	Radium
Radius	Radius (cirkel)
Radon	Radon
Rain	Regn
Rainbow	Regnbue
Rainer Maria Rilke	Rainer Maria Rilke
Raleigh	Raleigh
Ralph Waldo Emerson	Ralph Waldo Emerson
Rama	Rama
Ramadan	Ramadan
Ramesses II	Ramses 2.
Random access memory	RAM
Ranunculaceae	Ranunkel-familien
Rape	Voldtægt
Rapeseed	Raps
Raphael	Raffaello Santi
Rapid transit	Kategori:Metrosystemer
Raspberry	Almindelig Hindbær
Rat	Rotte
Rational number	Rationale tal
Ratite	Strudsefugle
Ravenna	Ravenna
Rawalpindi	Rawalpindi
Ray Bradbury	Ray Bradbury
Read-only memory	Rom (hukommelse)
Real number	Reelle tal
Recession	Recession
Recife	Recife
Rectangle	Rektangel
Rectifier	Ensretter
Recursion	Rekursiv
Recycling	Genbrug
Red	Rød
Red Army Faction	Rote Armee Fraktion
Red Deer	Kronhjort
Red Fox	Rød ræv
Red Panda	Rød panda
Red Sea	Røde Hav
Red algae	Rødalger
Red dwarf	Rød dværg
Red giant	Rød kæmpe
Redshift	Rødforskydning
Redshift (disambiguation)	Rødforskydning
Reduced instruction set computer	RISC
Referendum	Folkeafstemning
Refraction	Refraktion
Refractive index	Brydningsindeks
Refugee	Flygtning
Regent	Regent
Reggae	Reggae
Regiment	Regiment
Regina	Regina (Canada)
Region	Region
Reims	Reims
Reincarnation	Reinkarnation
Reindeer	Rensdyr
Relation (mathematics)	Relation (matematik)
Relativism	Relativisme
Relativity	Kategori:Relativitetsteori
Relay	Relæ
Religion	Religion
Religion	Kategori:Religion
Religious Society of Friends	Kvæker
Rembrandt	Rembrandt
Renaissance	Renæssance
Renaissance	Kategori:Renæssance
Reproduction	Formering
Reptile	Krybdyr
Republic	Republik
Republic of China	Republikken Kina
Republic of Ireland	Irland
Republic of Ireland	Kategori:Irland
Republic of the Congo	Republikken Congo
Republic of the Congo	Kategori:Republikken Congo
Republican Party (United States)	Republikanske parti (USA)
Requiem	Rekviem
Resistor	Elektrisk modstand (elektronisk komponent)
Restaurant	Restaurant
Reticulum	Nettet
Revolution	Revolution (politik)
Revolver	Revolver
Rhea (moon)	Rhea (måne)
Rhea (mythology)	Rhea (mytologi)
Rhenium	Rhenium
Rhetoric	Retorik
Rhetoric	Kategori:Retorik
Rhine	Rhinen
Rhinoceros	Næsehorn
Rho (letter)	Rho (bogstav)
Rhode Island	Rhode Island
Rhode Island	Kategori:Rhode Island
Rhodes	Rhodos
Rhodium	Rhodium
Rhombus	Rombe
Rhyme	Rim
Rhythm	Rytme
Rhythm and blues	Rhythm and blues
Rib	Ribben
Ribosome	Ribosom
Rice	Ris
Richard Feynman	Richard Feynman
Richard Nixon	Richard Nixon
Richard Strauss	Richard Strauss
Richard Wagner	Richard Wagner
Richard Wright (musician)	Richard Wright
Richmond	Richmond
Riga	Riga
Rigel	Rigel
Right ascension	Rektascension
Ring (mathematics)	Ring (matematik)
Ringo Starr	Ringo Starr
Rio Grande	Rio Grande
Rio de Janeiro	Rio de Janeiro
River	Flod
River Thames	Themsen
Riyadh	Riyadh
Road	Vej
Roald Amundsen	Roald Amundsen
Robert A. Heinlein	Robert A. Heinlein
Robert Andrews Millikan	Robert Andrews Millikan
Robert Boyle	Robert Boyle
Robert Burns	Robert Burns
Robert De Niro	Robert de Niro
Robert E. Lee	Robert E. Lee
Robert Falcon Scott	Robert Falcon Scott
Robert Koch	Robert Koch
Robert Louis Stevenson	Robert Louis Stevenson
Robert Oppenheimer	J. Robert Oppenheimer
Robert Owen	Robert Owen
Robert Redford	Robert Redford
Robert Schumann	Robert Schumann
Robin Hood	Robin Hood
Robot	Robot
Rock	Sten, saks, papir
Rock (geology)	Klippe (geologi)
Rock and roll	Rock and roll
Rock music	Rock
Rock music	Kategori:Rock
Rocket	Raket
Rocky Mountains	Rocky Mountains
Rococo	Rokoko
Rodent	Gnavere
Roe Deer	Rådyr
Roentgenium	Røntgenium
Roman Catholic Church	Romerskkatolske kirke
Roman Empire	Romerriget
Roman Republic	Romerske republik
Roman calendar	Romersk kalender
Roman law	Romerret
Roman legion	Legion
Roman mythology	Romersk mytologi
Roman mythology	Kategori:Romersk mytologi
Romania	Rumænien
Romania	Kategori:Rumænien
Romanticism	Romantikken
Rome	Rom
Rome	Kategori:Rom
Ronald Reagan	Ronald Reagan
Roof	Tag
Rook (bird)	Råge
Rook (chess)	Tårn (skak)
Roosevelt	Roosevelt
Root	Rod (plantedel)
Rosa Parks	Rosa Parks
Rosaceae	Rosen-familien
Rosales	Rosen-ordenen
Rosario	Rosario
Rosary	Bedekrans
Rose	Rose
Rosemary	Rosmarin
Rosetta Stone	Rosettestenen
Rosh Hashanah	Rosh Hashanah
Rostock	Rostock
Rotifer	Hjuldyr
Rotterdam	Rotterdam
Router	Router
Rowing (sport)	Roning
Royal Air Force	Royal Air Force
Rubicon	Rubicon
Rubidium	Rubidium
Rubus idaeus	Almindelig Hindbær
Ruby	Rubin
Ruby (programming language)	Ruby (programmeringssprog)
Rudolf Diesel	Rudolf Diesel
Rudolf Hess	Rudolf Hess
Rudolf Steiner	Rudolf Steiner
Rudyard Kipling	Rudyard Kipling
Rugby football	Rugby
Russia	Rusland
Russia	Kategori:Rusland
Russian Orthodox Church	Den russisk-ortodokse kirke
Russian Revolution (1917)	Den Russiske Revolution 1917
Russo-Japanese War	Russisk-japanske krig
Ruthenium	Ruthenium
Rutherford B. Hayes	Rutherford B. Hayes
Rutherfordium	Rutherfordium
Rwanda	Rwanda
Rwanda	Kategori:Rwanda
Rye	Almindelig Rug
S	S
SOAP	SOAP
SOS	SOS
Sacrament	Sakramente
Sacramento	Sacramento
Saddam Hussein	Saddam Hussein
Safari (web browser)	Safari (browser)
Saffron	Safran
Sagitta	Pilen
Sagittarius (constellation)	Skytten (stjernebillede)
Sahara	Sahara
Sail	Sejl
Saint	Helgen
Saint Andrew	Apostlen Andreas
Saint George	Sankt Jørgen
Saint Kitts and Nevis	Saint Kitts og Nevis
Saint Lawrence River	Saint Lawrence
Saint Lucia	Saint Lucia
Saint Nicholas	Sankt Nikolaus
Saint Patrick	Skt. Patrick
Saint Paul	Saint Paul
Saint Peter	Apostlen Peter
Saint Petersburg	Sankt Petersborg
Saint Vincent and the Grenadines	Saint Vincent og Grenadinerne
Saladin	Saladin
Salah	Salah
Salamander	Halepadder
Salem	Salem
Saliva	Spyt
Salman Rushdie	Salman Rushdie
Salt	Salt
Salt (chemistry)	Salt
Salt Lake City	Salt Lake City
Salvador	Salvador
Salzburg	Salzburg
Salzburg (state)	Salzburg (delstat)
Samara	Samara
Samarium	Samarium
Samarkand	Samarkand
Samoa	Samoa
Samoa	Kategori:Samoa
Samsara	Samsara
Samuel Beckett	Samuel Beckett
Samuel F. B. Morse	Samuel Morse
Samurai	Samurai
San Antonio	San Antonio
San Diego	San Diego
San Francisco	San Francisco
San Jose	San Jose
San Juan	San Juan, Puerto Rico
San Marino	San Marino
San Marino	Kategori:San Marino
San Marino	San Marino (by)
San Salvador	San Salvador
Sand	Sand
Sandro Botticelli	Sandro Botticelli
Sandstone	Sandsten
Sandwich	Sandwich
Sanskrit	Sanskrit
Santa Claus	Julemanden
Santa Fe	Santa Fe (New Mexico)
Santiago	Santiago de Chile
Santo Domingo	Santo Domingo
Santos (Săo Paulo)	Santos
Sapphire	Safir
Sappho	Sapfo
Sapporo	Sapporo
Sarah Bernhardt	Sarah Bernhardt
Sarajevo	Sarajevo
Sarcophagus	Sarkofag
Sardinia	Sardinien
Sari	Sari (by)
Saskatchewan	Saskatchewan
Satan	Satan
Satanism	Satanisme
Satellite	Satellit
Satire	Satire
Saturday	Lørdag
Saturn	Saturn (planet)
Saturn	Kategori:Saturn
Saturn (disambiguation)	Saturn
Saturn (mythology)	Saturn (gud)
Satyr	Satyr (græsk mytologi)
Sauce	Sovs
Saudi Arabia	Saudi-Arabien
Saudi Arabia	Kategori:Saudi-Arabien
Sausage	Pølse
Savanna	Savanne
Saxony	Sachsen
Saxony	Kategori:Sachsen
Saxophone	Saxofon
Scandinavia	Skandinavien
Scandinavia	Kategori:Skandinavien
Scandinavian Peninsula	Skandinaviske halvø
Scandium	Scandium
Scheldt	Schelde
Scheme (programming language)	Scheme
Schizophrenia	Skizofreni
Scholasticism	Skolastik
School	Skole
Schutzstaffel	Schutzstaffel
Science	Videnskab
Science	Kategori:Videnskab
Science fiction	Science fiction
Science fiction	Kategori:Science fiction
Scientific method	Videnskabelig metode
Scientist	Videnskabsmand
Scientology	Scientology
Scipio Africanus	Publius Cornelius Scipio Africanus
Scissors	Saks
Sciuridae	Egern
Scorpion	Skorpion
Scorpius	Skorpionen
Scotland	Skotland
Scotland	Kategori:Skotland
Scots Pine	Skov-Fyr
Scottish Gaelic	Skotsk gælisk
Scouting	Spejderbevægelsen
Scrabble	Scrabble
Screw	Skrue
Screwdriver	Skruetrækker
Scrotum	Skrotum
Sculptor (constellation)	Billedhuggerværkstedet
Sculpture	Skulptur
Sea	Hav
Sea Otter	Havodder
Sea anemone	Søanemone
Sea cucumber	Søpølser
Sea of Azov	Azovske Hav
Sea of Japan	Japanske Hav
Sea of Marmara	Marmarahavet
Sea of Okhotsk	Okhotske Hav
Sea urchin	Søpindsvin
Seaborgium	Seaborgium
Seahorse	Søhest
Search engine	Søgemaskine
Sears Tower	Sears Tower
Season	Årstid
Seattle	Seattle
Second	Sekund
Second Vatican Council	Det andet Vatikankoncil
Second law of thermodynamics	Termodynamikkens 2. lov
Sect	Sekt
Security	Kategori:Sikkerhed
Seed	Frø (plantedel)
Seine	Seinen
Seismology	Seismologi
Seismology	Kategori:Seismologi
Selene	Selene
Selenium	Selen
Semantics	Semantik
Semen	Sæd
Semicolon	Semikolon
Semiconductor	Halvleder
Semiotics	Semiotik
Senate	Senat
Senegal	Senegal
Senegal	Kategori:Senegal
Seoul	Seoul
Seppuku	Seppuku
September	September
September 11	11. september
September 11	Terrorangrebet den 11. september 2001
September 17	17. september
September 29	29. september
Septuagint	Septuaginta
Sequence	Talfølge
Serbia	Serbien
Serbia	Kategori:Serbien
Serbia and Montenegro	Serbien og Montenegro
Serbia and Montenegro	Kategori:Serbien og Montenegro
Sergei Eisenstein	Sergej Eisenstein
Sergei Rachmaninoff	Sergej Rachmaninov
Series (mathematics)	Række (matematik)
Serine	Serin
Serotonin	Serotonin
Serpens	Slangen
Server (computing)	Server
Set	Mængde
Set (mythology)	Seth
Set theory	Mængdelære
Set theory	Kategori:Mængdelære
Sevastopol	Sevastopol
Seven Years' War	Syvårskrigen (1756–1763)
Severe acute respiratory syndrome	SARS
Seville	Sevilla
Sex	Køn
Sex organ	Kønsorgan
Sexism	Kønsdiskrimination
Sextant	Sekstant
Sexual intercourse	Samleje
Sexuality	Kategori:Seksualitet
Sexually transmitted disease	Kønssygdom
Seychelles	Seychellerne
Seychelles	Kategori:Seychellerne
Shah	Shah
Shahadah	Shahadah
Shamanism	Shamanisme
Shanghai	Shanghai
Share (finance)	Aktie
Sharia	Sharia
Shark	Haj
Sheffield	Sheffield
Sherlock Holmes	Sherlock Holmes
Shetland	Shetlandsøerne
Shield	Skjold
Shinto	Shinto
Ship	Skib
Shiva	Shiva
Shogi	Shogi
Shogun	Shogun
Shrimp	Ægte reje
Shrub	Busk
Siberia	Sibirien
Siberian Husky	Siberian Husky
Sichuan	Sichuan
Sicily	Sicilien
Sicily	Kategori:Sicilien
Siemens (unit)	Siemens (ledningsevneenhed)
Sierra Leone	Sierra Leone
Sierra Leone	Kategori:Sierra Leone
Sigma	Sigma (bogstav)
Sigmund Freud	Sigmund Freud
Sign language	Tegnsprog
Sigrid Undset	Sigrid Undset
Sikhism	Sikhisme
Sikkim	Sikkim
Silesia	Schlesien
Silicon	Silicium
Silicon Valley	Silicon Valley
Silicon dioxide	Siliciumdioxid
Silk	Silke
Silk Road	Silkevejen
Silurian	Silur
Silver	Sølv
Simone de Beauvoir	Simone de Beauvoir
Sin	Synd
Sinai Peninsula	Sinai-halvøen
Singapore	Singapore
Singapore	Kategori:Singapore
Single (music)	Single (musik)
Siren	Sirene (græsk mytologi)
Sirenia	Søko
Sirius	Sirius (stjerne)
Sistine Chapel	Det Sixtinske Kapel
Sisyphus	Sisyfos
Sitting Bull	Sitting Bull
Situation comedy	Sitcom
Six-Day War	Seksdageskrigen
Skagerrak	Skagerrak
Skateboard	Skateboard
Skeletal system	Kategori:Skelet
Skepticism	Skepticisme
Skin	Hud
Skinhead	Skinheads
Skopje	Skopje
Skull	Kranium
Skylab	Skylab
Skyscraper	Skyskraber
Slash (musician)	Slash (musiker)
Slavery	Slaveri
Slayer	Slayer
Sleep	Søvn
Slovakia	Slovakiet
Slovakia	Kategori:Slovakiet
Slovenia	Slovenien
Slovenia	Kategori:Slovenien
Small intestine	Tyndtarmen
Smog	Smog
Smolensk	Smolensk
Snake	Slange
Snooker	Snooker
Snow	Sne
Soap	Sæbe
Social psychology	Socialpsykologi
Socialism	Socialisme
Socialism	Kategori:Socialisme
Socialist Party (France)	Parti Socialiste
Society	Kategori:Menneskesamfund
Society	Samfund
Society of Jesus	Jesuiterordenen
Sociolinguistics	Sociolingvistik
Sociology	Sociologi
Sociology	Kategori:Sociologi
Socrates	Sokrates
Sodium	Natrium
Sodium bicarbonate	Natron
Sodium chloride	Natriumklorid
Sodium hydroxide	Natriumhydroxid
Sofia	Sofia
Softball	Softball
Software	Kategori:Programmer
Soil	Jord
Solanaceae	Natskyggefamilien
Solar System	Solsystem
Solar System	Kategori:Solsystem
Solar cell	Solcelle
Solar eclipse	Solformørkelse
Solar energy	Solenergi
Solar wind	Solvind
Solid	Fast form
Solid state	Fast form
Solidarity	Solidarność
Solomon	Kong Salomo
Solomon Islands	Salomonøerne
Solomon Islands	Kategori:Salomonøerne
Solon	Solon
Solstice	Solhverv
Solution	Opløsning (kemi)
Solvent	Opløsningsmiddel
Somalia	Somalia
Somalia	Kategori:Somalia
Somerset	Somerset
Somme	Somme
Sonata	Sonate
Song	Sang
Song of Solomon	Højsangen
Sonnet	Sonet
Sophia Loren	Sophia Loren
Sophism	Sofisme
Sophocles	Sofokles
Sorbonne	Sorbonne
Sorghum	Durra
Sorting algorithm	Sorteringsalgoritme
Soul	Sjæl
Sound	Lyd
Soup	Suppe
Source code	Kildekode
South Africa	Kategori:Sydafrika
South America	Sydamerika
South America	Kategori:Sydamerika
South Australia	South Australia
South Carolina	South Carolina
South Carolina	Kategori:South Carolina
South China Sea	Sydkinesiske Hav
South Dakota	South Dakota
South Dakota	Kategori:South Dakota
South Island	Sydøen
South Korea	Sydkorea
South Korea	Kategori:Sydkorea
South Pole	Sydpolen
South Vietnam	Sydvietnam
Southeast Asia	Sydøstasien
Southern Hemisphere	Sydlige halvkugle
Sovereignty	Suverænitet
Soviet Union	Sovjetunionen
Soviet Union	Kategori:Sovjetunionen
Soybean	Sojabønne
Space	Rum
Space Shuttle	Rumfærge
Space station	Rumstation
Spacecraft	Rumskib
Spaghetti	Spaghetti
Spain	Spanien
Spain	Kategori:Spanien
Spam (electronic)	Spam
Spanish Civil War	Spanske borgerkrig
Spanish people	Kategori:Spaniere
Spanish-American War	Den spansk-amerikanske krig
Sparta	Sparta
Spear	Spyd
Special relativity	Speciel relativitetsteori
Species	Art
Spectroscopy	Spektroskopi
Speed	Fart
Speed of light	Lysets hastighed
Speleology	Spileologi
Spencer Tracy	Spencer Tracy
Sperm Whale	Kaskelothval
Spermatophyte	Frøplanter
Spermatozoon	Sædcelle
Sphere	Kugle
Sphinx	Sfinks
Spice	Krydderi
Spider	Edderkop
Spin (physics)	Spin (fysik)
Spinach	Spinat
Spleen	Milt
Split	Split
Sponge	Svampedyr
Sport	Sport
Spreadsheet	Regneark
Spree	Spree
Spring (season)	Forår
Springfield	Springfield (Illinois)
Spyware	Spyware
Squamata	Slanger og øgler
Square (geometry)	Kvadrat
Square root	Kvadratrod
Squash (sport)	Squash
Squirrel	Egern
Sri Lanka	Sri Lanka
Sri Lanka	Kategori:Sri Lanka
St. Louis	St. Louis
Stadium	Stadion
Stainless steel	Rustfrit stål
Stalinism	Stalinisme
Standard deviation	Standardafvigelse
Stanford University	Stanford University
Stanley Kubrick	Stanley Kubrick
Star	Stjerne
Star of David	Davidsstjerne
Starch	Kulhydrat#Stivelse
Starfish	Søstjerne
State	Stat
Staten Island	Staten Island
Statistics	Statistik
Statistics	Kategori:Statistik
Statue of Liberty	Frihedsgudinden
Stavanger	Stavanger
Steam engine	Dampmaskine
Steel	Stål
Stefan Zweig	Stefan Zweig
Steffi Graf	Steffi Graf
Stem cell	Stamcelle
Stendhal	Stendhal
Stephen Hawking	Stephen Hawking
Steppe	Steppe (biotop)
Steradian	Steradian
Sternum	Sternum
Steven Spielberg	Steven Spielberg
Sting	Sting
Stock exchange	Børs
Stockholm	Stockholm
Stoicism	Stoicisme
Stomach	Mave
Stone Age	Stenalder
Stonehenge	Stonehenge
Stork	Storke
Storm	Storm
Strait	Stræde (farvand)
Strait of Gibraltar	Gibraltarstrædet
Strait of Hormuz	Hormuzstrædet
Strait of Magellan	Magellanstrædet
Strait of Messina	Messinastrædet
Straits	Kategori:Stræder (farvand)
Strasbourg	Strasbourg
Strategy	Strategi
Stratigraphy	Stratigrafi
Stratosphere	Stratosfæren
Strawberry	Jordbær-slægten
Stress (medicine)	Stress
Stroke	Apopleksi
Strong interaction	Stærk kernekraft
Strontium	Strontium
Structuralism	Strukturalisme
Stub	Skabelon:Stub
Student	Student
Stupa	Stupa
Sturmabteilung	Sturmabteilung
Stuttgart	Stuttgart
Styx	Styx
Sub-Saharan Africa	Subsaharisk Afrika
Subculture	Subkultur
Sublimation (chemistry)	Sublimation (faseovergang)
Submarine	Undervandsbåd
Subtraction	Subtraktion
Subversion (software)	Subversion
Sucre	Sucre
Sucrose	Sukrose
Sudan	Sudan
Sudan	Kategori:Sudan
Sudoku	Sudoku
Suez Canal	Suez-kanalen
Suffix	Suffiks
Sufism	Sufisme
Sugar	Sukker
Suharto	Suharto
Sukarno	Achmed Sukarno
Sulawesi	Sulawesi
Sulfur	Svovl
Sulfur mustard	Sennepsgas
Sulfuric acid	Svovlsyre
Sultan	Sultan
Sumatra	Sumatra
Sumer	Sumererne
Summer	Sommer
Sumo	Sumo
Sun	Solen
Sun	Kategori:Solen
Sun Yat-sen	Sun Yat-sen
Sunday	Søndag
Sundial	Solur
Sunflower	Almindelig Solsikke
Sunni Islam	Sunni-islam
Sunspot	Solplet
Supercomputer	Supercomputer
Superconductivity	Superleder
Superman	Superman
Supernova	Supernova
Sura	Sura
Surgeon	Kirurgi
Surgery	Kirurgi
Suriname	Surinam
Suriname	Kategori:Surinam
Surrealism	Surrealisme
Surrey	Surrey
Susan Sontag	Susan Sontag
Sushi	Sushi
Suva	Suva
Svalbard	Svalbard
Swallow	Svaler
Swan	Svane
Swastika	Svastika
Swaziland	Swaziland
Swaziland	Kategori:Swaziland
Sweden	Sverige
Sweden	Kategori:Sverige
Swedish krona	Svenske kronor
Swimming	Svømning
Swimming	Kategori:Svømning
Swiss people	Kategori:Schweizere
Switzerland	Schweiz
Switzerland	Kategori:Schweiz
Sword	Sværd
Sydney	Sydney
Sylvia Plath	Sylvia Plath
Symbiosis	Symbiose
Symbol	Symbol
Symphony	Symfoni
Symptom	Symptom
Synagogue	Synagoge
Syndicate	Syndikat
Synesthesia	Synæstesi
Synonym	Synonym
Syntax	Syntaks
Synthesizer	Synthesizer
Syphilis	Syfilis
Syracuse	Siracusa
Syria	Syrien
Syria	Kategori:Syrien
System	System
Systematics	Systematik (biologi)
T	T
T. E. Lawrence	Lawrence of Arabia
T. S. Eliot	T.S. Eliot
Table (furniture)	Bord
Table tennis	Bordtennis
Taboo	Tabu
Tacitus	Tacitus
Taekwondo	Taekwondo
Tahiti	Tahiti
Tai chi chuan	Tai Chi
Tail	Hale
Taipei	Taipei
Taiwan	Taiwan (ø)
Taj Mahal	Taj Mahal
Tajikistan	Tadsjikistan
Tajikistan	Kategori:Tadsjikistan
Talc	Fedtsten
Taliban	Taliban
Tallahassee	Tallahassee
Tallinn	Tallinn
Talmud	Talmud
Tamil Nadu	Tamil Nadu
Tampa	Tampa
Tampere	Tampere
Tanakh	Tanakh
Tang Dynasty	Tang-dynastiet
Tangier	Tanger
Tango (dance)	Tango
Tank	Kampvogn
Tantalum	Tantal
Tantalus	Tantalos
Tanzania	Tanzania
Tanzania	Kategori:Tanzania
Taoism	Taoisme
Tardigrade	Bjørnedyr
Tarn	Tarn
Tarragon	Estragon
Tartarus	Tartaros
Tartu	Tartu
Tashkent	Tasjkent
Tasmania	Tasmanien
Tasmanian Devil	Tasmansk djævel
Tattoo	Tatovering
Tau	Tau
Taurus (constellation)	Tyren (stjernebillede)
Tawny Owl	Natugle
Tax	Skat
Taxation	Kategori:Skatter
Taxicab	Hyrevogn
Taxonomy	Taksonomi
Taxus baccata	Almindelig Taks
Tbilisi	Tbilisi
Tea	Te
Teacher	Lærer
Technetium	Technetium
Techno	Techno
Technology	Teknologi
Technology	Kategori:Teknologi
Tegucigalpa	Tegucigalpa
Tehran	Teheran
Tel Aviv	Tel Aviv
Telecommunication	Telekommunikation
Telegraphy	Telegrafi
Telephone	Telefon
Telescope	Kikkert
Telescopium	Kikkerten
Television	Tv
Television	Kategori:Tv
Tellurium	Tellur
Temperature	Temperatur
Temple	Tempel
Temple of Artemis	Artemistemplet i Efesos
Ten Commandments	De 10 bud
Tenerife	Tenerife
Tennessee	Tennessee
Tennessee	Kategori:Tennessee
Tennessee Williams	Tennessee Williams
Tennis	Tennis
Tennis	Kategori:Tennis
Tenzing Norgay	Tenzing Norgay
Tequila	Tequila
Terbium	Terbium
Termite	Termit (insekt)
Terpsichore	Terpsichore
Terrorism	Terrorisme
Terrorism	Kategori:Terrorisme
Tertullian	Tertullian
Tesla (unit)	Tesla
Testicle	Testikel
Testosterone	Testosteron
Tetanus	Stivkrampe
Tethys (moon)	Tethys (måne)
Tethys (mythology)	Tethys (mytologi)
Tetrahedron	Tetraeder
Tetrahydrocannabinol	Tetrahydrocannabinol
Tetrapod	Tetrapoder
Texas	Texas
Texas	Kategori:Texas
Textile	Tekstil
Thailand	Thailand
Thailand	Kategori:Thailand
Thales	Thales
Thalia	Thalia (muse)
Thallium	Thallium
Thanatos	Thanatos
Thanksgiving	Thanksgiving
Thanksgiving (Canada)	Thanksgiving
Thanksgiving (United States)	Thanksgiving
Thanksgiving (disambiguation)	Thanksgiving
The Gambia	Gambia
The Gambia	Kategori:Gambia
The Hague	Haag
The Star-Spangled Banner	The Star-Spangled Banner
Theatre	Teater
Theatre	Kategori:Teater
Thebe (moon)	Thebe (måne)
Thebes	Theben (Grækenland)
Thebes	Theben (Ægypten)
Theia	Thea
Themis	Themis
Themistocles	Themistokles
Theocracy	Teokrati
Theodolite	Teodolit
Theodor Mommsen	Theodor Mommsen
Theodore Roosevelt	Theodore Roosevelt
Theodosius I	Theodosius 1. den Store
Theology	Teologi
Theology	Kategori:Teologi
Theorem	Sætning (matematik)
Theory	Teori
Theory of relativity	Relativitetsteori
Theravada	Theravada
Thermodynamics	Termodynamik
Thermodynamics	Kategori:Termodynamik
Thermometer	Termometer
Theseus	Theseus
Thessaloniki	Thessaloniki
Theta	Theta
Thetis	Thetis
Thiamine	Tiamin
Think tank	Tænketank
Third World	Den tredje verden
Thirty Years' War	Trediveårskrigen
Thomas Aquinas	Thomas Aquinas
Thomas Edison	Thomas Edison
Thomas Hardy	Thomas Hardy
Thomas Hobbes	Thomas Hobbes
Thomas Jefferson	Thomas Jefferson
Thomas Malthus	Thomas Malthus
Thomas Mann	Thomas Mann
Thomas More	Thomas More
Thomas Paine	Thomas Paine
Thomas Young (scientist)	Thomas Young
Thor	Thor
Thorium	Thorium
Thoth	Thoth
Thrace	Thrakien
Thucydides	Thukydid
Thulium	Thulium
Thumb	Tommelfinger
Thuringia	Thüringen
Thuringia	Kategori:Thüringen
Thursday	Torsdag
Thylacine	Tasmansk pungulv
Thyme	Timian
Thymine	Thymin
Thyroid	Skjoldbruskkirtel
Tianjin	Tianjin
Tiber	Tiberen
Tiberius	Tiberius
Tibet	Tibet
Tibet	Kategori:Tibet
Ticino	Kanton Ticino
Tide	Tidevand
Tierra del Fuego	Ildlandet
Tiger	Tiger
Tigris	Tigris
Tilia	Lind
Timbuktu	Timbuktu
Time	Tid
Time	Kategori:Tid
Time (magazine)	Time Magazine
Time zone	Tidszone
Timor	Timor
Timur	Timur Lenk
Tin	Tin
Tirana	Tirana
Tissue (biology)	Væv
Titan (disambiguation)	Titan
Titan (moon)	Titan (måne)
Titan (mythology)	Titan (mytologi)
Titania (moon)	Titania (måne)
Titanic (disambiguation)	Titanic
Titanium	Titan (grundstof)
Titus	Titus Flavius Vespasianus
Tivoli	Tivoli (Italien)
Tobacco	Tobak
Tocopherol	Vitamin E
Tofu	Tofu
Togo	Togo
Togo	Kategori:Togo
Tokyo	Tokyo
Toledo	Toledo (Spanien)
Tom Hanks	Tom Hanks
Tom and Jerry	Tom & Jerry
Tomato	Tomat
Ton	Ton
Tonga	Tonga
Tonga	Kategori:Tonga
Tongue	Tunge
Toni Morrison	Toni Morrison
Tonne	Ton
Tony Blair	Tony Blair
Tool	Værktøj
Tooth	Tand
Toothbrush	Tandbørste
Topaz	Topas
Topeka	Topeka
Topology	Topologi
Topology	Kategori:Topologi
Torah	Tora
Tornado	Tornado
Toronto	Toronto
Torpedo	Torpedo
Torque	Drejningsmoment
Torture	Tortur
Torus	Torus
Totalitarianism	Totalitarisme
Toulon	Toulon
Toulouse	Toulouse
Tour de France	Tour de France
Tourism	Turisme
Tourism	Kategori:Turisme
Tours	Tours
Tower	Tårn
Tower of Babel	Babelstårnet
Tower of London	Tower of London
Town	By
Toxicity	Gift
Toxicology	Toksikologi
Toy	Legetøj
Toyota	Toyota
Tractor	Traktor
Trade	Handel
Trademark	Varemærke
Tradition	Tradition
Tragedy	Tragedie
Train	Tog
Train station	Jernbanestation
Trajan	Trajan
Tram	Sporvogn
Transcendental number	Transcendente tal
Transformer	Transformator
Transistor	Transistor
Transliteration	Translitteration
Transmission Control Protocol	TCP
Transportation	Kategori:Transport
Transsexualism	Transseksualitet
Transylvania	Transsylvanien
Trapezoid	Trapez (matematik)
Treaty	Traktat
Treaty of Versailles	Versailles-freden
Tree	Træ (organisme)
Trento	Trento
Trenton	Trenton
Triangle	Trekant
Triangulum	Trekanten
Triangulum Australe	Sydlige Trekant
Triassic	Trias
Tributary	Biflod
Trier	Trier
Trigonometric function	Trigonometrisk funktion
Trigonometry	Trigonometri
Trigonometry	Kategori:Trigonometri
Trilogy	Trilogi
Trinidad	Trinidad
Trinidad and Tobago	Trinidad og Tobago
Trinidad and Tobago	Kategori:Trinidad og Tobago
Trinitrotoluene	Trotyl
Trinity	Treenigheden
Tripoli	Tripoli
Triskelion	Triskele
Tritium	Tritium
Triton (moon)	Triton (måne)
Triton (mythology)	Triton
Triumphal arch	Triumfbue
Trojan Horse	Den trojanske hest
Trojan War	Den trojanske krig
Trojan horse (computing)	Trojansk hest
Troll	Trold
Troll (Internet)	Troll (Usenet)
Trolleybus	Trolleybus
Trombone	Basun
Trondheim	Trondheim
Tropic of Cancer	Krebsens vendekreds
Troposphere	Troposfære
Trotskyism	Trotskisme
Troy	Troja
Truck	Lastbil
Truman Doctrine	Trumandoktrinen
Trumpet	Trompet
Truth	Sandhed
Trygve Lie	Trygve Lie
Tryptophan	Tryptofan
Tsar	Zar
Tsunami	Tsunami
Tuareg	Tuareg
Tuba	Tuba
Tuberculosis	Tuberkulose
Tucana	Peberfuglen
Tucson	Tucson
Tuesday	Tirsdag
Tulip	Tulipan
Tumor	Tumor
Tundra	Tundra
Tungsten	Wolfram
Tunicate	Sækdyr
Tunis	Tunis
Tunisia	Tunesien
Tunisia	Kategori:Tunesien
Tunnel	Tunnel
Turbine	Turbine
Turin	Torino
Turing machine	Turingmaskine
Turkey	Tyrkiet
Turkey	Kategori:Tyrkiet
Turkmenistan	Turkmenistan
Turkmenistan	Kategori:Turkmenistan
Turmeric	Gurkemeje
Turtle	Skildpadde
Tuscany	Toscana
Tuvalu	Tuvalu
Tuvalu	Kategori:Tuvalu
Tux	Tux
Tycho Brahe	Tycho Brahe
Typewriter	Skrivemaskine
Typhon	Tyfon (græsk mytologi)
Typography	Typografi
Typography	Kategori:Typografi
Tyrannosaurus	Tyrannosaurus
Tyrrhenian Sea	Tyrrhenske hav
U	U
UNESCO	UNESCO
Uganda	Uganda
Uganda	Kategori:Uganda
Ukraine	Ukraine
Ukraine	Kategori:Ukraine
Ulan Bator	Ulan Bator
Ulster	Ulster
Ultrasound	Ultralyd
Ultraviolet	Ultraviolet lys
Ulysses S. Grant	Ulysses S. Grant
Umbrella	Paraply
Umbria	Umbria
Uncertainty principle	Heisenbergs ubestemthedsrelationer
Unemployment	Arbejdsløshed
Unicorn	Enhjørning
Unidentified flying object	Ufo (objekt)
Uniform Resource Locator	URL
United Arab Emirates	Forenede Arabiske Emirater
United Arab Emirates	Kategori:Forenede Arabiske Emirater
United Arab Republic	Forenede Arabiske Republik
United Kingdom	Storbritannien
United Kingdom	Kategori:Det Forenede Kongerige
United Nations	FN
United Nations	Kategori:Forenede Nationer
United Nations Children's Fund	UNICEF
United States	USA
United States	Kategori:USA
United States Air Force	United States Air Force
United States Congress	Kongressen
United States Constitution	USA's forfatning
United States House of Representatives	Repræsentanternes Hus (USA)
United States Military Academy	West Point
United States Navy	United States Navy
United States Senate	Senatet (USA)
United States Virgin Islands	Amerikanske Jomfruøer
United States dollar	Amerikanske dollar
Universe	Universet
University	Universitet
University of Chicago	University of Chicago
University of Pennsylvania	University of Pennsylvania
Unix	UNIX
Unix	Kategori:UNIX
Ununbium	Ununbium
Ununhexium	Ununhexium
Ununpentium	Ununpentium
Ununquadium	Ununquadium
Ununtrium	Ununtrium
Uppsala	Uppsala
Upsilon	Ypsilon (bogstav)
Ur	Ur (oldtidsby)
Uracil	Uracil
Ural Mountains	Uralbjergene
Urania	Urania
Uranium	Uran
Uranus	Uranus (planet)
Uranus	Kategori:Uranus
Uranus (mythology)	Uranus (mytologi)
Urdu	Urdu
Urea	Urinstof
Urine	Urin
Ursa Major	Store Bjørn
Ursa Minor	Lille Bjørn
Uruguay	Uruguay
Uruguay	Kategori:Uruguay
Utah	Utah
Utah	Kategori:Utah
Uterus	Livmoder
Utilitarianism	Utilitarisme
Utopia	Utopi
Utrecht (city)	Utrecht
Utrecht (province)	Utrecht (provins)
Uttar Pradesh	Uttar Pradesh
Uzbekistan	Usbekistan
Uzbekistan	Kategori:Usbekistan
V	V
Vaccine	Vaccination
Vacuole	Vakuole
Vacuum	Vakuum
Vacuum tube	Elektronrør
Vaduz	Vaduz
Vagina	Skede (kønsorgan)
Valence	Valence
Valence (chemistry)	Valens
Valencia	Valencia
Valencia	Valencia (flertydig)
Valentina Tereshkova	Valentina Teresjkova
Valentine's Day	Valentinsdag
Valhalla	Valhal
Valkyrie	Valkyrie
Valletta	Valletta
Valley	Dal
Vampire	Vampyr
Vanadium	Vanadium
Vancouver	Vancouver
Vancouver Island	Vancouver Island
Vanir	Vane (nordisk mytologi)
Vanuatu	Vanuatu
Vanuatu	Kategori:Vanuatu
Var (department)	Var (departement)
Variance	Varians
Varna	Varna
Vascular plant	Karplanter
Vatican City	Vatikanstaten
Vatican City	Kategori:Vatikanstaten
Vector (spatial)	Vektor (geometri)
Vegetable	Grøntsag
Vegetarianism	Vegetarisme
Vein	Vene
Vela (constellation)	Sejlet
Velociraptor	Velociraptor
Velocity	Hastighed
Veneto	Veneto
Venezuela	Venezuela
Venezuela	Kategori:Venezuela
Venice	Venedig
Venus	Venus (planet)
Venus (disambiguation)	Venus
Venus (mythology)	Venus (gudinde)
Verb	Udsagnsord
Vermont	Vermont
Vermont	Kategori:Vermont
Verona	Verona
Vertebral column	Rygsøjlen
Vertebrate	Hvirveldyr
Vespasian	Vespasian
Vesta (mythology)	Vesta
Veto	Veto
Vice President of the United States	Amerikanske vicepræsidenter
Vichy	Vichy
Victor Hugo	Victor Hugo
Victoria	Victoria (Seychellerne)
Victoria	Victoria (Canada)
Victoria	Victoria
Victoria (Australia)	Victoria (Australien)
Victoria Falls	Victoria Falls
Video	Video
Video game	Computerspil
Vienna	Wien
Vienna	Kategori:Wien
Vienne	Vienne
Vientiane	Vientiane
Vietnam	Vietnam
Vietnam	Kategori:Vietnam
Vietnam War	Vietnamkrigen
Vietnam War	Kategori:Vietnamkrigen
Viking	Viking
Village	Landsby
Vilnius	Vilnius
Vincent van Gogh	Vincent van Gogh
Vincenzo Bellini	Vincenzo Bellini
Vinegar	Eddike
Viola	Bratsch
Violence	Vold (handling)
Violin	Violin
Virgil	Publius Vergilius Maro
Virgin Islands	Jomfruøerne
Virginia	Virginia
Virginia	Kategori:Virginia
Virginia Woolf	Virginia Woolf
Virginity	Jomfru
Virgo (constellation)	Jomfruen
Virtual memory	Virtuel hukommelse
Virtual reality	Virtual reality
Virtue	Dyd
Virus	Virus (biologi)
Viscosity	Viskositet
Vishnu	Vishnu
Vistula	Wisła
Vitamin	Vitamin
Vitamin D	Vitamin D
Vitamin K	Vitamin K
Vittorio De Sica	Vittorio De Sica
Vitus Bering	Vitus Bering
Vivien Leigh	Vivien Leigh
Vladimir Lenin	Vladimir Lenin
Vladimir Nabokov	Vladimir Nabokov
Vladimir Putin	Vladimir Putin
Vladivostok	Vladivostok
Vocative case	Vokativ
Vodka	Vodka
Volans	Flyvefisken
Volcano	Vulkan
Volga River	Volga
Volgograd	Volgograd
Volleyball	Volleyball
Volleyball	Kategori:Volleyball
Volt	Volt
Voltage	Elektrisk spænding
Voltaire	Voltaire
Volume	Rumfang
Vomiting	Opkast
Voodoo	Voodoo
Vowel	Vokal (sprog)
Vulcan (mythology)	Vulcanus
Vulgar Latin	Vulgærlatin
Vulgate	Vulgata
Vulpecula	Ræven
Vulva	Vulva
W	W
WYSIWYG	WYSIWYG
Wahhabism	Wahabiter
Wake Island	Wake Island
Wales	Wales
Wales	Kategori:Wales
Walnut	Valnød-slægten
Walrus	Hvalros
Walt Disney	Walt Disney
Walt Whitman	Walt Whitman
Walter Gropius	Walter Adolph Gropius
Walter Scott	Walter Scott
War	Krig
War	Kategori:Krig
War crime	Krigsforbrydelse
War of the Spanish Succession	Spanske Arvefølgekrig
Wars of the Roses	Rosekrigene
Warsaw	Warszawa
Wart	Vorte
Washing machine	Vaskemaskine
Washington	Washington DC
Washington	Washington
Washington	Kategori:Washington
Washington (disambiguation)	Washington (flertydig)
Wassily Kandinsky	Wassily Kandinsky
Waste	Affald
Water	Vand
Water	Kategori:Vand
Water polo	Vandpolo
Waterfall	Vandfald
Watergate scandal	Watergate-skandalen
Watermelon	Vandmelon
Watt	Watt
Wave	Bølge
Wavelength	Bølgelængde
Wax	Voks
Weak interaction	Svag kernekraft
Weapon	Våben
Weather	Vejr
Web browser	Webbrowser
Web page	Webside
Webcam	Web cam
Weber (unit)	Weber
Wednesday	Onsdag
Week	Uge
Weight	Vægt (fysik)
Weightlifting	Vægtløftning
Weimar	Weimar
Weimar Republic	Weimarrepublikken
Welding	Svejsning
Wellington	Wellington
Werewolf	Varulv
Wernher von Braun	Wernher von Braun
Weser River	Weser
West Africa	Vestafrika
West Bank	Vestbredden
West Bengal	Vestbengalen
West Berlin	Vestberlin
West Germany	Vesttyskland
West Sussex	West Sussex
West Virginia	West Virginia
West Virginia	Kategori:West Virginia
Western Australia	Western Australia
Western Roman Empire	Vestromerske rige
Western Sahara	Vestsahara
Western Sahara	Kategori:Vestsahara
Westminster Abbey	Westminster Abbey
Whale	Hvaler
Wheat	Hvede
Wheel	Hjul
Whisky	Whisky
White House	Det Hvide Hus
White Sea	Hvidehavet
White dwarf	Hvid dværg
Wicca	Wicca
Wide area network	WAN
Wiesbaden	Wiesbaden
Wilhelm Ostwald	Wilhelm Ostwald
Will (law)	Testamente
William Blake	William Blake
William Butler Yeats	William Butler Yeats
William Faulkner	William Faulkner
William Gladstone	William Gladstone
William Golding	William Golding
William Henry Harrison	William Henry Harrison
William Herschel	William Herschel
William Howard Taft	William H. Taft
William I	Wilhelm 1. af Tyskland
William II	Wilhelm 2. af Tyskland
William James	William James
William McKinley	William McKinley
William Rowan Hamilton	William Rowan Hamilton
William Shakespeare	William Shakespeare
William Wordsworth	William Wordsworth
William of Ockham	William af Ockham
Willow	Pile-slægten
Willy Brandt	Willy Brandt
Wind instrument	Blæseinstrument
Wind power	Vindenergi
Windhoek	Windhoek
Windmill	Vindmølle
Window	Vindue
Wine	Vin
Wine	Kategori:Vin
Winnipeg	Winnipeg
Winston Churchill	Winston Churchill
Winter	Vinter
Winter Olympic Games	Vinter-OL
Wisconsin	Wisconsin
Wisconsin	Kategori:Wisconsin
Wolfgang Amadeus Mozart	Wolfgang Amadeus Mozart
Wolfgang Pauli	Wolfgang Pauli
Woman	Kvinde
Wood	Træ (materiale)
Woodrow Wilson	Woodrow Wilson
Woodwind instrument	Træblæser
Woody Allen	Woody Allen
Worcestershire	Worcestershire
Word	Ord
Word processor	Tekstbehandling
World Bank	Verdensbanken
World Health Organization	WHO
World Trade Center	World Trade Center
World Trade Organization	WTO
World War I	1. verdenskrig
World War I	Kategori:1. verdenskrig
World War II	2. verdenskrig
World War II	Kategori:2. verdenskrig
World Wide Web	World Wide Web
World Wide Web	Kategori:World Wide Web
World war	Verdenskrig
Worm	Orm
Wormhole	Ormehul
Writer	Skribent
Wuhan	Wuhan
Wyoming	Wyoming
Wyoming	Kategori:Wyoming
X	X
X-ray	Røntgenstråling
Xenarthra	Gumlere
Xenon	Xenon
Xenophanes	Xenofanes
Xenophobia	Xenofobi
Xenophon	Xenofon
Xi	Xi (bogstav)
Xinjiang	Xinjiang
Xylophone	Xylofon
Y	Y
Yahweh	Tetragrammaton
Yak	Yakokse
Yakuza	Yakuza
Yale University	Yale
Yalta	Jalta
Yalta Conference	Jaltakonferencen
Yangon	Rangoon
Yangtze River	Yangtze
Yard	Yard
Yasser Arafat	Yasser Arafat
Year	År
Years	Kategori:År
Yeast	Gærsvamp
Yellow	Gul
Yellow River	Den Gule Flod
Yellow Sea	Gule Hav
Yellowstone National Park	Yellowstone National Park
Yemen	Yemen
Yemen	Kategori:Yemen
Yenisei River	Jenisej
Yerevan	Jerevan
Yeti	Yeti
Yggdrasil	Yggdrasil
Yo-yo	Yoyo
Yoga	Yoga
Yoghurt	Jogurt
Yoko Ono	Yoko Ono
Yokohama	Yokohama
Yom Kippur	Yom Kippur
Yom Kippur War	Yom Kippur-krigen
York	York
Young's modulus	E-modul
Ytterbium	Ytterbium
Yttrium	Yttrium
Yuan Dynasty	Yuan-dynastiet
Yugoslavia	Jugoslavien
Yugoslavia	Kategori:Jugoslavien
Yukon	Yukon
Yunnan	Yunnan
Yuri Gagarin	Jurij Gagarin
Z	Z
Zachary Taylor	Zachary Taylor
Zagreb	Zagreb
Zambezi	Zambezi
Zambia	Zambia
Zambia	Kategori:Zambia
Zanzibar	Zanzibar
Zaragoza	Zaragoza
Zealand	Sjælland
Zebra	Zebra
Zen	Zen
Zenith	Zenit
Zeno of Citium	Zenon fra Kition
Zeno of Elea	Zenon fra Elea
Zeta	Zeta (bogstav)
Zeus	Zeus
Zeus (disambiguation)	Zeus
Ziggurat	Ziggurat
Zimbabwe	Zimbabwe
Zimbabwe	Kategori:Zimbabwe
Zinc	Zink
Zionism	Zionisme
Zirconium	Zirconium
Zodiac	Dyrekreds
Zombie	Zombie
Zoo	Zoologisk have
Zoology	Zoologi
Zoology	Kategori:Zoologi
Zoroaster	Zarathustra
Zoroastrianism	Zarathustrianisme
Zulu	Zuluer
