English	Indonesian
1	1
1 (number)	1 (angka)
10	10
10 (number)	10 (angka)
100	100
100	Kategori:100
1000	1000
1000	Kategori:1000
101	101
105	105
11	11
11 (number)	11 (angka)
110	110
115	115
12	12
12 (number)	12 (angka)
120	120
125	125
13	13
13 (number)	13 (angka)
130	130
135	135
14	14
14 (number)	14 (angka)
140	140
144	144
145	145
15	15
15 (number)	15 (angka)
150	150
1530s	1530-an
155	155
16	16
16 (number)	16 (angka)
160	160
165	165
17	17
17 (number)	17 (angka)
170	170
1728	1728
1728	Kategori:1728
175	175
1750s	1750-an
1750s	Kategori:1750-an
1760s	1760-an
1760s	Kategori:1760-an
1770s	1770-an
1770s	Kategori:1770-an
1780s	1780-an
1780s	Kategori:1780-an
1790s	1790-an
1790s	Kategori:1790-an
18	18
18 (number)	18 (angka)
180	180
1820s	1820-an
1820s	Kategori:1820-an
1830s	1830-an
1830s	Kategori:1830-an
1840s	1840-an
1840s	Kategori:1840-an
1850s	1850-an
1860s	1860-an
1860s	Kategori:1860-an
1870s	1870-an
1870s	Kategori:1870-an
1880s	1880-an
1880s	Kategori:1880-an
1890s	1890-an
1890s	Kategori:1890-an
19	19
19 (number)	19 (angka)
190	190
1900s	1900-an
1900s	Kategori:1900-an
1920s	1920-an
1920s	Kategori:1920-an
1930s	1930-an
1930s	Kategori:1930-an
1940s	1940-an
1940s	Kategori:1940-an
1950s	1950-an
1950s	Kategori:1950-an
1960s	1960-an
1960s	Kategori:1960-an
1970s	1970-an
1970s	Kategori:1970-an
1980s	1980-an
1980s	Kategori:1980-an
1990s	1990-an
1990s	Kategori:1990-an
2	2
2 (number)	2 (angka)
20	20
20 (number)	20 (angka)
200	200
21	21
21 (number)	21 (angka)
22	22
22 (number)	22 (angka)
23	23
23 (number)	23 (angka)
24	24
24 (TV series)	24 (serial televisi)
24 (number)	24 (angka)
25	25
25 (number)	25 (angka)
26	26
26 (number)	26 (angka)
27	27
27 (number)	27 (angka)
28	28
28 (number)	28 (angka)
29	29
29 (number)	29 (angka)
3	3
3 (number)	3 (angka)
30	30
30 (number)	30 (angka)
300	300
31	31
31 (number)	31 (angka)
32	32
33	33
34	34
35	35
36	36
37	37
38	38
39	39
4	4
4 (number)	4 (angka)
40	40
400	400
41	41
42	42
43	43
44	44
45	45
46	46
47	47
48	48
49	49
5	5
5 (number)	5 (angka)
50	50
500	500
500	Kategori:500
51	51
52	52
53	53
54	54
55	55
56	56
57	57
58	58
59	59
6	6
6 (number)	6 (angka)
60	60
61	61
62	62
63	63
64	64
65	65
66	66
67	67
68	68
69	69
7	7
7 (number)	7 (angka)
70	70
71	71
72	72
73	73
74	74
75	75
76	76
77	77
78	78
79	79
8	8
8 (number)	8 (angka)
80	80
81	81
82	82
83	83
84	84
85	85
86	86
87	87
88	88
89	89
9	9
9 (number)	9 (angka)
90	90
91	91
92	92
93	93
94	94
95	95
96	96
97	97
98	98
99	99
A cappella	A capella
AIDS	AIDS
ATP	ATP
AZ (football club)	AZ Alkmaar
Aachen	Aachen
Aalborg	Aalborg
Aarhus	Århus
Abacus	Sempoa
Abadan	Abadan
Abdomen	Abdomen
Abel Tasman	Abel Tasman
Aberdeen	Aberdeen
Abidjan	Abidjan
Abkhazia	Abkhazia
Abortion	Gugur kandungan
Abraham	Abraham
Abraham Lincoln	Abraham Lincoln
Absolute magnitude	Magnitudo mutlak
Abstract art	Seni abstrak
Abu Dhabi	Abu Dhabi
Abu Dhabi (emirate)	Abu Dhabi
Abuja	Abuja
Academy Award	Academy Awards
Acapulco	Acapulco
Acceleration	Percepatan
Accountancy	Akuntansi
Accountancy	Kategori:Akuntansi
Accra	Accra
Acetaldehyde	Asetaldehida
Acetic acid	Asam asetat
Acetylene	Asetilena
Acid	Asam
Acid rain	Hujan asam
Acne vulgaris	Jerawat
Acorn	Acorn
Acoustics	Kategori:Akustik
Acre	Akko
Acre (state)	Acre
Actinide	Aktinida
Actinium	Aktinium
Actor	Pemeran
Acts of the Apostles	Kisah Para Rasul
Acupuncture	Akupunktur
Ada (programming language)	Ada (bahasa pemrograman)
Adam	Adam
Adam Smith	Adam Smith
Adana	Adana
Adansonia	Baobab
Addiction	Kecanduan
Addis Ababa	Addis Ababa
Addition	Penjumlahan
Adelaide	Adelaide
Aden	Aden
Adenine	Adenin
Adenosine triphosphate	Adenosin trifosfat
Adjective	Adjektiva
Admiral	Laksamana
Adolescence	Remaja
Adolf Eichmann	Adolf Eichmann
Adolf Hitler	Adolf Hitler
Adrenal gland	Kelenjar adrenal
Adriatic Sea	Laut Adriatik
Adsorption	Adsorpsi
Adult	Dewasa
Advent	Adven
Adverb	Adverbia
Advertising	Iklan
Aegean Sea	Laut Aegea
Aerodynamics	Aerodinamika
Aerosol	Aerosol
Aesop	Aesop
Aesthetics	Estetika
Affix	Afiks
Afghanistan	Afganistan
Afghanistan	Kategori:Afganistan
Africa	Afrika
Africa	Kategori:Afrika
African American	Afrika-Amerika
Afrikaans	Bahasa Afrikaans
Agamemnon	Agamemnon
Agar	Agar-agar
Agatha Christie	Agatha Christie
Aggression	Agresi
Agnosticism	Agnostisisme
Agra	Agra
Agriculture	Pertanian
Agriculture	Kategori:Pertanian
Agrigento	Agrigento
Aikido	Aikido
Ain	Ain (departemen)
Air force	Angkatan udara
Airbus	Airbus
Aircraft	Pesawat terbang
Aircraft	Kategori:Pesawat
Aircraft carrier	Kapal induk
Airline	Maskapai penerbangan
Airport	Bandar udara
Ajax	Ajax
Ajax (programming)	AJAX
Akhenaten	Akhenaten
Akira Kurosawa	Akira Kurosawa
Al Capone	Al Capone
Al Gore	Al Gore
Al-Qaeda	Al-Qaeda
Alabama	Alabama
Alabama	Kategori:Alabama
Alan Turing	Alan Turing
Alanine	Alanin
Alaska	Alaska
Alaska	Kategori:Alaska
Albania	Albania
Albania	Kategori:Albania
Albany	Albany, New York
Albatross	Albatros
Albert Abraham Michelson	Albert Abraham Michelson
Albert Camus	Albert Camus
Albert Einstein	Albert Einstein
Albert Schweitzer	Albert Schweitzer
Albert Speer	Albert Speer
Alberta	Alberta
Alberta	Kategori:Alberta
Album	Album
Albuquerque	Albuquerque, New Mexico
Alchemy	Alkimia
Alchemy	Kategori:Alkimia
Alcohol	Alkohol
Alcoholic beverage	Minuman beralkohol
Alcoholism	Alkoholisme
Aldehyde	Alkanal
Alec Guinness	Alec Guinness
Aleksandr Solzhenitsyn	Aleksandr Solzhenitsyn
Aleppo	Aleppo
Aleutian Islands	Kepulauan Aleut
Alexander Fleming	Alexander Fleming
Alexander Graham Bell	Alexander Graham Bell
Alexander Hamilton	Alexander Hamilton
Alexander Pushkin	Aleksandr Pushkin
Alexander the Great	Alexander Agung
Alexandre Dumas	Alexandre Dumas
Alexandria	Iskandariyah
Alfred Dreyfus	Alfred Dreyfus
Alfred Hitchcock	Alfred Hitchcock
Alfred Nobel	Alfred Nobel
Algae	Alga
Algebra	Aljabar
Algebra	Kategori:Aljabar
Algeria	Aljazair
Algeria	Kategori:Aljazair
Algiers	Aljir
Algorithm	Algoritma
Alhambra	Alhambra
Ali	Ali bin Abi Thalib
Alkali metal	Logam alkali
Alkane	Alkana
Alkene	Alkena
Alkyne	Alkuna
Allah	Allah
Allegory	Alegori
Allele	Alel
Allergy	Alergi
Alliteration	Aliterasi
Alloy	Aloy
Almanac	Almanak
Almaty	Almaty
Almond	Badam
Alpha (letter)	Alfa
Alpha Centauri	Alpha Centauri
Alpha particle	Partikel Alfa
Alphabet	Alfabet
Alps	Alpen
Alsace	Alsace
Altar	Altar
Altay Mountains	Pegunungan Altai
Alternative medicine	Kategori:Pengobatan alternatif
Altruism	Altruisme
Aluminium	Aluminium
Aluminium oxide	Aluminium oksida
Alzheimer's disease	Alzheimer
Amaryllidaceae	Amaryllidaceae
Amaterasu	Amaterasu
Amazon River	Sungai Amazon
Ambassador	Duta Besar
Ambrose	Ambrosius
Amedeo Avogadro	Amedeo Avogadro
Amelia Earhart	Amelia Earhart
American Civil War	Perang Saudara Amerika
American Revolutionary War	Perang Revolusi Amerika
American Samoa	Samoa Amerika
American Standard Code for Information Interchange	ASCII
American football	Sepak bola Amerika
American football	Kategori:Sepak bola Amerika
Amerigo Vespucci	Amerigo Vespucci
Amharic	Bahasa Amhar
Amide	Amida
Amino acid	Asam amino
Amish	Amish
Amman	Amman
Ammonia	Amonia
Amnesia	Amnesia
Amnesty	Amnesti
Ampere	Ampere
Amphetamine	Amfetamin
Amphibian	Amfibia
Amplitude	Amplitudo
Amsterdam	Amsterdam
Anagram	Anagram
Anaheim	Anaheim, California
Anal sex	Seks anal
Anarchism	Anarkisme
Anarchism	Kategori:Anarkisme
Anatidae	Anatidae
Anatole France	Anatole France
Anatomy	Kategori:Anatomi
Anatomy	Anatomi
Anaxagoras	Anaxagoras
Anaximander	Anaximander
Anchor	Jangkar
Anchorage	Anchorage, Alaska
Ancient Greek	Bahasa Yunani Kuno
Andalusia	Andalusia
Andaman Sea	Laut Andaman
Anders Celsius	Anders Celsius
Andes	Andes
Andhra Pradesh	Andhra Pradesh
Andorra	Andorra
Andorra	Kategori:Andorra
Andrei Sakharov	Andrei Sakharov
Andrew Jackson	Andrew Jackson
Andrew Johnson	Andrew Johnson
Android	Android
Andromeda	Andromeda
Andromeda (constellation)	Andromeda (rasi bintang)
Andromeda (mythology)	Andromeda (mitologi)
Andy Warhol	Andy Warhol
Anemia	Anemia
Anesthesia	Anestesi
Angel	Malaikat
Angel Falls	Air terjun Angel
Angle	Sudut (geometri)
Anglicanism	Anglikanisme
Angola	Angola
Angola	Kategori:Angola
Anguilla	Anguilla
Angular momentum	Momentum sudut
Animal	Hewan
Animal husbandry	Peternakan
Animation	Animasi
Anime	Anime
Anime	Kategori:Anime
Animism	Animisme
Ankara	Ankara
Annapolis	Annapolis, Maryland
Annelid	Annelida
Anno Domini	Anno Domini
Anode	Anode
Anorexia nervosa	Anorexia nervosa
Ant	Semut
Antakya	Antakya
Antalya	Antalya
Antananarivo	Antananarivo
Antarctica	Antarktika
Antarctica	Kategori:Antarktika
Antares	Antares
Anthony Hopkins	Anthony Hopkins
Anthrax	Antraks
Anthropology	Antropologi
Anthropology	Kategori:Antropologi
Antibiotic	Antibiotika
Antibody	Antibodi
Antichrist	Antikristus
Antigen	Antigen
Antigua and Barbuda	Antigua dan Barbuda
Antigua and Barbuda	Kategori:Antigua dan Barbuda
Antimatter	Antimateri
Antimony	Antimon
Antioxidant	Antioksidan
Antipope	Anti-Paus
Antisemitism	Antisemitisme
Antlia	Antlia
Antofagasta	Antofagasta
Antoine Lavoisier	Antoine Lavoisier
Anton Bruckner	Anton Bruckner
Anton Chekhov	Anton Chekhov
Antonio Vivaldi	Antonio Vivaldi
Antonym	Antonim
Antwerp	Antwerpen
Antwerp (province)	Antwerpen (provinsi)
Anus	Anus
Aorta	Aorta
Apache	Suku Apache
Ape	Kera
Aphrodite	Aphrodite
Apia	Apia
Apollo	Apollo (mitologi)
Apollo program	Program Apollo
Apollo program	Kategori:Program Apollo
Apoptosis	Apoptosis
Appendicitis	Apendisitis
Apple	Apel
Apricot	Aprikot
April	April
April 14	14 April
April Fools' Day	April Mop
Apulia	Puglia
Apus	Apus
Aqaba	Aqaba
Aqua regia	Aqua regia
Aquarium	Akuarium
Aquarius (constellation)	Aquarius
Aquila (constellation)	Aquila
Aquitaine	Aquitaine
Ara (constellation)	Ara
Arab	Bangsa Arab
Arab League	Liga Arab
Arabian Peninsula	Jazirah Arab
Arabian Sea	Laut Arab
Arabic alphabet	Alfabet Arab
Arabic language	Bahasa Arab
Araceae	Araceae
Arachnid	Arachnida
Arafura Sea	Laut Arafura
Aragon	Aragon
Aral Sea	Laut Aral
Aram Khachaturian	Aram Khachaturian
Archaeology	Arkeologi
Archaeology	Kategori:Arkeologi
Archaeopteryx	Archeopteryx
Archbishop	Uskup Agung
Archean	Arkean
Archimedes	Archimedes
Archipelago	Kepulauan
Architect	Arsitek
Architecture	Arsitektur
Architecture	Kategori:Arsitektur
Archive	Arsip
Arctic	Arktik
Arctic Ocean	Samudra Arktik
Ardennes (department)	Ardennes
Are	Are
Area	Luas
Arecaceae	Arecaceae
Ares	Ares
Argentina	Argentina
Argentina	Kategori:Argentina
Argon	Argon
Arianism	Arianisme
Aries (constellation)	Aries
Aristarchus of Samos	Aristarchus
Aristocracy	Aristokrasi
Aristophanes	Aristofanes
Aristotle	Aristoteles
Arithmetic	Aritmatika
Arithmetic	Kategori:Aritmatika
Arizona	Arizona
Arizona	Kategori:Arizona
Arkansas	Arkansas
Arkansas	Kategori:Arkansas
Arles	Arles
Armadillo	Armadillo
Armenia	Armenia
Armenia	Kategori:Armenia
Armenian language	Bahasa Armenia
Armour	Baju zirah
Army	Angkatan darat
Arnhem	Arnhem
Arquebus	Arquebus
Arras	Arras
Arrow	Anak panah
Arsenic	Arsen
Art	Seni
Art Deco	Art Deco
Art history	Kategori:Sejarah seni
Artemis	Artemis
Artery	Pembuluh nadi
Arthritis	Pirai
Arthropod	Arthropoda
Arthur Compton	Arthur H. Compton
Arthur Conan Doyle	Arthur Conan Doyle
Arthur Miller	Arthur Miller
Arthur Rimbaud	Arthur Rimbaud
Arthur Wellesley	Arthur Wellesley dari Wellington
Artificial intelligence	Kecerdasan buatan
Artificial intelligence	Kategori:Kecerdasan buatan
Artillery	Artileri
Artillery	Kategori:Artileri
Artist	Seniman
Arts	Kategori:Seni
Aruba	Aruba
Aruba	Kategori:Aruba
Asbestos	Asbestos
Asgard	Asgard
Ash Wednesday	Rabu Abu
Asia	Asia
Asia	Kategori:Asia
Asmara	Asmara, Eritrea
Aspartame	Aspartam
Asphalt	Aspal
Aspirin	Aspirin
Assam	Assam
Assassination	Pembunuhan rahasia
Association of Southeast Asian Nations	Perhimpunan Bangsa-bangsa Asia Tenggara
Astana	Astana, Kazakhstan
Astatine	Astatin
Asteraceae	Kategori:Asteraceae
Asteroid	Asteroid
Asthma	Asma
Astigmatism (eye)	Astigmatisma
Astrakhan	Astrakhan
Astrology	Astrologi
Astrology	Kategori:Astrologi
Astrometry	Astrometri
Astronaut	Antariksawan
Astronomer	Astronom
Astronomical unit	Satuan astronomi
Astronomy	Astronomi
Astronomy	Kategori:Astronomi
Astronomy	Portal:Astronomi
Astrophysics	Astrofisika
Astrophysics	Kategori:Astrofisika
Aswan	Aswan
Asynchronous Transfer Mode	Asynchronous Transfer Mode
Atheism	Kategori:Ateisme
Athena	Dewi Athena
Athens	Kota Athena
Athletics	Kategori:Atletik
Athletics (track and field)	Atletik
Atlanta	Atlanta
Atlantic Ocean	Samudra Atlantik
Atlantic Ocean	Kategori:Samudra Atlantik
Atlantis	Atlantis
Atlas (disambiguation)	Atlas (disambiguasi)
Atlas Mountains	Pegunungan Atlas
Atmosphere	Atmosfer benda langit
Atmospheric pressure	Tekanan atmosfer
Atom	Atom
Atomic clock	Jam atom
Atomic mass	Massa atom
Atomic mass unit	Satuan massa atom
Atomic number	Nomor atom
Atomic physics	Fisika atom
Attica	Attika
Attila the Hun	Attila
Auckland	Auckland
August	Agustus
August 1	1 Agustus
August 15	15 Agustus
August 6	6 Agustus
August Strindberg	August Strindberg
Augusta	Augusta, Maine
Auguste Rodin	Auguste Rodin
Augustine of Hippo	Agustinus dari Hippo
Augustus	Oktavianus
Auriga (constellation)	Auriga
Aurora	Aurora (disambiguasi)
Aurora (astronomy)	Aurora
Austin	Austin, Texas
Australasia	Australasia
Australia	Australia
Australia	Kategori:Australia
Australian dollar	Dolar Australia
Austria	Austria
Austria	Kategori:Austria
Austria-Hungary	Austria-Hongaria
Author	Penulis
Autism	Autisme
Automated teller machine	ATM
Automobile	Mobil
Autumn	Musim gugur
Auvergne (region)	Auvergne
Avalanche	Longsor salju
Avatar	Awatara
Avena	Avena
Averroes	Ibnu Rusyd
Aviation	Kategori:Penerbangan
Avicenna	Ibnu Sina
Avignon	Avignon
Avocado	Apokat
Avogadro's law	Hukum Avogadro
Axe	Kapak
Axiom	Aksioma
Axon	Akson
Ayatollah	Ayatullah
Ayn Rand	Ayn Rand
Azerbaijan	Azerbaijan
Azerbaijan	Kategori:Azerbaijan
Azimuth	Azimut
Azores	Azores
Aztec	Aztek
BASIC	BASIC
Baal	Baal
Babylonia	Babilonia
Backgammon	Backgammon
Bacteria	Bakteri
Bacteria	Kategori:Bakteri
Bactrian Camel	Unta Baktrian
Badminton	Bulutangkis
Baffin Island	Pulau Baffin
Baghdad	Bagdad
Bahamas	Kategori:Bahama
Bahrain	Bahrain
Bahrain	Kategori:Bahrain
Baja California	Baja California (negara bagian)
Baklava	Baklava
Baku	Baku
Balalaika	Balalaika
Balance sheet	Laporan neraca
Baldr	Balder
Balearic Islands	Kepulauan Balears
Baleen whale	Paus balin
Bali	Bali
Balkan Wars	Perang Balkan
Balkans	Balkan
Ball	Bola
Ballet	Balet
Ballet	Kategori:Balet
Ballistic missile	Peluru kendali balistik
Ballpoint pen	Pulpen
Baltic Sea	Laut Baltik
Baltimore	Baltimore, Maryland
Bamako	Bamako
Bamboo	Bambu
Banana	Pisang
Bangalore	Bengaluru
Bangkok	Bangkok
Bangladesh	Bangladesh
Bangladesh	Kategori:Bangladesh
Bangui	Bangui
Banjul	Banjul
Bank	Bank
Banks	Kategori:Bank
Baptist	Gereja Baptis
Bar (unit)	Bar
Barbados	Barbados
Barbados	Kategori:Barbados
Barbra Streisand	Barbra Streisand
Barcelona	Barcelona
Barents Sea	Laut Barents
Bari	Bari
Barium	Barium
Barley	Jelai
Barn Swallow	Layang-layang Asia
Barometer	Barometer
Baroque	Barok
Barranquilla	Barranquilla
Barrel (unit)	Barrel (satuan)
Base (chemistry)	Basa
Baseball	Bisbol
Basel	Basel
Basidiomycota	Basidiomycota
Basil	Selasih
Basilica	Basilika
Basilicata	Basilicata
Basilisk	Basilisk
Basketball	Bola basket
Basketball	Kategori:Bola basket
Basra	Basra
Bass guitar	Gitar bass
Basse-Normandie	Basse-Normandie
Basseterre	Basseterre
Bastille	Bastille
Bat	Kelelawar
Bath	Bath, Inggris
Batman	Batman
Baton Rouge	Baton Rouge, Louisiana
Battalion	Batalyon
Battle of Austerlitz	Pertempuran Austerlitz
Battle of Hastings	Pertempuran Hastings
Battle of Thermopylae	Pertempuran Thermopylae
Battle of Trafalgar	Pertempuran Trafalgar
Battle of Waterloo	Pertempuran Waterloo
Bauhaus	Bauhaus
Bavaria	Bayern
Bay of Bengal	Teluk Benggala
Bayer	Bayer
Bayonne	Bayonne
Beach	Pantai
Bear	Beruang
Beaver	Berang-berang
Bebop	Bebop
Becquerel	Becquerel
Bed	Ranjang
Bede	Beda
Bedouin	Suku Badui (Arab)
Beer	Bir
Beer	Kategori:Bir
Beetle	Kumbang
Behaviorism	Behaviorisme
Beijing	Beijing
Beirut	Beirut
Belarus	Belarus
Belarus	Kategori:Belarus
Belfast	Belfast
Belgium	Belgia
Belgium	Kategori:Belgia
Belgrade	Beograd
Belize	Belize
Belize	Kategori:Belize
Bell (instrument)	Lonceng
Belo Horizonte	Belo Horizonte
Beluga	Paus Beluga
Benelux	Benelux
Bengal	Benggala
Benghazi	Benghazi
Benin	Benin
Benin	Kategori:Benin
Benito Mussolini	Benito Mussolini
Benjamin Disraeli	Benjamin Disraeli, 1st Earl of Beaconsfield
Benjamin Franklin	Benjamin Franklin
Benjamin Harrison	Benjamin Harrison
Benny Goodman	Benny Goodman
Bergen	Bergen
Bering Strait	Selat Bering
Berkelium	Berkelium
Berkshire	Berkshire
Berlin	Berlin
Berlin	Kategori:Berlin
Bermuda	Bermuda
Bermuda	Kategori:Bermuda
Bermuda Triangle	Segitiga Bermuda
Bernardo Bertolucci	Bernardo Bertolucci
Berne	Bern
Bernhard Riemann	Georg Friedrich Bernhard Riemann
Bertrand Russell	Bertrand Russell
Beryllium	Berilium
Beta (letter)	Beta (huruf Yunani)
Beta decay	Peluruhan beta
Betelgeuse	Betelgeuse
Bethlehem	Betlehem
Bette Davis	Bette Davis
Bhutan	Bhutan
Bhutan	Kategori:Bhutan
Bible	Alkitab
Bible	Kategori:Alkitab
Bicycle	Sepeda
Big Bang	Big Bang
Bihar	Bihar
Bikini	Bikini
Bile	Empedu
Bill Clinton	Bill Clinton
Bill Gates	Bill Gates
Billy Wilder	Billy Wilder
Binoculars	Binokular
Biochemistry	Biokimia
Biochemistry	Kategori:Biokimia
Biodiversity	Keanekaragaman hayati
Biography	Biografi
Biography	Portal:Biografi
Biology	Biologi
Biology	Kategori:Biologi
Biology	Portal:Biologi
Biomass	Biomassa
Biome	Bioma
Biometrics	Biometrik
Biophysics	Biofisika
Biosphere	Biosfer
Biotechnology	Bioteknologi
Biotechnology	Kategori:Bioteknologi
Bird	Burung
Birmingham	Birmingham, Alabama
Birth control	Keluarga Berencana
Bisexuality	Biseksualitas
Bishkek	Bishkek
Bishop	Uskup
Bismarck	Bismarck, North Dakota
Bismuth	Bismut
Bissau	Bissau
Bit	Bit
Black	Hitam
Black Death	Kematian Hitam
Black Sea	Laut Hitam
Black body	Benda hitam
Black hole	Lubang hitam
Blaise Pascal	Blaise Pascal
Blender (software)	Blender
Blindness	Kebutaan
Blitzkrieg	Blitzkrieg
Bloemfontein	Bloemfontein
Blog	Blog
Blood	Darah
Blood plasma	Plasma darah
Blood pressure	Tekanan darah
Blood type	Golongan darah
Blood vessel	Pembuluh darah
Blue	Biru
Blue Whale	Paus Biru
Blues	Blues
Boar	Babi hutan
Boat	Perahu
Bob Dylan	Bob Dylan
Bob Marley	Bob Marley
Bobby Fischer	Bobby Fischer
Bodhisattva	Bodhisattva
Bohemia	Bohemia
Boiling point	Titik didih
Boise	Boise, Idaho
Bolivia	Bolivia
Bolivia	Kategori:Bolivia
Bollywood	Bollywood
Bologna	Bologna
Bolshevik	Bolshevik
Bolzano	Bolzano-Bozen
Bomb	Bom
Bomber	Pesawat pengebom
Bombyx mori	Ulat sutra
Bond (finance)	Obligasi
Bone	Tulang
Bone marrow	Sumsum tulang
Bonn	Bonn
Bonsai	Bonsai
Book	Buku
Book of Esther	Kitab Ester
Book of Joshua	Kitab Yosua
Book of Judges	Kitab Hakim-hakim
Book of Mormon	Kitab Mormon
Book of Numbers	Kitab Bilangan
Book of Revelation	Wahyu kepada Yohanes
Book of Ruth	Kitab Rut
Boolean algebra (structure)	Aljabar Boolean
Boomerang	Bumerang
Bordeaux	Bordeaux
Boris Pasternak	Boris Leonidovich Pasternak
Borneo	Pulau Borneo
Boron	Boron
Bosnia and Herzegovina	Bosnia-Herzegovina
Bosnia and Herzegovina	Kategori:Bosnia-Herzegovina
Boson	Boson
Bosporus	Selat Bosporus
Boston	Boston
Boston Tea Party	Boston Tea Party
Bot	Templat:Bot
Botanical garden	Kebun raya
Botany	Botani
Botany	Kategori:Botani
Botswana	Botswana
Botswana	Kategori:Botswana
Bottle	Botol
Bottlenose Dolphin	Lumba-lumba hidung botol
Bourgogne	Bourgogne
Bouvet Island	Pulau Bouvet
Bowling	Boling
Boxer (dog)	Boxer (anjing)
Boxers	Kategori:Petinju
Boxing	Tinju
Boxing	Kategori:Tinju
Braga	Braga, Portugal
Brahma	Brahma
Brahmaputra River	Sungai Brahmaputra
Braille	Braille
Brain	Otak
Bram Stoker	Bram Stoker
Brandenburg	Brandenburg
Brandy	Brendi
Brass	Kuningan (logam)
Brassicaceae	Brassicaceae
Bratislava	Bratislava
Braunschweig	Braunschweig
Brazil	Brasil
Brazil	Kategori:Brasil
Brazzaville	Brazzaville
Bread	Roti
Breast	Payudara
Breast cancer	Kanker payudara
Bremen (state)	Bremen
Bremerhaven	Bremerhaven
Brescia	Brescia
Brest	Brest, Perancis
Brest	Brest-Litovsk
Brest	Brest
Bretagne	Bretagne
Brick	Batu bata
Bridge	Jembatan
Bridges	Kategori:Jembatan
Bridgetown	Bridgetown
Brigade	Brigade
Brighton	Brighton
Brindisi	Brindisi
Brisbane	Brisbane
Bristol	Bristol
British Columbia	British Columbia
British Empire	Imperium Britania
British Virgin Islands	Kepulauan Virgin Britania Raya
British people	Kategori:Tokoh Britania Raya
Brno	Brno
Broccoli	Brokoli
Bromine	Brom
Bronze	Perunggu
Bronze Age	Zaman Perunggu
Brown Bear	Beruang coklat
Brownian motion	Gerak Brown
Bruce Lee	Bruce Lee
Bruges	Brugge
Brunei	Brunei
Brunei	Kategori:Brunei
Brussels	Kota Brussel
Bucharest	Bukares
Buckingham Palace	Istana Buckingham
Buckminster Fuller	Buckminster Fuller
Budapest	Budapest
Buddha	Buddha
Buddhism	Agama Buddha
Buddhism	Kategori:Buddhisme
Buddy Holly	Buddy Holly
Buenos Aires	Buenos Aires
Buffalo	Buffalo, New York
Building	Bangunan
Bulgaria	Bulgaria
Bulgaria	Kategori:Bulgaria
Bureaucracy	Birokrasi
Burgomaster	Walikota
Burkina Faso	Burkina Faso
Burkina Faso	Kategori:Burkina Faso
Burma	Myanmar
Burma	Kategori:Myanmar
Burqa	Burqa
Bursa	Bursa, Turki
Burundi	Kategori:Burundi
Bus	Bus (transportasi)
Bus (computing)	Bus komputer
Business	Bisnis
Businesspeople	Kategori:Wirausahawan
Buster Keaton	Buster Keaton
Butane	Butana
Butter	Mentega
Butterfly effect	Efek kupu-kupu
Bydgoszcz	Bydgoszcz
Byte	Bita
C (programming language)	C (bahasa pemrograman)
C. S. Lewis	C.S. Lewis
CD (disambiguation)	CD
CN Tower	Menara CN
COBOL	COBOL
Cabaret	Kabaret
Cacao	Kakao
Cache	Memori Cache
Cactus	Kaktus
Cadmium	Kadmium
Caelum	Caelum
Caesium	Sesium
Caffeine	Kafein
Cairo	Kairo
Cake	Bolu
Calabria	Calabria
Calais	Calais
Calcium	Kalsium
Calculator	Mesin hitung
Calculus	Kalkulus
Caldera	Kaldera
Calendar	Kalender
California	California
California	Kategori:California
Caligula	Caligula
Caliph	Khalifah
Calorie	Kalori
Calvados	Calvados
Calvin Coolidge	Calvin Coolidge
Calvinism	Calvinisme
Cambodia	Kamboja
Cambodia	Kategori:Kamboja
Cambrian	Kambrium
Cambridge	Cambridge, Cambridgeshire
Cambridge	Cambridge, Massachusetts
Cambridge (disambiguation)	Cambridge
Camel	Unta
Camera	Kamera
Cameroon	Kamerun
Cameroon	Kategori:Kamerun
Campania	Campania
Canada	Kanada
Canada	Kategori:Kanada
Canadian dollar	Dollar Kanada
Canary Islands	Kepulauan Canary
Canary Islands	Kategori:Kepulauan Canary
Canberra	Canberra
Cancer	Kanker
Cancer (constellation)	Cancer
Candela	Candela
Candle	Lilin
Canidae	Canidae
Canis Major	Canis Major
Canis Minor	Canis Minor
Cannabis	Cannabis
Cannabis (drug)	Ganja
Cannes	Cannes
Cannibalism	Kanibalisme
Cannon	Meriam
Canoe	Kano
Canon (company)	Canon (perusahaan)
Canopus	Canopus
Canterbury	Canterbury
Cantonese (linguistics)	Kantonis (linguistik)
Capacitor	Kondensator
Cape Canaveral	Cape Canaveral
Cape Horn	Tanjung Horn
Cape Town	Cape Town
Cape Verde	Tanjung Verde
Cape Verde	Kategori:Tanjung Verde
Cape of Good Hope	Tanjung Harapan
Capital	Ibu kota
Capital (economics)	Modal
Capital punishment	Hukuman mati
Capitalism	Kapitalisme
Capricornus	Capricornus
Caracas	Caracas
Carambola	Belimbing
Caravaggio	Lukisan Caravaggio
Carbohydrate	Karbohidrat
Carbon	Karbon
Carbon cycle	Siklus karbon
Carbon dioxide	Karbon dioksida
Carbon monoxide	Karbon monoksida
Carboniferous	Karbon (periode)
Carboxylic acid	Asam alkanoat
Carburetor	Karburator
Card game	Permainan kartu
Cardamom	Kapulaga
Cardiff	Cardiff
Cardinal (Catholicism)	Kardinal
Cardiology	Kardiologi
Cardiology	Kategori:Kardiologi
Cardiovascular system	Kategori:Sistem kardiovaskular
Caribbean	Kepulauan Karibia
Caribbean	Kategori:Karibia
Caribbean Sea	Laut Karibia
Carina (constellation)	Carina
Carl David Anderson	Carl D. Anderson
Carl Jung	Carl Gustav Jung
Carl Maria von Weber	Carl Maria von Weber
Carnival	Karnaval
Carnivora	Carnivora
Carnivore	Karnivora
Carolus Linnaeus	Carolus Linnaeus
Carrot	Wortel
Carson City	Carson City, Nevada
Cartesian coordinate system	Sistem koordinat Kartesius
Carthage	Kartago
Cartography	Kartografi
Cartography	Kategori:Kartografi
Cary Grant	Cary Grant
Casablanca	Casablanca
Cashew	Kacang Mede
Casino	Kasino (tempat perjudian)
Caspian Sea	Laut Kaspia
Cassiopeia (constellation)	Cassiopeia
Caste	Kasta
Castle	Kastil
Castries	Castries
Casus belli	Casus belli
Cat	Kucing
Catalonia	Catalunya
Catalysis	Katalis
Cataphract	Kataphract
Cataract	Katarak
Cathedral	Katedral
Cathode	Katoda
Catholicism	Katolik
Cattle	Sapi
Cattle Egret	Kuntul Kerbau
Catullus	Catullus
Caucasus	Kaukasus
Caucasus	Kategori:Kaukasus
Caucasus Mountains	Pegunungan Kaukasus
Cauliflower	Kubis bunga
Cavalry	Kavaleri
Cave	Gua
Cayman Islands	Kepulauan Cayman
Cecil Rhodes	Cecil Rhodes
Celery	Seledri
Celestial equator	Ekuator langit
Celibacy	Selibat
Cell (biology)	Sel (biologi)
Cell membrane	Membran sel
Cell nucleus	Inti sel
Cell wall	Dinding sel
Cello	Cello
Cellulose	Selulosa
Celsius	Celsius
Cement	Semen
Cemetery	Pemakaman
Cenozoic	Kenozoikum
Census	Sensus
Centaur	Centaurus (mitologi)
Centaurus	Centaurus (rasi bintang)
Centimetre	Sentimeter
Central Africa	Afrika Tengah
Central African Republic	Republik Afrika Tengah
Central African Republic	Kategori:Republik Afrika Tengah
Central America	Amerika Tengah
Central America	Kategori:Amerika Tengah
Central Intelligence Agency	CIA
Central Park	Central Park
Central Powers	Blok Sentral
Central bank	Bank sentral
Central processing unit	CPU
Centre	Centre
Century	Abad
Cepheus (constellation)	Cepheus
Ceramic	Keramik
Cerberus	Cerberus
Cereal	Serealia
Ceres	Ceres
Ceres (dwarf planet)	1 Ceres
Cerium	Serium
Cetacea	Cetacea
Cetus	Cetus
Chad	Chad
Chad	Kategori:Chad
Chair	Kursi
Champagne (wine)	Sampanye
Champagne-Ardenne	Champagne-Ardenne
Channel Tunnel	Terowongan Channel
Chaos (mythology)	Khaos
Charlemagne	Charlemagne
Charleroi	Charleroi
Charles	Charles dari Wales
Charles Darwin	Charles Darwin
Charles Dickens	Charles Dickens
Charles Lindbergh	Charles Lindbergh
Charles Thomson Rees Wilson	C.T.R. Wilson
Charles de Gaulle	Charles de Gaulle
Charleston	Charleston, West Virginia
Charlie Chaplin	Charlie Chaplin
Charlie Parker	Charlie Parker
Charmed	Charmed
Charon (moon)	Charon (bulan)
Chartres	Chartres
Che Guevara	Che Guevara
Chechnya	Chechnya
Chechnya	Kategori:Chechnya
Cheese	Keju
Cheetah	Cheetah
Chelyabinsk	Chelyabinsk
Chemical bond	Ikatan kimia
Chemical compound	Senyawa kimia
Chemical element	Unsur kimia
Chemical engineering	Teknik kimia
Chemical formula	Rumus kimia
Chemical reaction	Reaksi kimia
Chemical warfare	Senjata kimia
Chemistry	Kimia
Chemistry	Kategori:Kimia
Chemistry	Portal:Kimia
Chemnitz	Chemnitz
Chemotherapy	Kemoterapi
Chennai	Chennai
Cheque	Cek
Chernobyl	Chernobyl
Cherry	Ceri
Chert	Rijang
Chess	Catur
Chess	Kategori:Catur
Chester A. Arthur	Chester A. Arthur
Cheyenne	Cheyenne, Wyoming
Chiang Kai-shek	Chiang Kai-shek
Chicago	Chicago
Chicken	Ayam
Chickenpox	Cacar air
Chickpea	Chickpea
Chihuahua	Chihuahua (negara bagian)
Child	Anak
Chile	Chili
Chile	Kategori:Chili
Chimera (mythology)	Chimaera
China	Kategori:Tiongkok
China	Cina
Chios	Chios
Chlorine	Klor
Chloroform	Kloroform
Chlorophyll	Klorofil
Chloroplast	Kloroplas
Chocolate	Cokelat
Choir	Paduan suara
Cholera	Kolera
Cholesterol	Kolesterol
Chongqing	Chongqing
Chord (music)	Akord
Chordate	Chordata
Christchurch	Christchurch
Christiaan Huygens	Christiaan Huygens
Christian Dior	Christian Dior
Christianity	Kekristenan
Christianity	Kategori:Kristen
Christmas	Natal
Christmas tree	Pohon Natal
Christopher Columbus	Christopher Columbus
Chromatography	Kromatografi
Chromium	Kromium
Chromosome	Kromosom
Chronology	Kategori:Kronologi
Church (building)	Gereja
Church of England	Gereja Inggris
Ciconiiformes	Ciconiiformes
Cigarette	Rokok
Cinderella	Cinderella
Cinnamon	Kayu manis
Circle	Lingkaran
Circulatory system	Sistem kardiovaskular
Circumcision	Sunat
Circus	Sirkus
Citizenship	Kewarganegaraan
Citric acid	Asam sitrat
City-state	Negara kota
Civil war	Perang Saudara
Civilization	Peradaban
Civilization (computer game)	Civilization
Clarinet	Klarinet
Clark Gable	Clark Gable
Class (biology)	Kelas (biologi)
Classical mechanics	Mekanika klasik
Classical music	Kategori:Musik klasik
Claude Monet	Claude Monet
Clavicle	Tulang selangka
Clay	Tanah liat
Clement Attlee	Clement Attlee
Clergy	Rohaniwan
Cleveland	Cleveland, Ohio
Client-server	Klien-server
Climate	Iklim
Climatology	Klimatologi
Climatology	Kategori:Klimatologi
Clinical depression	Depresi
Clitoris	Klitoris
Cloning	Kloning
Clothing	Kategori:Pakaian
Clothing	Pakaian
Cloud	Awan
Clove	Cengkeh
Cnidaria	Cnidaria
Coat of arms	Lambang negara
Cobalt	Kobal
Cocaine	Kokain
Coccinellidae	Kepik
Cockatoo	Kakatua
Cockroach	Kecoa
Coconut	Kelapa
Cocos (Keeling) Islands	Kepulauan Cocos (Keeling)
Codeine	Kodein
Coffea	Coffea
Coffee	Kopi
Coffee	Kategori:Kopi
Cognac (drink)	Konyak
Cognitive psychology	Psikologi kognitif
Coin	Uang logam
Cola	Kola
Cold War	Perang Dingin
Cold War	Kategori:Perang Dingin
Colin Powell	Colin Powell
Collagen	Kolagen
Colloid	Sistem koloid
Cologne	Köln
Colombia	Kolombia
Colombia	Kategori:Kolombia
Colombo	Kolombo
Colonel	Kolonel
Color	Warna
Colorado	Colorado
Colorado	Kategori:Colorado
Colosseum	Colosseum
Colossus of Rhodes	Colossus Rodos
Colubrid	Colubridae
Columbia	Columbia, South Carolina
Columbia University	Universitas Columbia
Columbus	Columbus, Ohio
Coma	Koma (medis)
Coma Berenices	Coma Berenices
Combustion	Pembakaran
Comedy	Melawak
Comenius	John Amos Comenius
Comet	Komet
Commerce	Kategori:Perdagangan
Common Fig	Tin
Commonwealth of Independent States	Persemakmuran Negara-negara Merdeka
Commonwealth of Nations	Negara-Negara Persemakmuran
Communication	Kategori:Komunikasi
Communication	Komunikasi
Communism	Komunisme
Communism	Kategori:Komunisme
Comoros	Komoro
Comoros	Kategori:Komoro
Compact Disc	Cakram padat
Company (military unit)	Kompi
Compass	Kompas
Compass (drafting)	Jangka
Competition	Kompetisi
Compiler	Kompilator
Complex instruction set computer	CISC
Composer	Komponis
Composite material	Material komposit
Composite number	Bilangan komposit
Computed tomography	Tomografi terkomputasi
Computer	Komputer
Computer architecture	Arsitektur komputer
Computer display	Tampilan komputer
Computer file	Berkas komputer
Computer graphics	Kategori:Komputer grafis
Computer hardware	Perangkat keras
Computer hardware	Kategori:Perangkat keras
Computer program	Program komputer
Computer programming	Pemrograman komputer
Computer programming	Kategori:Pemrograman komputer
Computer science	Ilmu komputer
Computer science	Kategori:Ilmu komputer
Computer software	Perangkat lunak
Computer virus	Virus komputer
Computer-aided design	CAD
Computing	Kategori:Komputer
Conakry	Conakry
Concord	Concord, New Hampshire
Concrete	Beton
Condom	Kondom
Conducting	Dirigen
Cone (geometry)	Kerucut
Confederation	Konfederasi
Confession	Pengakuan dosa
Confirmation	Penguatan
Conflict	Konflik
Confucianism	Agama Khonghucu
Confucius	Kong Hu Cu (filsuf)
Congo	Kongo
Congo River	Sungai Kongo
Conic section	Irisan kerucut
Connecticut	Connecticut
Connecticut	Kategori:Connecticut
Conquistador	Conquistador
Conservation of energy	Kekekalan energi
Conservatism	Konservatisme
Consonant	Konsonan
Constantine I	Konstantinus I
Constantinople	Konstantinopel
Constellation	Rasi bintang
Constitution (political)	Konstitusi
Contact lens	Lensa Kontak
Continent	Benua
Continental drift	Teori Continental Drift
Contract	Kontrak
Contract bridge	Bridge
Cooking	Memasak
Cooperative	Koperasi
Coordinated Universal Time	UTC
Copenhagen	Kopenhagen
Copper	Tembaga
Copyright	Hak cipta
Coriander	Ketumbar
Corinth	Korintus
Cork (city)	Cork
Cornea	Kornea
Cornell University	Universitas Cornell
Cornwall	Cornwall
Corporation	Perusahaan
Corrosion	Korosi
Corsica	Korsika
Corundum	Korundum
Corvette	Korvet
Corvus (constellation)	Corvus
Cosmic ray	Sinar kosmik
Cosmology	Kosmologi
Cosmology	Kategori:Kosmologi
Costa Rica	Kosta Rika
Costa Rica	Kategori:Kosta Rika
Cotonou	Cotonou
Cotopaxi	Gunung Cotopaxi
Cotton	Kapas
Coulomb	Coulomb
Council of Chalcedon	Konsili Khalsedon
Council of Ephesus	Konsili Efesus
Council of Trent	Konsili Trento
Court	Pengadilan
Covalent bond	Ikatan kovalen
Coventry	Coventry
Coyote	Koyote
Crab	Kepiting
Crane (bird)	Burung Jenjang
Creationism	Ciptaanisme
Cremona	Cremona
Cretaceous	Kapur (periode)
Crete	Kreta
Cricket	Kriket
Cricket (insect)	Jangkrik
Crime	Kriminalitas
Crimea	Republik Otonomi Krimea
Crimean War	Perang Krimea
Criminology	Kategori:Kriminologi
Croatia	Kroasia
Croatia	Kategori:Kroasia
Crocodile	Buaya
Crossword	Teka-teki silang
Crow	Gagak
Crucifixion	Penyaliban
Crust (geology)	Kerak bumi
Crustacean	Crustacea
Crux	Crux
Cryptography	Kriptografi
Cryptography	Kategori:Kriptografi
Crystal	Kristal
Cuba	Kuba
Cuba	Kategori:Kuba
Cube	Kubus
Cucumber	Mentimun
Cultural Revolution	Revolusi Kebudayaan
Culture	Budaya
Culture	Kategori:Budaya
Cumbria	Cumbria
Cumulus cloud	Awan Kumulus
Curitiba	Curitiba
Currency	Mata uang
Curry	Kari
Curve	Kurva
Cusco	Cusco
Cyan	Sian
Cyanide	Sianida
Cyanobacteria	Cyanobacteria
Cyberpunk	Cyberpunk
Cyclades	Cyclades
Cycling	Bersepeda
Cyclone	Siklon
Cygnus (constellation)	Cygnus
Cylinder (geometry)	Tabung (geometri)
Cyprus	Siprus
Cyprus	Kategori:Siprus
Cyrillic alphabet	Aksara Sirilik
Cyrus the Great	Koresh Agung
Cytoplasm	Sitoplasma
Cytosine	Sitosin
Cytoskeleton	Sitoskeleton
Czech Republic	Ceko
Czech Republic	Kategori:Ceko
Czechoslovakia	Cekoslowakia
Czechoslovakia	Kategori:Cekoslowakia
DNA	Asam deoksiribonukleat
DOS	DOS
DVD	DVD
Dachshund	Dachshund
Dada	Dadaisme
Dagger	Belati
Dahlia	Dahlia
Dakar	Dakar
Dalai Lama	Dalai Lama
Dallas	Dallas
Dalmatia	Dalmatia
Dam	Bendungan
Damascus	Damaskus
Dance	Tari
Dandelion	Randa Tapak
Daniel Defoe	Daniel Defoe
Daniel Ortega	Daniel Ortega
Danish krone	Krona Denmark
Dante Alighieri	Dante Alighieri
Danube	Donau
Dar es Salaam	Dar es Salaam
Darfur	Darfur
Darjeeling	Darjeeling
Dark matter	Materi gelap
Darwin	Darwin, Teritorial Utara
Darwin	Darwin (disambiguasi)
Das Kapital	Das Kapital
Data	Data
Data mining	Penggalian data
Data structure	Struktur data
Database	Basis data
Database management system	Sistem manajemen basis data
Daugavpils	Daugavpils
David	Daud
David Hilbert	David Hilbert
David Hume	David Hume
Day	Hari
De facto	De facto
Deacon	Diakon
Dead Sea	Laut Mati
Dead Sea scrolls	Naskah Laut Mati
Death	Kematian
Death	Kategori:Kematian
Decade	Dasawarsa
December	Desember
December 31	31 Desember
December 8	8 Desember
Decimal	Sistem bilangan desimal
Declination	Deklinasi
Deco	Deco
Deconstruction	Dekonstruksi
Deductive reasoning	Deduksi
Deer	Rusa
Definition	Definisi
Deflation	Deflasi
Degree	Derajat
Degree (angle)	Derajat (satuan sudut)
Delaware	Delaware
Delaware	Kategori:Delaware
Delft	Delft
Dell	Dell
Delta (letter)	Delta (huruf Yunani)
Deluge (mythology)	Air bah (mitologi)
Demeter	Demeter
Democracy	Demokrasi
Democratic Party (United States)	Partai Demokrat (Amerika Serikat)
Democratic Republic of the Congo	Republik Demokratik Kongo
Democratic Republic of the Congo	Kategori:Republik Demokratik Kongo
Democritus	Demokreitos
Demography	Kependudukan
Demography	Kategori:Kependudukan
Demon	Jurik
Deng Xiaoping	Deng Xiaoping
Dengue fever	Demam berdarah
Denis Diderot	Denis Diderot
Denmark	Denmark
Denmark	Kategori:Denmark
Dennis Gabor	Dennis Gabor
Density	Massa jenis
Dental caries	Karies gigi
Dentistry	Kategori:Kedokteran gigi
Dentistry	Kedokteran gigi
Denver	Denver, Colorado
Derivative	Turunan
Dermatology	Dermatologi
Des Moines	Des Moines, Iowa
Desert	Gurun
Deserts	Kategori:Gurun
Desiderius Erasmus	Desiderius Erasmus
Design	Desain
Design	Kategori:Desain
Desmond Tutu	Desmond Tutu
Destroyer	Kapal perusak
Detroit	Detroit
Deuterium	Deuterium
Deuteronomy	Kitab Ulangan
Developmental psychology	Psikologi perkembangan
Device driver	Device driver
Devon	Devon
Devonian	Devon (periode)
Dew	Embun
Dewey Decimal Classification	Klasifikasi Desimal Dewey
Dhaka	Dhaka
Dharma	Dharma
Dhole	Ajag
Diabetes mellitus	Diabetes mellitus
Dialect	Dialek
Diameter	Diameter
Diamond	Intan
Diana	Diana Spencer
Diarrhea	Diare
Diaspora	Diaspora
Diatom	Diatom
Dice	Dadu (permainan)
Dictatorship	Diktatur
Dictionary	Kamus
Diesel	Diesel
Diesel engine	Mesin diesel
Dietrich Bonhoeffer	Dietrich Bonhoeffer
Diffraction	Difraksi
Diffusion	Difusi
Digestion	Pencernaan
Digestive system	Kategori:Sistem pencernaan
Digital	Digital
Digital camera	Kamera digital
Digital photography	Fotografi digital
Digital subscriber line	DSL
Dijon	Dijon
Dimension	Dimensi
Dingo	Dingo
Dinosaur	Dinosaurus
Diocese	Keuskupan
Diocletian	Diocletianus
Diode	Dioda
Dionysus	Dionysus
Diphtheria	Difteri
Diphthong	Diftong
Diplomacy	Diplomasi
Diplomacy	Kategori:Diplomasi
Direct current	Arus searah
Disambiguation	Kategori:Disambiguasi
Disc jockey	DJ
Discrimination	Diskriminasi
Disease	Penyakit
Distance	Jarak
Distillation	Distilasi
Division (military)	Divisi
Divorce	Perceraian
Dizzy Gillespie	Dizzy Gillespie
Djibouti	Kategori:Djibouti
Dmitri Mendeleev	Dmitri Mendeleev
Dmitri Shostakovich	Dmitri Shostakovich
Dnipropetrovsk	Dnipropetrovsk
Doctor of the Church	Doktor Gereja
Document	Dokumen
Dodecanese	Dodecanese
Dodo	Dodo
Dodoma	Dodoma
Dog	Anjing
Dogma	Dogma
Doha	Doha
Dollar	Dolar
Dolly (sheep)	Domba Dolly
Dolomite	Dolomit
Dolphin	Lumba-lumba
Domain name	Nama domain
Dome	Kubah
Domestication	Domestikasi
Dominica	Dominika
Dominica	Kategori:Dominika
Dominican Order	Ordo Dominikan
Dominican Republic	Republik Dominika
Dominican Republic	Kategori:Republik Dominika
Donald Duck	Donal Bebek
Donatello	Donatello
Donato Bramante	Donato Bramante
Donetsk	Donetsk
Donkey	Keledai
Door	Pintu
Doppler effect	Efek Doppler
Doris Lessing	Doris Lessing
Dortmund	Dortmund
Douala	Douala
Douglas MacArthur	Douglas MacArthur
Dover	Dover, Delaware
Dover	Dover, Kent
Down syndrome	Sindrom Down
Dragon	Naga
Drainage basin	Batas air
Drama	Drama
Dream	Mimpi
Dresden	Dresden
Drink	Minuman
Drug addiction	Kecanduan
Drum	Drum
Dualism (philosophy of mind)	Dualisme
Dubai	Dubai
Dublin	Dublin
Duck	Bebek
Duke Ellington	Duke Ellington
Duke University	Universitas Duke
Dunkirk	Dunkerque
Duodenum	Usus dua belas jari
Durban	Durban
Dushanbe	Dushanbe
Dustin Hoffman	Dustin Hoffman
Dutch people	Kategori:Tokoh Belanda
Dwight D. Eisenhower	Dwight D. Eisenhower
Dynamite	Dinamit
Dysprosium	Disprosium
Dystopia	Distopia
E (mathematical constant)	E (konstanta matematika)
E-mail	Surat elektronik
Eagle	Elang
Ear	Telinga
Earth	Bumi
Earth	Kategori:Bumi
Earth science	Ilmu bumi
Earthquake	Gempa bumi
East	Timur
East Africa	Afrika Timur
East China Sea	Laut China Timur
East Germany	Jerman Timur
East Sussex	East Sussex
East Timor	Timor Timur
East Timor	Kategori:Timor Timur
Easter	Paskah
Eastern Orthodox Church	Gereja Ortodoks
Ebro	Ebro
Ecclesiastes	Kitab Pengkhotbah
Echidna	Ekidna
Echinoderm	Echinodermata
Eclipse	Gerhana
Eclipse (software)	Eclipse (perangkat lunak)
Ecliptic	Ekliptika
Ecology	Ekologi
Ecology	Kategori:Ekologi
Econometrics	Ekonometrika
Economics	Ilmu ekonomi
Economics	Kategori:Ekonomi
Economy	Ekonomi
Ecosystem	Ekosistem
Ecuador	Ekuador
Ecuador	Kategori:Ekuador
Ecumenical council	Konsili Ekumenis
Edgar Allan Poe	Edgar Allan Poe
Edgar Degas	Edgar Degas
Edinburgh	Edinburgh
Edirne	Edirne
Edmonton	Edmonton, Alberta
Edmund Hillary	Edmund Hillary
Edmund Husserl	Edmund Husserl
Eduard Buchner	Eduard Buchner
Education	Pendidikan
Education	Kategori:Pendidikan
Edvard Munch	Edvard Munch
Edward Jenner	Edward Jenner
Edward Teller	Edward Teller
Eel	Sidat
Egg (biology)	Telur
Eggplant	Terong
Egypt	Mesir
Egypt	Kategori:Mesir
Egyptian pound	Pound Mesir
Eiffel Tower	Menara Eiffel
Eindhoven	Eindhoven
Einsteinium	Einsteinium
Ejaculation	Ejakulasi
El Cid	El Cid
El Greco	El Greco
El Salvador	El Salvador
El Salvador	Kategori:El Salvador
Elbe	Elbe
Eleanor Roosevelt	Eleanor Roosevelt
Electric charge	Muatan listrik
Electric current	Arus listrik
Electric field	Medan listrik
Electric guitar	Gitar listrik
Electric motor	Motor listrik
Electrical engineering	Kategori:Teknik elektro
Electrical resistance	Hambatan listrik
Electricity	Listrik
Electricity	Kategori:Listrik
Electrocardiogram	Elektrokardiogram
Electrochemistry	Elektrokimia
Electrolysis	Elektrolisis
Electrolyte	Elektrolit
Electromagnetic radiation	Radiasi elektromagnetik
Electromagnetic spectrum	Spektrum elektromagnetik
Electromagnetism	Elektromagnetisme
Electromagnetism	Kategori:Elektromagnetisme
Electron	Elektron
Electron microscope	Mikroskop elektron
Electronegativity	Elektronegativitas
Electronics	Elektronika
Electronics	Kategori:Elektronika
Elementary particle	Partikel dasar
Elephant	Gajah
Elevator	Lift
Elf	Peri
Elia Kazan	Elia Kazan
Elias Canetti	Elias Canetti
Elizabeth Taylor	Elizabeth Taylor
Ellipse	Elips
Ellipsis	Elipsis
Elvis Presley	Elvis Presley
Embryo	Embrio
Emerald	Zamrud
Emilia-Romagna	Emilia-Romagna
Emiliano Zapata	Emiliano Zapata
Emily Dickinson	Emily Dickinson
Emir	Emir
Emma Goldman	Emma Goldman
Emotion	Kategori:Emosi
Empathy	Empati
Empedocles	Empedokles
Emperor	Kaisar
Empire State Building	Gedung Empire State
Empiricism	Empirisme
Emu	Emu
Emulator	Emulator
Emulsion	Emulsi
Encyclopedia	Ensiklopedia
Endemism	Endemik
Endocrine system	Sistem endokrin
Endocrinology	Kategori:Endokrinologi
Energy	Energi
Energy	Kategori:Energi
Energy (society)	Energi
Engineer	Insinyur
Engineering	Teknik
Engineering	Kategori:Teknik
England	Inggris
England	Kategori:Inggris
English Channel	Selat Inggris
English Civil War	Perang Saudara Inggris
English language	Bahasa Inggris
English people	Kategori:Tokoh Inggris
English people	Bangsa Inggris
Enrico Fermi	Enrico Fermi
Entertainment	Kategori:Hiburan
Enthalpy	Entalpi
Entomology	Entomologi
Enzyme	Enzim
Eocene	Eosen
Eon (geology)	Eon
Eos	Eos
Ephesus	Efesus
Epic poetry	Wiracarita
Epicenter	Episenter
Epidemic	Wabah
Epidemiology	Epidemiologi
Epilepsy	Epilepsi
Epiphany (Christian)	Epifani
Epirus (periphery)	Epirus
Epistemology	Epistemologi
Epistle to the Galatians	Surat Paulus kepada Jemaat di Galatia
Epistle to the Romans	Surat Paulus kepada Jemaat di Roma
Epithelium	Jaringan epitel
Epsilon	Epsilon
Equation	Persamaan
Equator	Khatulistiwa
Equatorial Guinea	Guinea Khatulistiwa
Equatorial Guinea	Kategori:Guinea Khatulistiwa
Equidae	Equidae
Equisetum	Paku ekor kuda
Erasure	Erasure
Eratosthenes	Eratosthenes
Erbium	Erbium
Erebus	Erebus
Erectile dysfunction	Disfungsi ereksi
Erection	Ereksi
Erik Axel Karlfeldt	Erik Axel Karlfeldt
Eris (dwarf planet)	Eris (planet katai)
Eritrea	Kategori:Eritrea
Ernest Hemingway	Ernest Hemingway
Ernest Rutherford	Ernest Rutherford
Erosion	Erosi
Erotica	Erotisme
Erwin Rommel	Erwin Rommel
Eschatology	Eskatologi
Escherichia coli	Escherichia coli
Esfahan	Kota Isfahan
Esophagus	Esofagus
Esperanto	Bahasa Esperanto
Espionage	Spionase
Espoo	Espoo
Espresso	Espresso
Essen	Essen, Nordrhein-Westfalen
Essential oil	Minyak atsiri
Essex	Essex
Ester	Ester
Estonia	Kategori:Estonia
Estrogen	Estrogen
Eta (letter)	Eta (huruf Yunani)
Etching	Etsa
Ethane	Etana
Ethanol	Etanol
Ethernet	Ethernet
Ethics	Etika
Ethics	Kategori:Etika
Ethiopia	Ethiopia
Ethiopia	Kategori:Ethiopia
Ethnic group	Suku bangsa
Ethology	Etologi
Ethylene	Etena
Etymology	Etimologi
Eucalyptus	Eukaliptus
Eucharist	Perjamuan Kudus
Euclid	Euklides
Eugene O'Neill	Eugene O'Neill
Eukaryote	Eukariota
Eunuch	Orang kasim
Euphemism	Eufemisme
Eurasia	Eurasia
Euro	Euro
Europa (moon)	Europa
Europe	Eropa
Europe	Kategori:Eropa
European Central Bank	Bank Sentral Eropa
European Community	Komunitas Eropa
European Union	Uni Eropa
European Union	Kategori:Uni Eropa
Europium	Europium
Eusebius of Caesarea	Eusebius dari Kaisaria
Euthanasia	Eutanasia
Eva Braun	Eva Braun
Evanescence	Evanescence
Evangelista Torricelli	Evangelista Torricelli
Evaporation	Penguapan
Even-toed ungulate	Hewan berkuku genap
Evolution	Evolusi
Excalibur	Excalibur
Excommunication	Ekskomunikasi
Executive (government)	Eksekutif
Existentialism	Eksistensialisme
Exodus	Kitab Keluaran
Explosion	Ledakan
Exponential function	Fungsi eksponensial
Exponentiation	Eksponen
Expressionism	Ekspresionisme
Extinction	Kepunahan
Eye	Mata
Eye	Kategori:Mata
Fabaceae	Fabaceae
Face	Wajah
Factorial	Faktorial
Factory	Pabrik
Fado	Fado
Fahrenheit	Fahrenheit
Fair use	Penggunaan wajar
Fairy	Peri
Falconiformes	Falconiformes
Falkland Islands	Kepulauan Falkland
Fallacy	Kesesatan
Fallopian tube	Tuba fallopi
Falun Gong	Falun Gong
Family	Kategori:Keluarga
Family (biology)	Familia
Family name	Marga
Far East	Timur Jauh
Faroe Islands	Kategori:Kepulauan Faroe
Fascism	Fasisme
Fascism	Kategori:Fasisme
Fashion	Kategori:Mode
Fashion	Mode
Fast food	Rumah makan siap saji
Fasting	Puasa
Fatah	Fatah
Fatty acid	Asam lemak
Fault (geology)	Sesar
Fauna	Fauna
Fauvism	Fauvisme
Feather	Bulu
February	Februari
February 12	12 Februari
February 14	14 Februari
February 2	2 Februari
February 22	22 Februari
February 29	29 Februari
February Revolution	Revolusi Februari
Feces	Tinja
Federal Bureau of Investigation	FBI
Federated States of Micronesia	Federasi Mikronesia
Federated States of Micronesia	Kategori:Federasi Mikronesia
Federation	Federasi
Federico Fellini	Federico Fellini
Fedora (Linux distribution)	Fedora Core
Feedback	Loloh balik
Felidae	Felidae
Felix Mendelssohn	Felix Mendelssohn
Feminism	Feminisme
Feminism	Kategori:Feminisme
Fencing	Anggar
Feng shui	Feng Shui
Fennel	Adas
Ferdinand Magellan	Fernando de Magelhaens
Fermentation (biochemistry)	Fermentasi
Fermentation (food)	Fermentasi
Fermion	Fermion
Fern	Tumbuhan paku
Ferry	Kapal feri
Fertilisation	Pembuahan
Fertilizer	Pupuk
Fetus	Janin
Fever	Demam
Fiat	Fiat
Fibonacci number	Bilangan Fibonacci
Fiction	Kategori:Fiksi
Fictional character	Tokoh fiktif
Fidel Castro	Fidel Castro
Field hockey	Hoki lapangan
Fighter aircraft	Pesawat tempur
Fiji	Fiji
Fiji	Kategori:Fiji
File Allocation Table	FAT
File Transfer Protocol	FTP
File system	Sistem berkas
Film	Kategori:Film
Film	Film
Film	Portal:Film
Film director	Sutradara
Fin Whale	Paus Sirip
Finance	Kategori:Keuangan
Finance	Keuangan
Finger	Jari
Fingerprint	Sidik jari
Finland	Finlandia
Finland	Kategori:Finlandia
Fire	Api
Firearm	Senjata api
Firefighter	Pemadam kebakaran
Firewall (networking)	Firewall
Firmware	Firmware
First Council of Nicaea	Konsili Nicea I
First Crusade	Perang Salib Pertama
First Epistle to the Corinthians	Surat Paulus yang Pertama kepada Jemaat di Korintus
First aid	Pertolongan Pertama Pada Kecelakaan
First language	Bahasa ibu
Fish	Ikan
Fish	Kategori:Ikan
Fishing	Memancing
Fishing	Kategori:Memancing
Fjord	Fyord
Flag	Bendera
Flagellum	Flagel
Flash memory	Memori flash
Flatulence	Kentut
Flea	Kutu
Flint	Rijang
Flip-flop (electronics)	Flip-flop
Flood	Banjir
Floppy disk	Disket
Florence	Firenze
Florence Nightingale	Florence Nightingale
Florida	Florida
Florida	Kategori:Florida
Flour	Tepung
Flower	Bunga
Flowering plant	Tumbuhan berbunga
Fluid	Fluida
Fluid mechanics	Mekanika fluida
Flute	Suling
Fog	Kabut
Folic acid	Asam folik
Folk music	Lagu daerah
Folklore	Kategori:Cerita rakyat
Food	Makanan
Food additive	Aditif makanan
Food and Agriculture Organization	Organisasi Pangan dan Pertanian
Food chain	Rantai makanan
Foot (unit of length)	Kaki (satuan panjang)
Football (soccer)	Sepak bola
Football (soccer)	Kategori:Sepak bola
Football (soccer) by country	Kategori:Sepak bola menurut negara
Football (soccer) clubs	Kategori:Tim sepak bola
Football (soccer) managers	Kategori:Pelatih sepak bola
Football (soccer) players	Kategori:Pemain sepak bola
Football (soccer) venues	Kategori:Stadion sepak bola
Forbidden City	Kota Terlarang
Force	Gaya
Forest	Hutan
Forestry	Kehutanan
Fork	Garpu
Form of government	Bentuk pemerintahan
Formaldehyde	Formaldehida
Formic acid	Asam format
Fort Worth	Fort Worth, Texas
Fortification	Benteng
Fortran	Fortran
Fossil	Fosil
Fossil fuel	Bahan bakar fosil
Fountain	Air mancur
Fox	Rubah
Fractal	Fraktal
Fraction (mathematics)	Pecahan
France	Perancis
France	Kategori:Perancis
Francis Bacon	Francis Bacon
Francis Crick	Francis Crick
Francis Drake	Francis Drake
Francis Ford Coppola	Francis Ford Coppola
Francis of Assisi	Fransiskus dari Assisi
Franciscan	Fransiskan
Francisco Franco	Francisco Franco
Francisco Goya	Francisco Goya
Francisco Pizarro	Francisco Pizarro
Francium	Fransium
Franco-Prussian War	Perang Perancis-Prusia
Frank Lloyd Wright	Frank Lloyd Wright
Frank Sinatra	Frank Sinatra
Frankfort	Frankfort, Kentucky
Frankfurt	Frankfurt am Main
Frankfurt	Kategori:Frankfurt
Frankfurt (Oder)	Frankfurt an der Oder
Franklin Pierce	Franklin Pierce
Franz Kafka	Franz Kafka
Franz Schubert	Franz Schubert
Fred Astaire	Fred Astaire
Frederick I	Friedrich I, Kaisar Romawi Suci
Frederick II	Frederick II, Kaisar Romawi Suci
Frederick Sanger	Frederick Sanger
Frederick Soddy	Frederick Soddy
Fredericton	Fredericton
Free State	Free State
Freemasonry	Freemasonry
Freetown	Freetown
Freeware	Freeware
French Polynesia	Polinesia Perancis
French Polynesia	Kategori:Polinesia Perancis
French Revolution	Revolusi Perancis
French Revolution	Kategori:Revolusi Perancis
French people	Kategori:Tokoh Perancis
Frequency	Frekuensi
Fresco	Fresko
Freshwater	Air tawar
Fresno	Fresno
Freyja	Freyja
Friction	Gaya gesek
Friday	Jumat
Fridtjof Nansen	Fridtjof Wedel-Jarlsberg Nansen
Friedrich Engels	Friedrich Engels
Friesland	Friesland
Frigate	Fregat
Frigg	Frigg
Fritz Haber	Fritz Haber
Friuli-Venezia Giulia	Friuli-Venezia Giulia
Frog	Kodok dan katak
Fructose	Fruktosa
Fruit	Buah
Fruit	Kategori:Buah-buahan
Fucking	Fucking, Austria
Fuel	Bahan bakar
Fuel cell	Sel bahan bakar
Fukuoka	Fukuoka, Fukuoka
Full moon	Bulan purnama
Function (mathematics)	Fungsi
Fundamental	Kategori:Utama
Fundamental interaction	Interaksi dasar
Fundamentalism	Fundamentalisme
Fungi	Kategori:Fungi
Fungus	Fungi
Funk	Funk
Furniture	Kategori:Mebel
Fuzzy logic	Logika Fuzzy
Fyodor Dostoevsky	Fyodor Dostoyevsky
GNOME	GNOME
GNU	GNU
Gabon	Gabon
Gabon	Kategori:Gabon
Gaborone	Gaborone
Gabriel	Jibril
Gabriel Lippmann	Gabriel Lippmann
Gadolinium	Gadolinium
Gaia (mythology)	Gaia
Galatia	Galatia
Galaxy	Galaksi
Galen	Galenus
Galicia (Central Europe)	Galisia (Eropa Tengah)
Galicia (Spain)	Galicia (Spanyol)
Galilee	Galilea
Galileo (spacecraft)	Galileo (wahana antariksa)
Galileo Galilei	Galileo Galilei
Gallbladder	Kantung empedu
Galliformes	Galliformes
Gallium	Galium
Galway	Galway
Gamal Abdel Nasser	Gamal Abdul Nasir
Game	Permainan
Game theory	Teori permainan
Gamma	Gamma (huruf Yunani)
Gamma ray	Sinar gamma
Ganesha	Ganesa
Ganges	Sungai Gangga
Ganja	Ganja (kota)
Gansu	Gansu
Gap	Gap, Hautes-Alpes
Garden	Taman
Garden of Eden	Taman Eden
Garfield	Garfield
Garlic	Bawang putih
Gas	Gas
Gas giant	Raksasa gas
Gasoline	Petrol
Gastrointestinal tract	Saluran pencernaan
Gaul	Galia
Gautama Buddha	Siddhartha Gautama
Gaza	Gaza
Gaza Strip	Jalur Gaza
Geisha	Geisha
Gemini (constellation)	Gemini
Gemstone	Batu permata
Gene	Gen
General Agreement on Tariffs and Trade	GATT
General Officer	Jenderal
General relativity	Relativitas umum
Genesis	Kitab Kejadian
Genetic engineering	Rekayasa genetika
Genetics	Genetika
Geneva	Jenewa
Genie	Jin
Genoa	Genova
Genocide	Genosida
Genocide	Kategori:Genosida
Genome	Genom
Genus	Genus
Geochemistry	Geokimia
Geoffrey Chaucer	Geoffrey Chaucer
Geography	Geografi
Geography	Kategori:Geografi
Geography	Portal:Geografi
Geology	Kategori:Geologi
Geology	Geologi
Geometric progression	Deret ukur
Geometry	Geometri
Geometry	Kategori:Geometri
Geomorphology	Geomorfologi
Geomorphology	Kategori:Geomorfologi
Geophysics	Geofisika
Geophysics	Kategori:Geofisika
Georg Philipp Telemann	Georg Philipp Telemann
Georg Wilhelm Friedrich Hegel	Georg Wilhelm Friedrich Hegel
George Bernard Shaw	George Bernard Shaw
George Frideric Handel	Georg Friedrich Händel
George Gershwin	George Gershwin
George Harrison	George Harrison
George Lucas	George Lucas
George Marshall	George C. Marshall
George Orwell	George Orwell
George Stephenson	George Stephenson
George W. Bush	George W. Bush
George Washington	George Washington
Georges Clemenceau	Georges Clemenceau
Georgetown	Georgetown, Guyana
Georgia (U.S. state)	Georgia, Amerika Serikat
Georgia (U.S. state)	Kategori:Georgia, Amerika Serikat
Georgia (country)	Georgia
Georgia (country)	Kategori:Georgia
Gerald Ford	Gerald Ford
Gerard Kuiper	Gerard Kuiper
German language	Bahasa Jerman
German language	Kategori:Bahasa Jerman
German mark	Deutsche Mark
Germanium	Germanium
Germany	Jerman
Germany	Kategori:Jerman
Geronimo	Geronimo
Gestapo	Gestapo
Geyser	Geyser
Ghana	Ghana
Ghana	Kategori:Ghana
Ghent	Gent
Ghost	Hantu
Giacomo Puccini	Giacomo Puccini
Giant Panda	Panda
Gibraltar	Gibraltar
Gibraltar	Kategori:Gibraltar
Gigabyte	Gigabita
Gilgamesh	Gilgames
Ginger	Jahe
Ginkgo	Ginkgo
Giordano Bruno	Giordano Bruno
Giorgio Vasari	Giorgio Vasari
Giotto di Bondone	Giotto di Bondone
Giraffe	Jerapah
Giraffidae	Giraffidae
Gironde	Gironde
Giuseppe Garibaldi	Giuseppe Garibaldi
Giuseppe Verdi	Giuseppe Verdi
Giza	Giza
Glacier	Gletser
Gladiator	Gladiator
Gland	Kelenjar
Glasgow	Glasgow
Glass	Kaca
Glasses	Kacamata
Glider	Glider
Global Positioning System	Global Positioning System
Global warming	Pemanasan global
Globalization	Globalisasi
Gloucestershire	Gloucestershire
Glucagon	Glukagon
Glucose	Glukosa
Glutamic acid	Asam glutamat
Glycine	Glisin
Glycogen	Glikogen
Glycolysis	Glikolisis
Go (board game)	Igo
Goa	Goa, India
Goalkeeper	Penjaga gawang
Goat	Kambing
Gobi Desert	Gurun Gobi
God	Tuhan
Golan Heights	Dataran Tinggi Golan
Gold	Emas
Golda Meir	Golda Meir
Golden Eagle	Elang emas
Golden Gate Bridge	Jembatan Golden Gate
Golf	Golf
Golf	Kategori:Golf
Golgi apparatus	Badan Golgi
Gomel	Homyel
Good Friday	Jumat Agung
Google	Google
Google	Kategori:Google
Googol	Googol
Gorilla	Gorila
Gospel	Injil
Gospel of Luke	Injil Lukas
Gothenburg	Göteborg
Gothic	Gothik
Gothic architecture	Arsitektur Gothik
Gottlieb Daimler	Gottlieb Daimler
Gout	Pirai
Government	Pemerintah
Grace Kelly	Grace Kelly
Gradient	Gradien
Graffiti	Grafiti
Grammar	Tata bahasa
Grammar	Kategori:Tata bahasa
Granada	Granada
Grand Canyon	Grand Canyon
Grand Slam (tennis)	Grand Slam
Grandmaster (chess)	Grandmaster
Granite	Granit
Grape	Anggur
Graphic design	Kategori:Desain grafis
Graphic design	Desain grafis
Graphical user interface	Antarmuka pengguna grafis
Graphite	Grafit
Gravitation	Gravitasi
Gray Wolf	Serigala abu-abu
Graz	Graz
Great Barrier Reef	Karang Penghalang Besar
Great Britain	Pulau Britania Raya
Great Depression	Depresi Besar
Great Lakes	Danau-Danau Besar
Great Rift Valley	Great Rift Valley
Great Wall of China	Tembok Raksasa Cina
Greater Antilles	Antilles Besar
Greater London	Greater London
Greatest common divisor	Faktor persekutuan terbesar
Greece	Yunani
Greece	Kategori:Yunani
Greek alphabet	Huruf Yunani
Greek fire	Api Yunani
Greek mythology	Mitologi Yunani
Greek mythology	Kategori:Mitologi Yunani
Green	Hijau
Greenhouse	Rumah kaca
Greenhouse effect	Efek rumah kaca
Greenhouse gas	Gas rumah kaca
Greenland	Greenland
Greenland	Kategori:Greenland
Greenland Sea	Laut Greenland
Greenpeace	Greenpeace
Greenwich	Greenwich
Greenwich Mean Time	GMT
Gregor Mendel	Gregor Mendel
Gregorian calendar	Kalender Gregorian
Grenada	Kategori:Grenada
Grenoble	Grenoble
Grey	Abu-abu
Griffin	Griffin
Gross domestic product	Produk domestik bruto
Group (mathematics)	Grup (matematika)
Group (periodic table)	Golongan tabel periodik
Grover Cleveland	Grover Cleveland
Grozny	Grozny
Guadalajara	Guadalajara
Guadeloupe	Guadeloupe
Guam	Guam
Guangdong	Guangdong
Guangzhou	Guangzhou
Guanine	Guanin
Guatemala	Kategori:Guatemala
Guatemala City	Kota Guatemala
Guayaquil	Guayaquil
Guernsey	Guernsey
Guglielmo Marconi	Guglielmo Marconi
Guillotine	Guillotine
Guinea	Guinea
Guinea	Kategori:Guinea
Guinea pig	Marmut
Guinea-Bissau	Guinea-Bissau
Guinea-Bissau	Kategori:Guinea-Bissau
Guitar	Gitar
Gujarat	Gujarat
Gulag	Gulag
Gulf War	Perang Teluk I
Gulf of Aden	Teluk Aden
Gulf of Aqaba	Teluk Aqaba
Gulf of Bothnia	Teluk Bothnia
Gulf of Finland	Teluk Finlandia
Gulf of Mexico	Teluk Meksiko
Gulf of Oman	Teluk Oman
Gulf of Thailand	Teluk Thailand
Gunpowder	Bubuk mesiu
Gunpowder Plot	Plot Bubuk Mesiu
Guppy	Guppy
Gustav Klimt	Gustav Klimt
Gustav Ludwig Hertz	Gustav Hertz
Gustav Mahler	Gustav Mahler
Guyana	Kategori:Guyana
Gymnosperm	Tumbuhan berbiji terbuka
Gynaecology	Ginekologi
HIV	HIV
HTML	Hypertext markup language
Habitat	Habitat
Hacker	Peretas
Hadean	Hadean
Hades	Hades
Hadith	Hadits
Hadrian	Hadrian
Haemophilia	Hemofilia
Hafnium	Hafnium
Hagia Sophia	Hagia Sophia
Haifa	Haifa
Haiku	Haiku
Hail Mary	Salam Maria
Hair	Rambut
Haiti	Haiti
Haiti	Kategori:Haiti
Hajj	Haji
Halal	Halal
Half-life	Waktu paruh
Halle	Halle (Saale)
Halloween	Halloween
Hallucination	Halusinasi
Halogen	Halogen
Hamas	Hamas
Hamburg	Hamburg
Hamburger	Hamburger
Hamlet	Hamlet
Hammer and sickle	Palu arit
Hammurabi	Hammurabi
Hampshire	Hampshire
Hamster	Hamster
Han Dynasty	Dinasti Han
Hand	Tangan
Hand grenade	Granat tangan
Handgun	Pistol
Hanging	Hukuman gantung
Hanging Gardens of Babylon	Taman Gantung Babilonia
Hannah Arendt	Hannah Arendt
Hannibal	Hannibal
Hanoi	Hanoi
Hanover	Hannover
Hans Bethe	Hans Bethe
Hans Christian Andersen	Hans Christian Andersen
Hanukkah	Hari raya Pentahbisan
Hanuman	Hanoman
Harare	Harare
Harem	Harem
Harmonica	Harmonika
Harmony	Harmoni (musik)
Harold Pinter	Harold Pinter
Harp	Harpa
Harpy	Harpy
Harriet Beecher Stowe	Harriet Beecher Stowe
Harriet Tubman	Harriet Tubman
Harrisburg	Harrisburg, Pennsylvania
Harry Houdini	Harry Houdini
Hartford	Hartford, Connecticut
Hatred	Benci
Haute-Normandie	Haute-Normandie
Havana	Havana
Hawaii	Hawaii
Hawaii	Kategori:Hawaii
Head	Kepala
Head of state	Kepala negara
Health	Kesehatan
Health	Kategori:Kesehatan
Heart	Jantung
Heat	Panas
Heat engine	Mesin kalor
Heaven	Sorga
Heavy metal	Kategori:Heavy metal
Heavy metal music	Heavy metal
Heavy water	Air berat
Hebei	Hebei
Hectare	Hektare
Hector Berlioz	Hector Berlioz
Heinrich Hertz	Heinrich Rudolf Hertz
Heinrich Himmler	Heinrich Himmler
Helen	Helena (mitologi)
Helen Keller	Helen Keller
Helena	Helena, Montana
Helicopter	Helikopter
Helios	Helios
Helium	Helium
Hell	Neraka
Helmut Schmidt	Helmut Schmidt
Helsinki	Helsinki
Hematology	Hematologi
Hematology	Kategori:Hematologi
Hemoglobin	Hemoglobin
Hemorrhoid	Wasir
Henri Becquerel	Henri Becquerel
Henri Matisse	Henri Matisse
Henrik Ibsen	Henrik Ibsen
Henry (unit)	Henry (induktansi)
Henry Fonda	Henry Fonda
Henry Ford	Henry Ford
Henry Kissinger	Henry Alfred Kissinger
Henry Miller	Henry Miller
Hepatitis	Hepatitis
Hephaestus	Hefestus
Hera	Hera
Heracles	Herakles
Heraclitus	Herakleitos
Herat	Provinsi Herat
Herbert Hoover	Herbert Hoover
Herbert Spencer	Herbert Spencer
Hercules	Hercules (tokoh)
Hercules (constellation)	Hercules (rasi bintang)
Heresy	Ajaran sesat
Herman Melville	Herman Melville
Hermann Hesse	Hermann Hesse
Hermann Minkowski	Hermann Minkowski
Hermeneutics	Hermeneutika
Hermes	Hermes
Hero	Pahlawan
Herod the Great	Herodes Agung
Herodotus	Herodotus
Heroin	Heroin
Heron	Kuntul
Hertfordshire	Hertfordshire
Hertz	Hertz
Hesse	Hessen
Hesse	Kategori:Hessen
Heterosexuality	Heteroseksual
Heterotroph	Heterotrof
Hexadecimal	Heksadesimal
Hezbollah	Hizbullah (Lebanon)
Hideki Yukawa	Hideki Yukawa
Himalayas	Pegunungan Himalaya
Hinduism	Umat Hindu
Hinduism	Kategori:Hindu
Hipparchus	Hipparchus
Hippocrates	Hippokrates
Hippocratic Oath	Sumpah Hippokrates
Hippopotamus	Kuda Nil
Hirohito	Hirohito
Hiroshima	Hiroshima, Hiroshima
Hispaniola	Hispaniola
Histidine	Histidin
Histology	Histologi
Histology	Kategori:Histologi
Historiography	Historiografi
History	Sejarah
History	Kategori:Sejarah
History	Portal:Sejarah
Ho Chi Minh	Ho Chi Minh
Ho Chi Minh City	Kota Ho Chi Minh
Hobart	Hobart
Hobby	Hobi
Hokusai	Katsushika Hokusai
Holiday	Hari raya
Hollywood	Hollywood
Holmium	Holmium
Holocene	Holosen
Holy Grail	Piala Suci
Holy Roman Empire	Kekaisaran Romawi Suci
Holy Roman Empire	Kategori:Kekaisaran Romawi Suci
Holy Spirit	Allah Roh Kudus
Homeostasis	Homeostasis
Homer	Homerus
Homo (genus)	Homo (genus)
Homo erectus	Homo erectus
Homo habilis	Homo habilis
Homosexuality	Homoseksualitas
Honduras	Honduras
Honduras	Kategori:Honduras
Honey	Madu
Hong Kong	Hong Kong
Hong Kong	Kategori:Hong Kong
Honiara	Honiara
Honolulu	Honolulu
Horace	Horatius
Horatio Nelson	Horatio Nelson
Horizon	Horizon
Hormone	Hormon
Horn (anatomy)	Tanduk
Horn of Africa	Tanduk Afrika
Horoscope	Horoskop
Horse	Kuda
Horse racing	Pacuan kuda
Hosni Mubarak	Hosni Mubarak
Hospital	Rumah sakit
Hotel	Hotel
House	Rumah
House (TV series)	House
House Mouse	Mencit
Houston	Houston, Texas
Hovercraft	Kapal bantalan udara
Howard Carter (archaeologist)	Howard Carter
Hubble's law	Hukum Hubble
Hudson Bay	Teluk Hudson
Hugh Capet	Hugh Capet dari Perancis
Human	Manusia
Humanism	Humanisme
Humerus	Tulang lengan atas
Humidity	Kelembapan
Humor	Kategori:Humor
Humpback Whale	Paus Bungkuk
Humphrey Bogart	Humphrey Bogart
Hunan	Hunan
Hundred Years' War	Perang Seratus Tahun
Hungary	Hongaria
Hungary	Kategori:Hongaria
Hunger	Kelaparan
Hunting	Perburuan
Hutu	Hutu
Hybrid	Hibrida
Hyderabad	Hyderabad
Hydrocarbon	Hidrokarbon
Hydroelectricity	Hidroelektrisitas
Hydrogen	Hidrogen
Hydrogen bond	Ikatan hidrogen
Hydrogen peroxide	Hidrogen peroksida
Hydrology	Hidrologi
Hydrology	Kategori:Hidrologi
Hydroxide	Hidroksida
Hyena	Hyena
Hymen	Selaput dara
Hymenoptera	Hymenoptera
Hymn	Himne
Hyperbola	Hiperbola (matematika)
Hyperion (moon)	Hyperion (bulan)
Hypertension	Tekanan darah tinggi
Hypertext	Hiperteks
Hypertext Transfer Protocol	HTTP
Hypnosis	Hipnosis
Hypothesis	Hipotesis
IPod	IPod
Iapetus (moon)	Iapetus
Iberian Peninsula	Iberia
Ibuprofen	Ibuprofen
Ice	Es
Ice age	Zaman es
Ice cream	Es krim
Ice hockey	Hoki es
Iceberg	Gunung es
Iceland	Islandia
Iceland	Kategori:Islandia
Ichthyology	Iktiologi
Idaho	Idaho
Idaho	Kategori:Idaho
Ideology	Ideologi
Ido	Bahasa Ido
Igloo	Igloo
Ignatius of Loyola	Ignatius Loyola
Igneous rock	Batuan beku
Iguazu Falls	Air terjun Iguazu
Iliad	Iliad
Illinois	Illinois
Illinois	Kategori:Illinois
Image scanner	Pemindai
Imam	Imam
Immanuel Kant	Immanuel Kant
Immune system	Imunitas
Immunology	Imunologi
Immunology	Kategori:Imunologi
Imperialism	Imperialisme
Impressionism	Impresionisme
Incest	Hubungan sedarah
Inch	Inci
Incheon	Incheon
Inclined plane	Bidang miring
Independence	Kemerdekaan
India	India
India	Kategori:India
Indian Ocean	Samudra Hindia
Indian Ocean	Kategori:Samudra Hindia
Indiana	Indiana
Indiana	Kategori:Indiana
Indianapolis	Indianapolis
Indira Gandhi	Indira Gandhi
Indium	Indium
Indochina	Indochina
Indonesia	Indonesia
Indonesia	Kategori:Indonesia
Indra	Indra
Inductor	Induktor
Indulgence	Indulgensi
Indus River	Sungai Sindhu
Industrial Revolution	Revolusi Industri
Industry	Industri
Inequality	Pertidaksamaan
Infantry	Infanteri
Infectious disease	Penyakit menular
Infinity	Tak hingga
Inflammation	Radang
Inflation	Inflasi
Influenza	Influensa
Information	Informasi
Information technology	Teknologi informasi
Information theory	Teori informasi
Infrared	Inframerah
Ingmar Bergman	Ingmar Bergman
Ingrid Bergman	Ingrid Bergman
Inner Mongolia	Mongolia Dalam
Innsbruck	Innsbruck
Inorganic chemistry	Kimia anorganik
Inorganic chemistry	Kategori:Kimia anorganik
Inquisition	Inkuisisi
Insect	Serangga
Insulin	Insulin
Insurance	Asuransi
Integer	Bilangan bulat
Integral	Integral
Integrated circuit	Sirkuit terpadu
Intellectual property	Kekayaan intelektual
Intelligence	Kecerdasan
Interest	Suku bunga
Interference	Interferensi
Interjection	Interjeksi
International Atomic Energy Agency	Badan Tenaga Atom Internasional
International Civil Aviation Organization	International Civil Aviation Organization
International Court of Justice	Mahkamah Internasional
International Date Line	Batas penanggalan internasional
International Labour Organization	Organisasi Buruh Internasional
International Monetary Fund	Dana Moneter Internasional
International System of Units	Sistem Internasional Satuan
International law	Kategori:Hukum internasional
Internet	Internet
Internet	Kategori:Internet
Internet Explorer	Internet Explorer
Internment	Kamp konsentrasi
Interval (music)	Interval (musik)
Intestine	Usus
Intranet	Intranet
Invention	Penemuan
Invertebrate	Invertebrata
Iodine	Yodium
Ion	Ion
Ionian Sea	Laut Ionia
Ionosphere	Ionosfer
Iowa	Iowa
Iowa	Kategori:Iowa
Iran	Iran
Iran	Kategori:Iran
Iran-Iraq War	Perang Iran-Irak
Iraq	Irak
Iraq	Kategori:Irak
Ireland	Pulau Irlandia
Ireland	Kategori:Irlandia
Irenaeus	Ireneus
Iridium	Iridium
Irish people	Kategori:Tokoh Republik Irlandia
Iron	Besi
Iron Age	Zaman Besi
Iron Maiden	Iron Maiden
Irony	Ironi
Irrational number	Bilangan irasional
Isaac	Ishak
Isaac Asimov	Isaac Asimov
Isaac Bashevis Singer	Isaac Bashevis Singer
Isaac Newton	Isaac Newton
Isadora Duncan	Isadora Duncan
Ishmael	Isma'il
Islam	Islam
Islam	Kategori:Islam
Islamabad	Islamabad
Islamic calendar	Kalender Hijriyah
Island	Pulau
Isle of Man	Pulau Man
Isle of Man	Kategori:Pulau Man
Isle of Wight	Isle of Wight
Isomer	Isomer
Isoroku Yamamoto	Isoroku Yamamoto
Isotope	Isotop
Israel	Israel
Israel	Kategori:Israel
Istanbul	Istanbul
Isthmus	Tanah genting
Isthmus of Panama	Tanah Genting Panama
Italian Peninsula	Semenanjung Italia
Italy	Italia
Italy	Kategori:Italia
Ithaca	Ithaki
Ivan Lendl	Ivan Lendl
Ivan Pavlov	Ivan Pavlov
Ivan Turgenev	Ivan Turgenev
Ivy League	Ivy League
Iwo Jima	Iwo Jima
J. M. Barrie	J. M. Barrie
Jack Kerouac	Jack Kerouac
Jack Lemmon	Jack Lemmon
Jack London	Jack London
Jack the Ripper	Jack the Ripper
Jackson	Jackson, Mississippi
Jackson Pollock	Paul Jackson Pollock
Jacksonville	Jacksonville, Florida
Jacob	Yakub
Jacques Cartier	Jacques Cartier
Jacques Derrida	Jacques Derrida
Jade	Giok
Jainism	Jainisme
Jakarta	Daerah Khusus Ibukota Jakarta
Jalalabad	Jalalabad
Jamaica	Jamaika
Jamaica	Kategori:Jamaika
James	Yakobus
James A. Garfield	James A. Garfield
James Bond	James Bond
James Buchanan	James Buchanan
James Clerk Maxwell	James Clerk Maxwell
James Cook	James Cook
James Franck	James Franck
James Joyce	James Joyce
James K. Polk	James Knox Polk
James Madison	James Madison
James Monroe	James Monroe
James Naismith	James Naismith
James Prescott Joule	James Prescott Joule
James Watt	James Watt
Jammu and Kashmir	Jammu dan Kashmir
Jan Hus	Jan Hus
Jane Austen	Jane Austen
Jane Fonda	Jane Fonda
Janissary	Yanisari
January	Januari
January 1	1 Januari
January 19	19 Januari
January 20	20 Januari
January 6	6 Januari
Japan	Jepang
Japan	Kategori:Jepang
Java	Pulau Jawa
Java (programming language)	Java
Jawaharlal Nehru	Jawaharlal Nehru
Jazz	Jazz
Jean Piaget	Jean Piaget
Jean Sibelius	Jean Sibelius
Jean-Jacques Rousseau	Jean-Jacques Rousseau
Jean-Paul Sartre	Jean-Paul Sartre
Jeddah	Jeddah
Jefferson City	Jefferson City, Missouri
Jefferson Davis	Jefferson Finis Davis
Jehovah's Witnesses	Saksi-Saksi Yehuwa
Jellyfish	Ubur-ubur
Jena	Jena
Jerez de la Frontera	Jerez de la Frontera
Jericho	Yerikho
Jerome	Hieronimus
Jersey	Jersey
Jerusalem	Yerusalem
Jesus	Yesus
Jet engine	Mesin jet
Jew	Yahudi
Jihad	Jihad
Jimi Hendrix	Jimi Hendrix
Jimmy Carter	Jimmy Carter
Joan of Arc	Jeanne d'Arc
Johann Bernoulli	Johann Bernoulli
Johann Sebastian Bach	Johann Sebastian Bach
Johann Wolfgang von Goethe	Johann Wolfgang von Goethe
Johannes Brahms	Johannes Brahms
Johannes Diderik van der Waals	Johannes Diderik van der Waals
Johannes Gutenberg	Johann Gutenberg
Johannes Kepler	Johannes Kepler
Johannes Vilhelm Jensen	Johannes Vilhelm Jensen
Johannesburg	Johannesburg
John Adams	John Adams
John Bardeen	John Bardeen
John Calvin	Yohanes Calvin
John Chrysostom	Yohanes Krisostomus
John Dalton	John Dalton
John Galsworthy	John Galsworthy
John Lennon	John Lennon
John Locke	John Locke
John Major	John Major
John Maynard Keynes	John Maynard Keynes
John Milton	John Milton
John Napier	John Napier
John Quincy Adams	John Quincy Adams
John Steinbeck	John Ernst Steinbeck
John Tyler	John Tyler
John Wayne	John Wayne
John Wycliffe	John Wycliffe
John the Baptist	Yohanes Pembaptis
John von Neumann	John von Neumann
Johnny Cash	Johnny Cash
Joint	Sendi
Jonathan Swift	Jonathan Swift
Jordan	Yordania
Jordan	Kategori:Yordania
Jordan River	Sungai Yordan
Jorge Luis Borges	Jorge Luis Borges
Joseph Goebbels	Joseph Goebbels
Joseph Haydn	Joseph Haydn
Joseph Louis Gay-Lussac	Joseph Louis Gay-Lussac
Joseph McCarthy	Joseph Raymond McCarthy
Joseph Smith	Joseph Smith, Jr.
Joseph Stalin	Josef Stalin
Josephus	Flavius Yosefus
Joule	Joule
Journalism	Kategori:Jurnalisme
Journalism	Jurnalisme
Journalist	Wartawan
Joystick	Tuas kontrol
Judaism	Agama Yahudi
Judaism	Kategori:Yudaisme
Judas Iscariot	Yudas Iskariot
Judo	Judo
Jujutsu	Jujitsu
Jules Verne	Jules Verne
Julian calendar	Kalender Julian
Julius Caesar	Julius Caesar
July	Juli
July 1	1 Juli
July 4	4 Juli
June	Juni
June 14	14 Juni
June 21	21 Juni
June 23	23 Juni
June 24	24 Juni
June 29	29 Juni
June 3	3 Juni
Juneau	Juneau, Alaska
Jupiter	Yupiter
Jupiter	Kategori:Yupiter
Jurassic	Jura (periode)
Justinian I	Justinianus I
Jutland	Jutlandia
KGB	KGB
Kaaba	Ka'bah
Kabbalah	Kabala
Kabul	Kabul, Afganistan
Kamchatka Peninsula	Semenanjung Kamchatka
Kamikaze	Kamikaze
Kampala	Kampala
Kandahar	Provinsi Kandahar
Kangaroo	Kanguru
Kansas	Kansas
Kansas	Kategori:Kansas
Kansas City	Kansas City, Missouri
Kara Sea	Laut Kara
Karachi	Karachi
Karaoke	Karaoke
Karate	Karate
Karl Barth	Karl Barth
Karl Marx	Karl Marx
Karl Popper	Karl Popper
Karma	Karma
Karnataka	Karnataka
Katharine Hepburn	Katharine Hepburn
Kathmandu	Kathmandu
Katowice	Katowice
Kaunas	Kaunas
Kayak	Kayak
Kazakhstan	Kazakhstan
Kazakhstan	Kategori:Kazakhstan
Kazan	Kazan
Kelvin	Kelvin
Kent	Kent
Kentucky	Kentucky
Kentucky	Kategori:Kentucky
Kenya	Kenya
Kenya	Kategori:Kenya
Kernel (computer science)	Kernel (ilmu komputer)
Kerosene	Minyak tanah
Ketchup	Saus tomat
Ketone	Keton
Keyboard (computing)	Papan ketik
Khabarovsk	Khabarovsk
Khartoum	Khartoum
Khmer Rouge	Khmer Merah
Khufu	Khufu
Kibbutz	Kibbutz
Kidney	Ginjal
Kiev	Kiev
Kigali	Kigali
Kilobyte	Kilobita
Kilogram	Kilogram
Kilometre	Kilometer
Kilometres per hour	Kilometer per jam
Kimono	Kimono
Kindergarten	Taman Kanak-kanak
Kinematics	Kinematika
Kinetic energy	Energi kinetis
King Arthur	Raja Arthur
King Lear	Raja Lear
Kingdom (biology)	Kerajaan (biologi)
Kingston	Kingston, Jamaika
Kingstown	Kingstown
Kinshasa	Kinshasa
Kiribati	Kiribati
Kiribati	Kategori:Kiribati
Kirkuk	Kirkuk
Kite	Layang-layang
Kiwi	Kiwi
Knee	Lutut
Knesset	Knesset
Knife	Pisau
Knight	Kesatria
Knot (speed)	Knot (kecepatan)
Knowledge	Pengetahuan
Knut Hamsun	Knut Hamsun
Koala	Koala
Kobe	Kobe, Hyogo
Kola Peninsula	Semenanjung Kola
Kolkata	Kolkata
Komodo dragon	Biawak Komodo
Konqueror	Konqueror
Konrad Adenauer	Konrad Adenauer
Korea	Korea
Korea	Kategori:Korea
Korean War	Perang Korea
Kosovo	Kosovo
Kosovo	Kategori:Kosovo
Krakatoa	Gunung Krakatau
Krishna	Kresna
Krypton	Kripton
Ku Klux Klan	Ku Klux Klan
Kuala Lumpur	Kuala Lumpur
Kublai Khan	Kubilai Khan
Kuiper belt	Sabuk Kuiper
Kumquat	Buah Kumquat
Kung fu (term)	Kung fu
Kuomintang	Kuomintang
Kura River	Sungai Kura
Kurdistan	Kategori:Kurdistan
Kurdistan Workers Party	Partai Pekerja Kurdistan
Kursk	Kursk
Kurt Vonnegut	Kurt Vonnegut
Kurt Waldheim	Kurt Waldheim
Kuwait	Kuwait
Kuwait	Kategori:Kuwait
Kuwait City	Kuwait City
KwaZulu-Natal	KwaZulu-Natal
Kyoto	Kyoto
Kyrgyzstan	Kirgizstan
Kyrgyzstan	Kategori:Kirgizstan
L'Aquila	L'Aquila
LAMP (software bundle)	LAMP
La Paz	La Paz, Bolivia
La Plata	La Plata
La Spezia	La Spezia
Laboratory	Laboratorium
Labour Party (UK)	Partai Buruh (Britania Raya)
Labrador Retriever	Labrador Retriever
Lacerta	Lacerta
Lagos	Lagos
Laissez-faire	Laissez-faire
Lake	Danau
Lake Baikal	Danau Baikal
Lake Balaton	Danau Balaton
Lake Chad	Danau Chad
Lake Erie	Danau Erie
Lake Huron	Danau Huron
Lake Michigan	Danau Michigan
Lake Ontario	Danau Ontario
Lake Superior	Danau Superior
Lake Tanganyika	Danau Tanganyika
Lake Victoria	Danau Victoria
Lakshmi	Laksmi
Lamprey	Lamprey
Lancashire	Lancashire
Language	Bahasa
Languedoc-Roussillon	Languedoc-Roussillon
Lansing	Lansing, Michigan
Lanthanide	Lantanida
Lanthanum	Lantanum
Laos	Laos
Laos	Kategori:Laos
Laptop	Komputer jinjing
Larva	Larva
Larynx	Laring
Las Vegas	Las Vegas, Nevada
Laser	Laser
Latin	Bahasa Latin
Latin America	Amerika Latin
Latin alphabet	Abjad Latin
Latitude	Garis lintang
Latvia	Latvia
Latvia	Kategori:Latvia
Laurasia	Laurasia
Lausanne	Lausanne
Lava	Lava
Law	Hukum
Law enforcement	Kategori:Kepolisian
Lawyer	Pengacara
Lazio	Latium
Le Corbusier	Le Corbusier
Le Havre	Le Havre
Lead	Timbal
Leaf	Daun
League of Nations	Liga Bangsa-Bangsa
Leaning Tower of Pisa	Menara Pisa
Leap year	Tahun Kabisat
Learning	Belajar
Lebanon	Lebanon
Lebanon	Kategori:Lebanon
Lee Harvey Oswald	Lee Harvey Oswald
Leeds	Leeds
Left-handed	Kidal
Legend	Legenda
Legislature	Legislatif
Lego	Lego
Leicester	Leicester
Leiden	Leiden
Leipzig	Leipzig
Lemon	Lemon
Lena River	Sungai Lena
Lens (optics)	Lensa
Lent	Pra-Paskah
Leo (constellation)	Leo
Leon Trotsky	Lev Trotski
Leonardo da Vinci	Leonardo da Vinci
Leonhard Euler	Leonhard Euler
Leonid Brezhnev	Leonid Brezhnev
Leopard	Macan Tutul
Lepidoptera	Kupu-kupu dan ngengat
Leprosy	Kusta
Lesbian	Lesbian
Lesotho	Lesotho
Lesotho	Kategori:Lesotho
Lesser Antilles	Kepulauan Antilles Kecil
Leukemia	Leukemia
Lever	Tuas
Leviathan	Lewiatan
Leviticus	Kitab Imamat
Lhasa	Lhasa
Liberalism	Liberalisme
Liberalism	Kategori:Liberalisme
Liberation Tigers of Tamil Eelam	Macan Tamil
Liberia	Liberia
Liberia	Kategori:Liberia
Libra (constellation)	Libra
Library	Perpustakaan
Library science	Ilmu perpustakaan
Libya	Libya
Libya	Kategori:Libya
Lie	Bohong
Liechtenstein	Liechtenstein
Liechtenstein	Kategori:Liechtenstein
Life	Kehidupan
Life	Kategori:Kehidupan
Light	Cahaya
Light-emitting diode	Dioda cahaya
Light-year	Tahun cahaya
Lighter	Korek api gas
Lighthouse	Mercusuar
Lightning	Kilat
Liguria	Liguria
Lilith	Lilith
Lille	Lille
Lilongwe	Lilongwe
Lima	Lima, Peru
Limerick	Limerick
Limestone	Batu kapur
Limit (mathematics)	Limit
Limnology	Limnologi
Limousin (region)	Limousin
Lincoln	Lincoln, Nebraska
Lincolnshire	Lincolnshire
Linear algebra	Aljabar linier
Linear algebra	Kategori:Aljabar linear
Linear equation	Persamaan Linear
Lingua franca	Lingua franca
Linguistics	Linguistik
Linguistics	Kategori:Linguistik
Linus Pauling	Linus Carl Pauling
Linux	Linux
Linux	Kategori:Linux
Linz	Linz
Lion	Singa
Lipid	Lipid
Liquid	Cairan
Liquid crystal display	Tampilan Kristal Cair
Liquorice	Licorice
Lisbon	Lisboa
Literature	Sastra
Literature	Kategori:Sastra
Literature	Portal:Sastra
Lithium	Litium
Lithography	Litografi
Lithuania	Lituania
Lithuania	Kategori:Lituania
Litre	Liter
Liverpool	Liverpool (kota)
Lizard	Kadal
Ljubljana	Ljubljana
Loanword	Kata pungut
Local area network	Local Area Network
Loch Ness	Loch Ness
Loch Ness Monster	Monster Loch Ness
Locomotive	Lokomotif
Logarithm	Logaritma
Logic	Logika
Logic	Kategori:Logika
Logic gate	Gerbang logika
Logistics	Logistik
Logo	Logo
Loire	Loire (departemen)
Loki	Loki
Lolita	Lolita
Lombardy	Lombardia
London	London
Long Beach	Long Beach, California
Long Island	Long Island
Lord's Prayer	Doa Bapa Kami
Lorraine (region)	Lorraine
Los Angeles	Los Angeles
Lot (department)	Lot (departemen)
Loudspeaker	Pengeras suara
Louis Armstrong	Louis Armstrong
Louis Braille	Louis Braille
Louis Pasteur	Louis Pasteur
Louisiana	Louisiana
Louisiana	Kategori:Louisiana
Louisville	Louisville, Kentucky
Louvre	Museum Louvre
Love	Cinta
Lower Saxony	Niedersachsen
Luanda	Luanda
Lublin	Lublin
Luciano Pavarotti	Luciano Pavarotti
Ludwig Boltzmann	Ludwig Boltzmann
Ludwig Wittgenstein	Ludwig Wittgenstein
Ludwig van Beethoven	Ludwig van Beethoven
Luftwaffe	Luftwaffe
Luigi Galvani	Luigi Galvani
Luigi Pirandello	Luigi Pirandello
Lunar eclipse	Gerhana bulan
Lund	Lund
Lung	Paru-paru
Lung cancer	Kanker paru-paru
Lupus (constellation)	Lupus
Lusaka	Lusaka
Lusitania	Lusitania
Lutetium	Lutesium
Luxembourg	Luksemburg
Luxembourg	Kategori:Luksemburg
Luxembourg (city)	Kota Luksemburg
Luxor	Luxor
Luzon	Luzon
Lydia	Lydia
Lymphatic system	Sistem limfatik
Lynx (constellation)	Lynx (rasi bintang)
Lyon	Lyon
Lyra	Lyra
Lysine	Lisin
Lysosome	Lisosom
M-theory	Teori-M
MESSENGER	MESSENGER
MIME	MIME
MS-DOS	MS-DOS
Macau	Makau
Macbeth	Macbeth
Macedon	Kekaisaran Makedonia
Mach number	Mach
Machine	Mesin
Machine code	Bahasa mesin
Machine gun	Senapan mesin
Machine translation	Terjemahan mesin
Machu Picchu	Machu Picchu
Macintosh	Macintosh
Macroeconomics	Ekonomi makro
Macroeconomics	Kategori:Ekonomi makro
Madagascar	Madagaskar
Madagascar	Kategori:Madagaskar
Madeira	Kepulauan Madeira
Madison	Madison, Wisconsin
Madonna (entertainer)	Madonna (penyanyi)
Madrid	Madrid
Madrid (autonomous community)	Madrid (wilayah otonomi)
Mafia	Mafia
Magazine	Majalah
Magenta	Magenta
Magic (paranormal)	Sihir
Maginot Line	Garis Maginot
Magma	Magma
Magna Carta	Magna Carta
Magnesium	Magnesium
Magnet	Magnet
Magnetic field	Medan Magnet
Magnetism	Magnetisme
Magnetism	Kategori:Magnetisme
Magnifying glass	Lup
Magnoliopsida	Kategori:Magnoliopsida
Maharashtra	Maharashtra
Mahatma Gandhi	Mahatma Gandhi
Mahayana	Mahayana
Mail	Pos
Maimonides	Moses Maimonides
Main	Sungai Main
Main	Templat:Main
Maine	Maine
Maine	Kategori:Maine
Mainframe computer	Mainframe (komputer)
Maitreya	Maitreya
Maize	Jagung
Major	Mayor
Major scale	Tangga nada mayor
Majorca	Mallorca
Malabo	Malabo
Malaria	Malaria
Malawi	Kategori:Malawi
Malay Peninsula	Semenanjung Melayu
Malaysia	Malaysia
Malaysia	Kategori:Malaysia
Malcolm X	Malcolm X
Maldives	Maladewa
Maldives	Kategori:Maladewa
Mali	Mali
Mali	Kategori:Mali
Malta	Malta
Malta	Kategori:Malta
Maltese language	Bahasa Malta
Malvaceae	Malvaceae
Mammal	Binatang menyusui
Mammoth	Mamut
Management	Manajemen
Managua	Managua
Manama	Al-Manamah
Manatee	Manatee
Manchester	Manchester
Manchuria	Manchuria
Mandala	Mandala
Mandarin (linguistics)	Bahasa Mandarin
Manganese	Mangan
Mango	Mangga
Mangrove	Hutan bakau
Manhattan	Manhattan
Manhattan Project	Proyek Manhattan
Manila	Manila
Manipur	Manipur
Manitoba	Manitoba
Mannerism	Mannerisme
Mannheim	Mannheim
Mantua	Mantova
Manuscript	Naskah
Mao Zedong	Mao Zedong
Maoism	Maoisme
Map	Peta
Maputo	Maputo
Marathon	Maraton
Marble	Marmer
Marc Chagall	Marc Chagall
Marcel Duchamp	Marcel Duchamp
Marcel Marceau	Marcel Marceau
Marcel Proust	Marcel Proust
March	Maret
March 17	17 Maret
March 19	19 Maret
March 2	2 Maret
March 25	25 Maret
Marche	Marche
Marco Polo	Marco Polo
Marcus Aurelius	Marcus Aurelius
Marcus Junius Brutus	Marcus Junius Brutus
Marduk	Marduk
Margaret Mead	Margaret Mead
Margaret Mitchell	Margaret Mitchell
Margaret Thatcher	Margaret Thatcher
Maria Callas	Maria Callas
Marie Antoinette	Marie Antoinette
Marie Curie	Marie Curie
Mariehamn	Mariehamn
Marilyn Monroe	Marilyn Monroe
Mark Twain	Mark Twain
Market	Pasar
Marketing	Pemasaran
Marketing	Kategori:Pemasaran
Markup language	Bahasa markah
Marlene Dietrich	Marlene Dietrich
Marquis de Sade	Marquis de Sade
Marrakech	Marrakesh
Marriage	Pernikahan
Mars	Kategori:Mars
Marseille	Marseille
Marshall Islands	Kepulauan Marshall
Marshall Islands	Kategori:Kepulauan Marshall
Marsupial	Marsupial
Martin Heidegger	Martin Heidegger
Martin Luther	Martin Luther
Martin Luther King	Martin Luther King, Jr.
Martin Scorsese	Martin Scorsese
Martin Van Buren	Martin Van Buren
Martinique	Martinique
Martyr	Syahid
Marx Brothers	Marx Brothers
Marxism	Marxisme
Marxism	Kategori:Marxisme
Mary (mother of Jesus)	Maria
Mary Shelley	Mary Shelley
Mary Wollstonecraft	Mary Wollstonecraft
Maryland	Maryland
Maryland	Kategori:Maryland
Maseru	Maseru
Mashhad	Masyhad
Mass	Massa
Mass (liturgy)	Misa
Massachusetts	Massachusetts
Massachusetts	Kategori:Massachusetts
Massachusetts Institute of Technology	Institut Teknologi Massachusetts
Masturbation	Masturbasi
Mata Hari	Mata Hari
Match	Korek api
Materialism	Materialisme
Mathematical logic	Logika matematika
Mathematical logic	Kategori:Logika matematika
Mathematical proof	Pembuktian Matematika
Mathematics	Matematika
Mathematics	Kategori:Matematika
Mathematics	Portal:Matematika
Matrix (mathematics)	Matriks (matematika)
Matter	Materi
Mauna Kea	Mauna Kea
Mauna Loa	Mauna Loa
Maundy Thursday	Kamis Putih
Mauritania	Mauritania
Mauritania	Kategori:Mauritania
Mauritius	Mauritius
Mauritius	Kategori:Mauritius
Max Born	Max Born
Max Planck	Max Planck
Max Weber	Max Weber
May	Mei
May 1	1 Mei
May 24	24 Mei
Mayenne	Mayenne
Mayonnaise	Mayones
Mayor	Walikota
Mbabane	Mbabane
Mead	Mead
Measles	Demam Campak
Measurement	Kategori:Pengukuran
Measurement	Pengukuran
Meat	Daging
Mecca	Mekkah
Mechanical engineering	Teknik mesin
Mechanical engineering	Kategori:Teknik mesin
Mechanics	Kategori:Mekanika
Mechanics	Mekanika
Medicine	Kedokteran
Medicine	Kategori:Kedokteran
Medina	Madinah
Mediterranean Sea	Laut Tengah
Megabyte	Megabita
Meiosis	Meiosis
Mekong	Mekong
Mel Gibson	Mel Gibson
Melanesia	Melanesia
Melting point	Titik lebur
Memory	Ingatan
Memphis	Memphis, Tennessee
Menachem Begin	Menachem Begin
Meningitis	Meningitis
Menstrual cycle	Menstruasi
Menstruation	Menstruasi
Mental disorder	Penyakit mental
Mentha	Mentha
Mercantilism	Merkantilisme
Mercenary	Tentara bayaran
Mercury (element)	Raksa
Mercury (planet)	Merkurius
Meridian (geography)	Meridian (geografi)
Meritocracy	Meritokrasi
Mermaid	Ikan duyung
Meryl Streep	Meryl Streep
Mesopotamia	Mesopotamia
Mesopotamia	Kategori:Mesopotamia
Mesosphere	Mesosfer
Mesozoic	Mesozoikum
Messenger RNA	MRNA
Messiah	Mesias
Messina	Messina
Metabolism	Metabolisme
Metadata	Metadata
Metal	Logam
Metalloid	Metaloid
Metallurgy	Metalurgi
Metamorphic rock	Batuan metamorf
Metaphysics	Metafisika
Metaphysics	Kategori:Metafisika
Metastasis	Metastasis
Meteor shower	Hujan meteor
Meteorite	Meteorit
Meteoroid	Meteoroid
Meteorology	Kategori:Meteorologi
Meteorology	Meteorologi
Methanol	Metanol
Methionine	Metionin
Methodism	Gereja Methodis
Methylenedioxymethamphetamine	Metilendioksimetamfetamin
Metre	Meter
Meuse	Meuse
Mexico	Meksiko
Mexico	Kategori:Meksiko
Mexico City	Ciudad de México
Miami	Miami, Florida
Michael (archangel)	Malaikat Mikail
Michael Faraday	Michael Faraday
Michel Ney	Michel Ney
Michelangelo	Michaelangelo Buonarroti
Michigan	Michigan
Michigan	Kategori:Michigan
Mick Jagger	Mick Jagger
Mickey Mouse	Miki Tikus
Microbiology	Mikrobiologi
Microbiology	Kategori:Mikrobiologi
Microeconomics	Ekonomi mikro
Microeconomics	Kategori:Ekonomi mikro
Micronesia	Mikronesia
Microorganism	Mikroorganisme
Microphone	Mikropon
Microprocessor	Mikroprosesor
Microscope	Mikroskop
Microwave	Gelombang mikro
Microwave oven	Oven microwave
Middle Ages	Abad Pertengahan
Middle Ages	Kategori:Abad Pertengahan
Middle East	Timur Tengah
Middle East	Kategori:Timur Tengah
Miguel de Cervantes	Miguel de Cervantes
Mike Tyson	Mike Tyson
Mikhail Bakunin	Mikhail Bakunin
Mikhail Gorbachev	Mikhail Gorbachev
Milan	Milano
Mile	Mil
Miles Davis	Miles Davis
Military	Kategori:Militer
Milk	Susu
Milky Way	Bima Sakti
Millard Fillmore	Millard Fillmore
Millennium	Milenium
Million	Satu juta
Milton Friedman	Milton Friedman
Milwaukee	Milwaukee, Wisconsin
Mindanao	Mindanao
Mineral	Mineral
Mineralogy	Mineralogi
Mineralogy	Kategori:Mineralogi
Ming Dynasty	Dinasti Ming
Mining	Pertambangan
Minister (government)	Menteri Departemen
Minneapolis	Minneapolis
Minnesota	Minnesota
Minnesota	Kategori:Minnesota
Minor scale	Tangga nada minor
Minotaur	Minotaurus
Minsk	Minsk
Minute	Menit
Miocene	Miosen
Miracle	Mujizat
Mirror	Cermin
Mishnah	Mishnah
Mississippi	Kategori:Mississippi
Mississippi River	Sungai Mississippi
Missouri	Missouri
Missouri	Kategori:Missouri
Missouri River	Sungai Missouri
Mitochondrion	Mitokondria
Mobile phone	Telepon genggam
Modem	Modem
Modernism	Modernisme
Modulation	Modulasi
Mogadishu	Mogadishu
Mold	Kapang
Moldova	Moldova
Moldova	Kategori:Moldavia
Mole (unit)	Mol
Molecular biology	Biologi molekular
Molecular biology	Kategori:Biologi molekular
Molecule	Molekul
Molise	Molise
Mollusca	Mollusca
Molotov cocktail	Bom Molotov
Molybdenum	Molibdenum
Mombasa	Mombasa
Momentum	Momentum
Monaco	Monako
Monaco	Kategori:Monako
Monarch	Monark
Monarchy	Monark
Monarchy	Kategori:Monarki
Monday	Senin
Money	Uang
Mongolia	Mongolia
Mongolia	Kategori:Mongolia
Monism	Monisme
Monomer	Monomer
Monopoly	Pasar monopoli
Monopoly (game)	Monopoli (permainan)
Monosaccharide	Monosakarida
Monosodium glutamate	Mononatrium glutamat
Monotheism	Monoteisme
Monotreme	Monotremata
Monrovia	Monrovia
Mons	Mons, Belgia
Monsoon	Muson
Mont Blanc	Mont Blanc
Montana	Montana
Montana	Kategori:Montana
Monte Carlo	Monte Carlo
Montenegro	Montenegro
Montenegro	Kategori:Montenegro
Monterrey	Monterrey
Montevideo	Montevideo
Montgomery	Montgomery, Alabama
Month	Bulan (penanggalan)
Montpelier	Montpelier, Vermont
Montreal	Montreal
Montserrat	Montserrat
Moon	Bulan
Morality	Moral
Moravia	Moravia
Morocco	Maroko
Morocco	Kategori:Maroko
Morphine	Morfin
Morphology	Morfologi
Morphology (linguistics)	Morfologi (linguistik)
Morse code	Kode Morse
Mortar (weapon)	Mortir
Moscow	Moskwa
Moscow	Kategori:Moskwa
Moselle	Moselle (departemen)
Moses	Musa
Moshe Dayan	Moshe Dayan
Mosque	Masjid
Mosquito	Nyamuk
Moss	Tumbuhan lumut
Mossad	Mossad
Mosul	Mosul
Mother Teresa	Bunda Teresa
Mother's Day	Hari Ibu
Motorcycle	Sepeda motor
Motto	Motto
Mount Ararat	Ararat
Mount Etna	Etna
Mount Everest	Gunung Everest
Mount Fuji	Gunung Fuji
Mount Kilimanjaro	Kilimanjaro
Mount Olympus	Gunung Olympus
Mount Pinatubo	Gunung Pinatubo
Mount St. Helens	Gunung St. Helens
Mount Vesuvius	Gunung Vesuvius
Mountain	Gunung
Mountain bike	Sepeda gunung
Mouse (computing)	Tetikus
Mozambique	Mozambik
Mozambique	Kategori:Mozambik
Muezzin	Mu'azzin
Muhammad	Muhammad
Muhammad Ali	Muhammad Ali
Mulberry	Bebesaran
Mule	Bagal
Multimedia	Multimedia
Multiple sclerosis	Sklerosis ganda
Mumbai	Mumbai
Mummy	Mumi
Munich	München
Municipality	Kotamadya
Muon	Muon
Murmansk	Murmansk
Murphy's law	Hukum Murphy
Muscat	Muskat
Muscle	Otot
Museum	Museum
Music	Musik
Music	Kategori:Musik
Musical Instrument Digital Interface	MIDI
Musical instrument	Alat musik
Musical scale	Tangga nada
Musician	Musikus
Musket	Musket
Mutation	Mutasi
Mute Swan	Angsa Putih
Myanmar	Kategori:Myanmar
Mycology	Mikologi
Mycology	Kategori:Mikologi
Myocardial infarction	Serangan jantung
Myth	Mitos
Mythology	Mitologi
Mythology	Kategori:Mitologi
N'Djamena	N'Djamena
NASDAQ	NASDAQ
NATO	NATO
NATO	Kategori:NATO
Nadine Gordimer	Nadine Gordimer
Nagasaki	Nagasaki
Nagoya	Nagoya
Nahuatl	Bahasa Nahuatl
Nail (anatomy)	Kuku
Nail (fastener)	Paku
Nairobi	Nairobi
Namib Desert	Gurun Namib
Namibia	Namibia
Namibia	Kategori:Namibia
Namur (city)	Namur (kota)
Nancy	Nancy
Nanjing	Nanjing
Nanotechnology	Nanoteknologi
Nantes	Nantes
Naples	Napoli
Napoleonic Wars	Perang Napoleon
Nashville	Nashville, Tennessee
Nassau	Nassau, Bahama
Nathaniel Hawthorne	Nathaniel Hawthorne
Nation	Bangsa
National Security Agency	National Security Agency
National anthem	Lagu kebangsaan
National park	Taman nasional
Nationalism	Nasionalisme
Natural gas	Gas alam
Natural number	Bilangan asli
Natural science	Ilmu alam
Natural selection	Seleksi alam
Nature	Alam
Nature	Kategori:Alam
Nauru	Nauru
Nauru	Kategori:Nauru
Nautical mile	Mil laut
Navigation	Kategori:Navigasi
Navigation	Navigasi
Navy	Angkatan laut
Nazareth	Nazaret
Nazi Germany	Jerman Nazi
Nazi Germany	Kategori:Jerman Nazi
Nazi Party	Nationalsozialistische Deutsche Arbeiterpartei
Nazism	Kategori:Nazi
Nebraska	Nebraska
Nebraska	Kategori:Nebraska
Nebula	Nebula
Necktie	Dasi
Nefertiti	Nefertiti
Neil Armstrong	Neil Armstrong
Nelson Mandela	Nelson Mandela
Neodymium	Neodimium
Neolithic	Neolitikum
Neologism	Neologisme
Neon	Neon
Nepal	Nepal
Nepal	Kategori:Nepal
Neptune	Neptunus
Neptunium	Neptunium
Nero	Nero
Nervous system	Sistem saraf
Nervous system	Kategori:Sistem saraf
Nest	Sarang
Nestorianism	Nestorianisme
Netherlands	Belanda
Netherlands	Kategori:Belanda
Netherlands Antilles	Antillen Belanda
Network topology	Topologi jaringan
Neurology	Neurologi
Neurology	Kategori:Neurologi
Neuron	Sel saraf
Neutrino	Neutrino
Neutron	Neutron
Nevada	Nevada
Nevada	Kategori:Nevada
Neville Chamberlain	Arthur Neville Chamberlain
New Brunswick	New Brunswick
New Caledonia	Kaledonia Baru
New Delhi	New Delhi
New England	New England
New Guinea	Pulau Irian
New Hampshire	New Hampshire
New Hampshire	Kategori:New Hampshire
New Jersey	New Jersey
New Jersey	Kategori:New Jersey
New Mexico	New Mexico
New Mexico	Kategori:New Mexico
New Orleans	New Orleans
New South Wales	New South Wales
New Testament	Perjanjian Baru
New World	Dunia Baru
New Year	Tahun Baru
New York	New York
New York	Kategori:New York
New York City	New York City
New York City	Kategori:New York City
New York Stock Exchange	NYSE
New Zealand	Selandia Baru
New Zealand	Kategori:Selandia Baru
Newark	Newark, New Jersey
Newfoundland (island)	Newfoundland
Newfoundland and Labrador	Newfoundland dan Labrador
Newport	Newport
Newton	Newton
Niagara Falls	Niagara
Niamey	Niamey
Nicaragua	Nikaragua
Nicaragua	Kategori:Nikaragua
Nice	Nice
Nicene Creed	Doa Syahadat Nicea
Nicholas	Petrović Njegoš
Nickel	Nikel
Nicolas Poussin	Nicolas Poussin
Nicolaus Copernicus	Nikolaus Kopernikus
Nicosia	Nikosia
Nicotine	Nikotin
Niels Bohr	Niels Bohr
Niger	Niger
Niger	Kategori:Niger
Niger River	Sungai Niger
Nigeria	Nigeria
Nigeria	Kategori:Nigeria
Night	Malam
Nihilism	Nihilisme
Nijmegen	Nijmegen
Nike	Nike, Inc.
Nikita Khrushchev	Nikita Khrushchev
Nikola Tesla	Nikola Tesla
Nile	Sungai Nil
Nile crocodile	Buaya sungai Nil
Ninja	Ninja
Niobium	Niobium
Nirvana	Nirwana
Nitric acid	Asam nitrat
Nitrogen	Nitrogen
Nitroglycerin	Nitrogliserin
Noah	Nuh
Noam Chomsky	Noam Chomsky
Nobel Prize	Penghargaan Nobel
Nobel Prize	Kategori:Penghargaan Nobel
Nobility	Bangsawan
Nobility	Kategori:Bangsawan
Noble gas	Gas mulia
Nomad	Nomaden
Nonmetal	Nonlogam
Norfolk	Norfolk
Norfolk Island	Pulau Norfolk
Norma (constellation)	Norma (rasi bintang)
Normal distribution	Distribusi normal
Normandy	Normandia
Norse mythology	Mitologi Nordik
Norse mythology	Kategori:Mitologi Nordik
North	Utara
North Africa	Afrika Utara
North America	Amerika Utara
North America	Kategori:Amerika Utara
North Carolina	North Carolina
North Dakota	North Dakota
North Dakota	Kategori:Dakota Utara
North Island	Pulau Utara
North Korea	Korea Utara
North Korea	Kategori:Korea Utara
North Pole	Kutub Utara
North Sea	Laut Utara
North Yorkshire	North Yorkshire
Northern Europe	Eropa Utara
Northern Hemisphere	Belahan utara
Northern Ireland	Irlandia Utara
Northern Ireland	Kategori:Irlandia Utara
Northern Mariana Islands	Kepulauan Mariana Utara
Northern Territory	Teritorial Utara
Northwest Territories	Northwest Territories
Norway	Norwegia
Norway	Kategori:Norwegia
Norwegian Sea	Laut Norwegia
Norwegian krone	Krona Norwegia
Nose	Hidung
Nostradamus	Nostradamus
Nouakchott	Nouakchott
Noun	Nomina
Nova Scotia	Nova Scotia
Novel	Novel
November	November
November 1	1 November
November 11	11 November
November 2	2 November
November 5	5 November
Novial	Bahasa Novial
Novosibirsk	Novosibirsk
Nu (letter)	Nu (huruf Yunani)
Nuclear fusion	Fusi nuklir
Nuclear physics	Kategori:Fisika nuklir
Nuclear power	Daya nuklir
Nuclear weapon	Senjata nuklir
Nucleic acid	Asam nukleat
Nucleotide	Nukleotida
Number	Bilangan
Numbers	Kategori:Angka
Nunavut	Nunavut
Nuremberg	Nürnberg
Nut (fruit)	Kacang
Nutmeg	Pala
Nutrition	Kategori:Nutrisi
Nymph	Nymph
OPEC	Organisasi Negara-negara Pengekspor Minyak Bumi
Oahu	Oahu
Oak	Ek
Oakland	Oakland, California
Oasis	Oasis
Oat	Haver
Oaxaca	Oaxaca (negara bagian)
Obesity	Obesitas
Object-oriented programming	Pemrograman Berorientasi Objek
Oboe	Obo
Observatory	Observatorium
Occam's razor	Pisau Ockham
Ocean	Samudra
Oceania	Oseania
Oceania	Kategori:Oseania
Oceanography	Oseanografi
Oceanography	Kategori:Oseanografi
Oceanus	Oceanus
Octal	Oktal
Octave	Oktaf
October	Oktober
October 12	12 Oktober
October 24	24 Oktober
October Revolution	Revolusi Oktober
Oder River	Sungai Oder
Odessa	Odessa
Odin	Odin
Odyssey	Odyssey
Offside (football)	Offside (sepak bola)
Ohio	Ohio
Ohio	Kategori:Ohio
Ohm	Ohm
Oil	Minyak
Oil (disambiguation)	Minyak
Okapi	Okapi
Oklahoma	Oklahoma
Oklahoma	Kategori:Oklahoma
Oklahoma City	Oklahoma City, Oklahoma
Oktoberfest	Oktoberfest
Old Testament	Perjanjian Lama
Oligarchy	Oligarki
Oligocene	Oligosen
Oligopoly	Oligopoli
Olive	Zaitun
Olive oil	Minyak zaitun
Oliver Cromwell	Oliver Cromwell
Oliver Stone	Oliver Stone
Olympia	Olympia, Washington
Olympic Games	Olimpiade
Olympics	Kategori:Olimpiade
Omaha	Omaha, Nebraska
Oman	Oman
Oman	Kategori:Oman
Omega	Omega
Omicron	Omikron
Omsk	Omsk
Oncology	Kategori:Onkologi
Onion	Bawang Bombay
Onomastics	Onomastik
Ontario	Ontario
Ontario	Kategori:Ontario
Ontology	Ontologi
Oort cloud	Awan Oort
Opel	Opel
Opera	Opera
Opera (Internet suite)	Opera (perangkat lunak)
Operating system	Sistem operasi
Ophiuchus	Ophiuchus
Opium	Opium
Optical fiber	Serat optik
Optical illusion	Ilusi optis
Optics	Optik
Optics	Kategori:Optik
Optimization (mathematics)	Optimisasi
Oral sex	Seks oral
Orange (colour)	Jingga
Orange (fruit)	Jeruk manis
Orangutan	Orang utan
Orbit	Orbit
Orchidaceae	Orchidaceae
Order (biology)	Ordo (biologi)
Order of Saint Benedict	Benediktin
Ordovician	Ordovisium
Oregano	Oregano
Oregon	Oregon
Oregon	Kategori:Oregon
Organ (anatomy)	Organ (anatomi)
Organ (music)	Organ (alat musik)
Organelle	Organel
Organic chemistry	Kimia organik
Organic chemistry	Kategori:Kimia organik
Organic compound	Senyawa organik
Organism	Organisme
Organization	Organisasi
Organization of American States	Organisasi Negara-negara Amerika
Orgasm	Orgasme
Origami	Origami
Origen	Origenes
Original sin	Dosa Asal
Orinoco	Sungai Orinoko
Orion (constellation)	Orion
Orlando	Orlando, Florida
Ornithology	Ornitologi
Ornithology	Kategori:Ornitologi
Orson Welles	Orson Welles
Osaka	Osaka
Osama bin Laden	Usamah bin Ladin
Oscar Wilde	Oscar Wilde
Oscillation	Osilasi
Osiris	Osiris
Oslo	Oslo
Osman I	Osman I
Osmium	Osmium
Osprey	Elang Tiram
Osteoporosis	Osteoporosis
Ostrava	Ostrava
Ostrich	Burung unta
Othello	Othello
Ottawa	Ottawa
Otto Hahn	Otto Hahn
Otto von Bismarck	Otto von Bismarck
Ottoman Empire	Kesultanan Utsmaniyah
Ottoman Empire	Kategori:Kesultanan Utsmaniyah
Ovary	Ovarium
Ovid	Ovid
Oviedo	Oviedo
Ovum	Sel telur
Owl	Burung Hantu
Oxford	Oxford
Oxidation state	Bilangan oksidasi
Oxide	Oksida
Oxygen	Oksigen
Oxytocin	Oksitosin
Ozone	Ozon
Ozone layer	Lapisan ozon
PAL	PAL
PH	PH
Pablo Neruda	Pablo Neruda
Pablo Picasso	Pablo Picasso
Pacific Ocean	Samudra Pasifik
Pacific Ocean	Kategori:Samudra Pasifik
Pacifism	Pasifisme
Padua	Padova
Paganism	Paganisme
Pakistan	Pakistan
Pakistan	Kategori:Pakistan
Palace of Versailles	Istana Versailles
Palau	Palau
Palau	Kategori:Palau
Paleocene	Paleosen
Paleolithic	Paleolitik
Paleontology	Paleontologi
Paleontology	Kategori:Paleontologi
Paleozoic	Paleozoikum
Palermo	Palermo
Palestine	Palestina
Palestine	Kategori:Palestina
Palestine Liberation Organization	Organisasi Pembebasan Palestina
Palestinian National Authority	Otoritas Nasional Palestina
Pali	Bahasa Pali
Palindrome	Palindrom
Palladium	Paladium
Palm Sunday	Minggu Palma
Pan (mythology)	Pan
Panama	Panama
Panama	Kategori:Panama
Panama Canal	Terusan Panama
Pancreas	Pankreas
Pangaea	Pangea
Pantheism	Panteisme
Panthera	Panthera
Papal States	Negara-negara Kepausan
Papua New Guinea	Papua Nugini
Papua New Guinea	Kategori:Papua Nugini
Papyrus	Papirus
Parabola	Parabola
Paracelsus	Paracelsus
Parachute	Parasut
Paradox	Paradoks
Paraguay	Paraguay
Paraguay	Kategori:Paraguay
Parallax	Paralaks
Parallelogram	Jajar Genjang
Paramaribo	Paramaribo
Paranoia	Paranoia
Parasitism	Parasitisme
Paris	Paris
Paris	Kategori:Paris
Parkinson's disease	Penyakit Parkinson
Parliament	Parlemen
Parsec	Parsec
Parsley	Peterseli
Parthenon	Parthenon
Parthia	Parthia
Particle physics	Fisika partikel
Particle physics	Kategori:Fisika partikel
Parvati	Parwati
Pascal (programming language)	Pascal (bahasa pemrograman)
Pascal (unit)	Pascal (satuan)
Passerine	Burung pengicau
Passover	Pesakh
Passport	Paspor
Password	Kata sandi
Pasteurization	Pasteurisasi
Patent	Paten
Pathology	Patologi
Patras	Patras
Patriarch	Patriark
Paul Gauguin	Paul Gauguin
Paul Johann Ludwig von Heyse	Paul Johann Ludwig von Heyse
Paul McCartney	Paul McCartney
Paul Newman	Paul Newman
Paul the Apostle	Paulus dari Tarsus
Paul von Hindenburg	Paul von Hindenburg
Pavo (constellation)	Pavo
Pays de la Loire	Pays de la Loire
Pea	Ercis
Peace	Damai
Peace of Westphalia	Perdamaian Westphalia
Peach	Persik
Peafowl	Merak
Peanut	Kacang tanah
Pearl	Mutiara
Pearl Harbor	Pearl Harbor
Peat	Gambut
Pedagogy	Pedagogi
Pediatrics	Pediatri
Pedophilia	Pedofilia
Pegasus (constellation)	Pegasus
Pencil	Pensil
Penguin	Penguin
Penicillin	Penisilin
Peninsula	Semenanjung
Pennsylvania	Pennsylvania
Pennsylvania	Kategori:Pennsylvania
Pentagon	Segi lima
Pentagram	Pentagram
Pentecost	Pentakosta
Pentecostalism	Gereja Pentakosta
People	Kategori:Tokoh
People's Republic of China	Republik Rakyat Cina
Pepsi	Pepsi
Percussion instrument	Alat musik perkusi
Peregrine Falcon	Falcon Peregrine
Perfume	Parfum
Period (periodic table)	Periode tabel periodik
Periodic table	Tabel periodik
Perm	Perm
Permian	Perm
Permutation	Permutasi
Pernambuco	Pernambuco
Persepolis	Persepolis
Perseus (constellation)	Perseus
Persian Empire	Kekaisaran Persia
Persian Gulf	Teluk Persia
Personal digital assistant	Personal Digital Assistant
Perth	Perth, Australia Barat
Peru	Peru
Peru	Kategori:Peru
Peter Sellers	Peter Sellers
Petroleum	Minyak bumi
Petrology	Petrologi
Phanerozoic	Fanerozoikum
Pharaoh	Firaun
Pharmacology	Farmakologi
Pharmacology	Kategori:Farmakologi
Pharynx	Faring
Phase (matter)	Fase benda
Phenol	Fenol
Phenomenology	Fenomenologi
Phenotype	Fenotipe
Phenylalanine	Fenilalanin
Phenylketonuria	Fenilketonuria
Philadelphia	Philadelphia, Pennsylvania
Philately	Filateli
Philately	Kategori:Filateli
Philip II of Spain	Felipe II dari Spanyol
Philipp Lenard	Philipp Eduard Anton von Lenard
Philippine Sea	Laut Filipina
Philippines	Filipina
Philippines	Kategori:Filipina
Philology	Filologi
Philosopher's stone	Batu filsuf
Philosophy	Filsafat
Philosophy	Kategori:Filsafat
Philosophy	Portal:Filsafat
Phnom Penh	Phnom Penh
Phobia	Fobia
Phoenicia	Bangsa Fenisia
Phoenix	Phoenix, Arizona
Phoenix	Phoenix
Phoenix (mythology)	Phoenix (mitologi)
Phoenix (spacecraft)	Phoenix (wahana antariksa)
Phoneme	Fonem
Phonetics	Fonetik
Phonetics	Kategori:Fonetik
Phonology	Fonologi
Phosphate	Fosfat
Phosphorus	Fosfor
Photography	Fotografi
Photography	Kategori:Fotografi
Photon	Foton
Photosphere	Fotosfer
Photosynthesis	Fotosintesis
Phylum	Filum
Physical chemistry	Kimia fisik
Physical chemistry	Kategori:Kimia fisik
Physician	Dokter
Physics	Fisika
Physics	Kategori:Fisika
Physics	Portal:Fisika
Physiology	Fisiologi
Physiology	Kategori:Fisiologi
Pi	Pi
Piano	Piano
Picardie	Picardie
Piciformes	Piciformes
Pidgin	Bahasa Pidgin
Piedmont	Piemonte
Pierre	Pierre, South Dakota
Pierre Curie	Pierre Curie
Pierre de Fermat	Pierre de Fermat
Pieter Zeeman	Pieter Zeeman
Pigment	Pigmen
Pilsen	Plzeň
Pine	Tusam
Pineapple	Nanas
Ping	Ping
Pink	Merah jambu
Pinniped	Anjing laut
Piracy	Perompakan
Pisa	Pisa
Pisces (constellation)	Pisces
Piston	Piston
Pittsburgh	Pittsburgh, Pennsylvania
Pituitary gland	Hipofisis
Pixel	Piksel
Pizza	Pizza
Plagiarism	Plagiarisme
Planet	Planet
Plankton	Plankton
Plant	Tumbuhan
Plastic	Plastik
Plastid	Plastida
Plate tectonics	Lempeng tektonik
Platelet	Keping darah
Platinum	Platina
Plato	Plato
Platypus	Platipus
Playboy	Playboy (majalah)
Pleistocene	Plestosen
Pleven	Pleven
Pliocene	Pliosen
Plovdiv	Plovdiv
Plum	Prem
Pluto	Pluto
Plutonium	Plutonium
Plymouth	Plymouth
Pneumonia	Pneumonia
Po River	Sungai Po
Poaceae	Poaceae
Podcast	Podcasting
Poetry	Puisi
Pogrom	Pogrom
Poison	Racun
Poitiers	Poitiers
Poitou-Charentes	Poitou-Charentes
Poland	Polandia
Poland	Kategori:Polandia
Polar bear	Beruang kutub
Police	Polisi
Poliomyelitis	Poliomielitis
Political party	Partai politik
Political science	Ilmu politik
Political science	Kategori:Ilmu politik
Politician	Politikus
Politics	Politik
Politics	Kategori:Politik
Pollen	Serbuk sari
Pollination	Penyerbukan
Pollution	Pencemaran
Polo	Polo
Polonium	Polonium
Polygamy	Poligami
Polymer	Polimer
Polynesia	Polinesia
Polytheism	Politeisme
Pomegranate	Delima
Pomelo	Jeruk bali
Pompeii	Pompeii
Pontius Pilate	Pontius Pilatus
Pop music	Musik populer
Pope	Paus (Katolik Roma)
Pope Alexander VI	Paus Aleksander VI
Pornography	Pornografi
Port	Pelabuhan
Port Louis	Port Louis
Port Moresby	Port Moresby
Port Vila	Port Vila
Port of Spain	Port-of-Spain
Port-au-Prince	Port-au-Prince
Portland	Portland
Porto	Porto
Portsmouth	Portsmouth
Portugal	Portugal
Portugal	Kategori:Portugal
Poseidon	Poseidon
Positron	Positron
Postage stamp	Prangko
Postal code	Kode pos
Potassium	Kalium
Potassium nitrate	Kalium nitrat
Potato	Kentang
Potential energy	Energi potensial
Potsdam	Potsdam
Pound sterling	Pound sterling
Poverty	Kemiskinan
Power (physics)	Daya
Prague	Praha
Praia	Praia, Tanjung Verde
Praseodymium	Praseodimium
Precambrian	Prakambrium
Precipitation (meteorology)	Presipitasi
Pregnancy	Kehamilan
Prehistory	Prasejarah
Prehistory	Kategori:Prasejarah
President	Presiden
President of the United States	Daftar Presiden AS
Pressure	Tekanan
Pretoria	Pretoria
Primate	Primata
Primates	Kategori:Primata
Prime Meridian	Meridian utama
Prime minister	Perdana Menteri
Prime number	Bilangan prima
Prince Edward Island	Pulau Pangeran Edward
Prince of Wales	Pangeran Wales
Princeton University	Universitas Princeton
Principle of relativity	Teori relativitas
Printing	Percetakan
Prion	Prion
Prism (geometry)	Prisma (geometri)
Prism (optics)	Prisma (optik)
Prison	Penjara
Prisoner of war	Tahanan perang
Probability theory	Probabilitas
Procyonidae	Procyonidae
Professor	Profesor
Profit	Laba
Programmer	Pemrogram
Programming language	Bahasa pemrograman
Progressive rock	Progressive rock
Prokaryote	Prokariota
Prolog	Prolog
Promethium	Prometium
Pronoun	Pronomina
Propaganda	Propaganda
Propane	Propana
Prophet	Nabi
Prose	Prosa
Prostate	Prostat
Protectorate	Protektorat
Protein	Protein
Proterozoic	Proterozoikum
Protestant Reformation	Reformasi Protestan
Protestantism	Protestan
Protist	Protista
Protista	Kategori:Protista
Protocol	Protokol
Proton	Proton
Protozoa	Protozoa
Providence	Providence, Rhode Island
Proxima Centauri	Proxima Centauri
Prussia	Prusia
Psalms	Kitab Mazmur
Pseudonym	Nama samaran
Pseudoscience	Kategori:Ilmu semu
Pseudoscience	Ilmu semu
Psoriasis	Psoriasis
Psychiatry	Psikiatri
Psychiatry	Kategori:Psikiatri
Psychoanalysis	Psikoanalisis
Psychology	Psikologi
Psychology	Kategori:Psikologi
Psychotherapy	Psikoterapi
Ptolemaic dynasty	Dinasti Ptolemeus
Ptolemy	Claudius Ptolemaeus
Puberty	Pubertas
Public domain	Domain publik
Public relations	Hubungan Masyarakat
Puerto Rico	Puerto Riko
Puerto Rico	Kategori:Puerto Riko
Pulley	Katrol
Pump	Pompa
Punctuation	Tanda baca
Punk rock	Punk rock
Pyongyang	Pyongyang
Pyramid	Piramida
Pyramid (geometry)	Limas
Pythagoras	Pythagoras
Qatar	Qatar
Qatar	Kategori:Qatar
Qin Dynasty	Dinasti Qin
Qing Dynasty	Dinasti Qing
Quadratic equation	Persamaan kuadrat
Quantum mechanics	Mekanika kuantum
Quantum mechanics	Kategori:Mekanika kuantum
Quarantine	Karantina
Quark	Quark
Quartz	Kuarsa
Quebec	Quebec
Quebec	Kategori:Quebec
Quebec City	Kota Quebec
Quechua	Bahasa Quechua
Queensland	Queensland
Quentin Tarantino	Quentin Tarantino
Question mark	Tanda tanya
Quetzalcoatl	Quetzalcoatl
Quito	Quito
RAF (disambiguation)	RAF
RAID	RAID
RNA	Asam ribonukleat
Ra	Ra
Rabat	Rabat
Rabbi	Rabi
Rabindranath Tagore	Rabindranath Tagore
Raccoon Dog	Anjing rakun
Race	Ras manusia
Rachel Carson	Rachel Carson
Racism	Rasisme
Racism	Kategori:Rasisme
Radar	Radar
Radian	Radian
Radio	Kategori:Radio
Radioactive decay	Peluruhan radioaktif
Radiocarbon dating	Penanggalan radiokarbon
Radiology	Radiologi
Radium	Radium
Radius	Radius
Radon	Radon
Rain	Hujan
Rainbow	Pelangi
Rainer Maria Rilke	Rainer Maria Rilke
Raleigh	Raleigh, North Carolina
Rama	Rama
Ramadan	Ramadhan
Ramayana	Ramayana
Random access memory	RAM
Rape	Pemerkosaan
Rapeseed	Brassica napus
Raphael	Raphael Sanzio
Rapid transit	Kategori:Angkutan cepat
Rational number	Bilangan rasional
Ravenna	Ravenna
Rawalpindi	Rawalpindi
Ray Bradbury	Ray Bradbury
Read-only memory	ROM
Real number	Bilangan riil
Recession	Resesi
Rectangle	Persegi panjang
Recursion	Rekursi
Recycling	Daur ulang
Red	Merah
Red Army Faction	Faksi Pasukan Merah
Red Fox	Rubah merah
Red Panda	Panda Merah
Red Sea	Laut Merah
Red algae	Ganggang merah
Red blood cell	Sel darah merah
Redshift	Pergeseran merah
Redshift (disambiguation)	Pergeseran merah
Reduced instruction set computer	RISC
Referendum	Referendum
Refugee	Pengungsi
Regent	Gubernur
Reggae	Reggae
Regiment	Resimen
Regina	Regina, Saskatchewan
Region	Wilayah
Reims	Reims
Reincarnation	Reinkarnasi
Relativity	Kategori:Relativitas
Relay	Relay
Religion	Agama
Religion	Kategori:Agama
Religious Society of Friends	Kaum Quaker
Rembrandt	Rembrandt van Rijn
Renaissance	Abad Renaisans
Reptile	Reptil
Republic	Republik
Republic of China	Republik Cina
Republic of Ireland	Republik Irlandia
Republic of Ireland	Kategori:Republik Irlandia
Republic of the Congo	Republik Kongo
Republic of the Congo	Kategori:Republik Kongo
Republican Party (United States)	Partai Republik (Amerika Serikat)
Resistor	Resistor
Respiratory system	Sistem pernapasan
Retina	Retina
Retinol	Retinol
Revolution	Revolusi
Revolver	Revolver
Rhea (mythology)	Rhea
Rhenium	Renium
Rhetoric	Retorika
Rhine	Rhein
Rhinoceros	Badak
Rhode Island	Rhode Island
Rhode Island	Kategori:Rhode Island
Rhodes	Pulau Rodos
Rhodium	Rodium
Rhombus	Belah ketupat
Rhythm and blues	R&B
Rib	Tulang rusuk
Ribosome	Ribosom
Rice	Padi
Richard Feynman	Richard Feynman
Richard Nixon	Richard Nixon
Richard Strauss	Richard Strauss
Richard Wagner	Richard Wagner
Richard Wright (musician)	Richard Wright (pemusik)
Richmond	Richmond, Virginia
Riga	Riga
Right ascension	Asensio rekta
Ringo Starr	Ringo Starr
Rio de Janeiro	Rio de Janeiro
Rio de Janeiro (state)	Rio de Janeiro (negara bagian)
River	Sungai
River Thames	Sungai Thames
Riyadh	Riyadh
Road	Jalan raya
Roald Amundsen	Roald Amundsen
Robert A. Heinlein	Robert A. Heinlein
Robert Andrews Millikan	Robert Andrews Millikan
Robert Boyle	Robert Boyle
Robert De Niro	Robert De Niro
Robert Hooke	Robert Hooke
Robert Koch	Robert Koch
Robert Louis Stevenson	Robert Louis Stevenson
Robert Oppenheimer	Julius Robert Oppenheimer
Robert Owen	Robert Owen
Robert Redford	Robert Redford
Robert Schumann	Robert Schumann
Robin Hood	Robin Hood
Robot	Robot
Rock	Batu-Gunting-Kertas
Rock (geology)	Batu
Rock music	Kategori:Rock
Rocket	Roket
Rocky Mountains	Pegunungan Rocky
Rodent	Hewan pengerat
Roe Deer	Rusa Roe
Roger Bacon	Roger Bacon
Roman Catholic Church	Gereja Katolik Roma
Roman Empire	Kekaisaran Romawi
Roman Republic	Republik Romawi
Roman mythology	Mitologi Romawi
Roman mythology	Kategori:Mitologi Romawi
Romania	Rumania
Romania	Kategori:Rumania
Romansh	Bahasa Romansh
Romanticism	Romantisisme
Rome	Roma
Ronald Reagan	Ronald Reagan
Roof	Atap
Root	Akar
Rosa Parks	Rosa Parks
Rosaceae	Rosaceae
Rosario	Rosario, Argentina
Rosary	Doa Rosario
Rose	Mawar
Roseau	Roseau
Rosetta Stone	Batu Rosetta
Rosh Hashanah	Rosh Hashanah
Ross Sea	Laut Ross
Rostock	Rostock
Rotterdam	Gemeente Rotterdam
Router	Router
Royal Air Force	Angkatan Udara Britania Raya
Rubber	Karet
Rubicon	Rubicon
Rubidium	Rubidium
Ruby	Rubi
Ruby (programming language)	Ruby (bahasa pemrograman)
Rudolf Diesel	Rudolf Diesel
Rudolf Hess	Rudolf Hess
Rudyard Kipling	Joseph Rudyard Kipling
Rupert Murdoch	Rupert Murdoch
Russia	Rusia
Russia	Kategori:Rusia
Russian Revolution (1917)	Revolusi Rusia
Russo-Japanese War	Perang Rusia-Jepang
Ruthenium	Rutenium
Rutherford B. Hayes	Rutherford B. Hayes
Rutherfordium	Rutherfordium
Rwanda	Rwanda
Rwanda	Kategori:Rwanda
SOAP	SOAP
SOS	SOS
Sacrament	Sakramen
Sacramento	Sacramento, California
Saddam Hussein	Saddam Hussein
Safari (web browser)	Safari (penjelajah web)
Saffron	Kuma-kuma
Sagitta	Sagitta
Sagittarius (constellation)	Sagittarius
Sahara	Gurun Sahara
Saint	Santo
Saint Andrew	Andreas
Saint Kitts and Nevis	Saint Kitts dan Nevis
Saint Kitts and Nevis	Kategori:Saint Kitts dan Nevis
Saint Lawrence River	Sungai Saint Lawrence
Saint Lucia	Saint Lucia
Saint Lucia	Kategori:Saint Lucia
Saint Martin	Saint Martin
Saint Patrick	Patrick (santo)
Saint Paul	Saint Paul, Minnesota
Saint Peter	Simon Petrus
Saint Petersburg	St. Petersburg
Saint Vincent and the Grenadines	Saint Vincent dan Grenadines
Saint Vincent and the Grenadines	Kategori:Saint Vincent dan Grenadines
Sake	Sake
Saladin	Salahuddin Ayyubi
Salah	Shalat
Salem	Salem, Oregon
Salerno	Salerno
Saliva	Air liur
Salman Rushdie	Salman Rushdie
Salt (chemistry)	Garam (kimia)
Salt Lake City	Salt Lake City, Utah
Salvador	Salvador, Brasil
Salzburg	Salzburg
Salzburg (state)	Salzburg (negara bagian)
Samara	Samara, Rusia
Samarium	Samarium
Samarkand	Samarkand
Samoa	Samoa
Samoa	Kategori:Samoa
Samsara	Samsara
Samuel Beckett	Samuel Beckett
Samuel F. B. Morse	Samuel Morse
Samuel Taylor Coleridge	Samuel Taylor Coleridge
Samurai	Samurai
San Antonio	San Antonio, Texas
San Diego	San Diego, California
San Francisco	San Francisco
San Jose	San José, California
San Juan	San Juan, Puerto Riko
San Marino	San Marino
San Marino	Kategori:San Marino
San Marino	San Marino (kota)
San Salvador	San Salvador
Sand	Pasir
Sandro Botticelli	Sandro Botticelli
Sandstone	Batu pasir
Sandwich	Roti lapis
Sanskrit	Bahasa Sanskerta
Santa Fe	Santa Fe, New Mexico
Santiago	Santiago, Chili
Santo Domingo	Santo Domingo
Santos (Săo Paulo)	Santos
Sapphire	Safir
Sapporo	Sapporo
Sarah Bernhardt	Sarah Bernhardt
Sarajevo	Sarajevo
Sardine	Sarden
Sardinia	Sardinia
Sari	Sari, Iran
Saskatchewan	Saskatchewan
Satan	Setan
Satanism	Setanisme
Satellite	Satelit
Saturday	Sabtu
Saturn	Saturnus
Saturn	Kategori:Saturnus
Satyr	Satyr
Sauce	Saus
Saudi Arabia	Arab Saudi
Saudi Arabia	Kategori:Arab Saudi
Saul Bellow	Saul Bellow
Sausage	Sosis
Savanna	Sabana
Saxony	Sachsen
Saxony	Kategori:Sachsen
Saxophone	Saksofon
Scandinavia	Skandinavia
Scandinavia	Kategori:Skandinavia
Scandium	Skandium
Scapula	Tulang belikat
Schizophrenia	Skizofrenia
School	Sekolah (institusi)
Schutzstaffel	Schutzstaffel
Science	Ilmu
Science	Kategori:Ilmu
Science fiction	Fiksi ilmiah
Scientific method	Metode ilmiah
Scientist	Ilmuwan
Scissors	Gunting
Scorpion	Kalajengking
Scorpius	Scorpius
Scotland	Skotlandia
Scotland	Kategori:Skotlandia
Scottish Gaelic	Bahasa Gaelik Skotlandia
Scrabble	Scrabble
Screw	Baut
Screwdriver	Obeng
Scrotum	Skrotum
Sculpture	Patung
Sculpture	Kategori:Patung
Sea	Laut
Sea cucumber	Teripang
Sea level	Permukaan laut
Sea of Azov	Laut Azov
Sea of Japan	Laut Jepang
Sea of Marmara	Laut Marmara
Sea of Okhotsk	Laut Okhotsk
Seaborgium	Seaborgium
Seahorse	Kuda laut
Search engine	Mesin pencari
Sears Tower	Menara Sears
Season	Musim
Seattle	Seattle
Second	Detik
Second Crusade	Perang Salib Kedua
Second Vatican Council	Konsili Vatikan II
Second law of thermodynamics	Hukum termodinamika kedua
Sect	Sekte
Security	Kategori:Keamanan
Sedimentary rock	Batuan sedimen
Seed	Biji
Segovia	Segovia
Seine	Sungai Seine
Seismology	Seismologi
Seismology	Kategori:Seismologi
Selene	Selene
Selenium	Selenium
Semantics	Semantik
Semantics	Kategori:Semantik
Semen	Air mani
Semiconductor	Semikonduktor
Semiotics	Semiotika
Senate	Senat
Senegal	Senegal
Senegal	Kategori:Senegal
Seoul	Seoul
Seppuku	Seppuku
September	September
September 11	11 September
September 11	Serangan 11 September 2001
September 17	17 September
September 29	29 September
Septuagint	Septuaginta
Sequence	Barisan
Serbia	Serbia
Serbia	Kategori:Serbia
Serbia and Montenegro	Serbia dan Montenegro
Serbia and Montenegro	Kategori:Serbia dan Montenegro
Sergei Rachmaninoff	Sergei Rachmaninoff
Serine	Serin
Serotonin	Serotonin
Serpens	Serpens
Server (computing)	Peladen
Set	Himpunan
Set theory	Teori himpunan
Set theory	Kategori:Teori himpunan
Sevastopol	Sevastopol
Severe acute respiratory syndrome	SARS
Seville	Sevilla
Sex	Seks
Sex organ	Alat kelamin
Sexism	Seksisme
Sexual intercourse	Hubungan seksual
Sexually transmitted disease	Penyakit menular seksual
Seychelles	Seychelles
Seychelles	Kategori:Seychelles
Shahadah	Syahadat
Shamanism	Dukun
Shanghai	Shanghai
Share (finance)	Saham
Shareware	Shareware
Sharia	Syariat Islam
Shark	Hiu
Sheffield	Sheffield
Sherlock Holmes	Sherlock Holmes
Shetland	Shetland
Shield	Perisai
Shikoku	Shikoku
Shinto	Shinto
Ship	Kapal
Shiva	Siwa
Shogi	Shogi
Shorthand	Stenografi
Shrimp	Udang
Siberia	Siberia
Sichuan	Sichuan
Sicily	Sisilia
Sicily	Kategori:Sisilia
Sierra Leone	Sierra Leone
Sierra Leone	Kategori:Sierra Leone
Sigma	Sigma
Sigmund Freud	Sigmund Freud
Sign language	Bahasa isyarat
Sigrid Undset	Sigrid Undset
Sikhism	Sikhisme
Sikkim	Sikkim
Silesia	Silesia
Silicon	Silikon
Silicon Valley	Silicon Valley
Silk Road	Jalur Sutra
Silurian	Silur
Silver	Perak
Simone de Beauvoir	Simone de Beauvoir
Sin	Dosa
Sinai Peninsula	Semenanjung Sinai
Sinclair Lewis	Harry Sinclair Lewis
Singapore	Singapura
Singapore	Kategori:Singapura
Single (music)	Singel
Siren	Siren
Sirius	Sirius
Sistine Chapel	Kapel Sistina
Sitting Bull	Sitting Bull
Six-Day War	Perang Enam Hari
Skagerrak	Skagerrak
Skateboard	Skateboard
Skeletal system	Kategori:Sistem rangka
Skin	Kulit
Skinhead	Skinhead
Skopje	Skopje
Skull	Tengkorak
Skyscraper	Pencakar langit
Slash (musician)	Slash
Slavery	Perbudakan
Slayer	Slayer
Sleep	Tidur
Slovakia	Slowakia
Slovakia	Kategori:Slowakia
Slovenia	Slovenia
Slovenia	Kategori:Slovenia
Small intestine	Usus halus
Smog	Asbut
Smolensk	Smolensk
Snake	Ular
Snow	Salju
Soap	Sabun
Socialism	Sosialisme
Society	Kategori:Masyarakat
Society of Jesus	Yesuit
Sociolinguistics	Sosiolinguistik
Sociology	Sosiologi
Sociology	Kategori:Sosiologi
Socrates	Socrates
Sodium	Natrium
Sodium bicarbonate	Natrium bikarbonat
Sodium chloride	Natrium klorida
Sofia	Sofia
Softball	Sofbol
Software	Kategori:Perangkat lunak
Soil	Tanah
Solanaceae	Solanaceae
Solanaceae	Kategori:Solanaceae
Solar System	Tata surya
Solar System	Kategori:Tata Surya
Solar cell	Sel surya
Solar eclipse	Gerhana matahari
Solar energy	Energi surya
Solar wind	Angin matahari
Solid	Padat
Solid state	Padat
Solidarity	Solidarność
Solomon	Salomo
Solomon Islands	Kepulauan Solomon
Solomon Islands	Kategori:Kepulauan Solomon
Solstice	Titik balik matahari
Solution	Larutan
Somalia	Somalia
Somalia	Kategori:Somalia
Somerset	Somerset
Somme	Somme (departemen)
Song	Lagu
Song of Solomon	Kitab Kidung Agung
Sophia Loren	Sophia Loren
Sophism	Sofisme
Sophocles	Sophokles
Soprano	Sopran
Sorbonne	Sorbonne
Soul	Jiwa
Sound	Bunyi
Soup	Sup
Source code	Kode sumber
South	Selatan
South Africa	Kategori:Afrika Selatan
South America	Amerika Selatan
South America	Kategori:Amerika Selatan
South Australia	Australia Selatan
South Carolina	South Carolina
South Carolina	Kategori:Carolina Selatan
South China Sea	Laut China Selatan
South Dakota	South Dakota
South Dakota	Kategori:Dakota Selatan
South Island	Pulau Selatan
South Korea	Korea Selatan
South Korea	Kategori:Korea Selatan
South Pole	Kutub Selatan
South Vietnam	Vietnam Selatan
Southeast Asia	Asia Tenggara
Southern Hemisphere	Belahan selatan
Sovereignty	Kedaulatan
Soviet Union	Uni Soviet
Soviet Union	Kategori:Uni Soviet
Soybean	Kedelai
Space	Ruang
Space Shuttle	Pesawat ulang-alik
Space station	Stasiun luar angkasa
Spacecraft	Wahana antariksa
Spaghetti	Spageti
Spain	Spanyol
Spain	Kategori:Spanyol
Spam (electronic)	Spam
Spanish Civil War	Perang Saudara Spanyol
Spanish people	Kategori:Tokoh Spanyol
Spanish-American War	Perang Spanyol-Amerika
Sparta	Sparta
Spear	Tombak
Special relativity	Relativitas khusus
Species	Spesies
Spectroscopy	Spektroskopi
Speed of light	Kecepatan cahaya
Speleology	Speleologi
Spencer Tracy	Spencer Tracy
Sperm Whale	Ikan paus sperma
Spermatozoon	Spermatozoid
Sphere	Bola (geometri)
Sphinx	Sphinx
Spice	Rempah-rempah
Spin (physics)	Spin (fisika)
Spinach	Bayam (Spinacia)
Spinal cord	Sumsum tulang belakang
Spleen	Limpa
Split	Split
Sponge	Porifera
Sport	Olahraga
Spreadsheet	Lembar kerja
Spring (season)	Musim semi
Springfield	Springfield, Illinois
Spyware	Spyware
Squamata	Squamata
Square (geometry)	Bujur sangkar
Squash (sport)	Squash
Squirrel	Bajing
Sri Lanka	Sri Lanka
Sri Lanka	Kategori:Sri Lanka
St. Louis	St. Louis, Missouri
Stadium	Stadion
Stainless steel	Baja tahan karat
Standard Generalized Markup Language	SGML
Standard deviation	Simpangan baku
Stanford University	Universitas Stanford
Stanley Kubrick	Stanley Kubrick
Star	Bintang
Star of David	Bintang Daud
Starch	Pati (polisakarida)
Starfish	Bintang laut
State	Negara
Statistical mechanics	Mekanika statistika
Statistics	Statistika
Statistics	Kategori:Statistika
Statue of Liberty	Patung Liberty
Stavanger	Stavanger
Steam	Uap
Steam engine	Mesin uap
Steel	Baja
Steffi Graf	Steffi Graf
Stegosaurus	Stegosaurus
Stem cell	Sel punca
Stephen Hawking	Stephen Hawking
Steppe	Stepa
Steven Spielberg	Steven Spielberg
Sting	Sting
Stock exchange	Bursa saham
Stockholm	Stockholm
Stomach	Lambung
Stone Age	Zaman Batu
Stonehenge	Stonehenge
Stork	Bangau
Storm	Badai
Strait	Selat
Strait of Gibraltar	Selat Gibraltar
Strait of Magellan	Selat Magelhaens
Strait of Messina	Selat Messina
Straits	Kategori:Selat
Strasbourg	Strasbourg
Strategy	Strategi
Stratigraphy	Stratigrafi
Stratosphere	Stratosfer
Strawberry	Stroberi
Stress (medicine)	Stres
String theory	Teori dawai
Stroke	Stroke
Strong interaction	Gaya nuklir kuat
Strontium	Stronsium
Stub	Templat:Stub
Student	Peserta didik
Stupa	Stupa
Stuttgart	Stuttgart
Sub-Saharan Africa	Afrika Sub-Sahara
Subculture	Subkultur
Submarine	Kapal selam
Subtraction	Pengurangan
Subversion (software)	Subversion
Sucre	Sucre, Bolivia
Sudan	Sudan
Sudan	Kategori:Sudan
Sudoku	Sudoku
Suez Canal	Terusan Suez
Suffix	Sufiks
Sufism	Sufisme
Sugar	Gula
Suharto	Soeharto
Sukarno	Soekarno
Sulawesi	Sulawesi
Sulfur	Belerang
Sulfur mustard	Yperit
Sulfuric acid	Asam sulfat
Sultan	Sultan
Sumatra	Sumatra
Sumer	Sumeria
Summer	Musim panas
Sumo	Sumo
Sun	Matahari
Sun Yat-sen	Sun Yat-sen
Sunday	Minggu
Sundial	Jam matahari
Sunflower	Bunga Matahari
Sunni Islam	Sunni
Supercomputer	Superkomputer
Superconductivity	Superkonduktivitas
Superman	Superman
Supernova	Supernova
Supreme Court of the United States	Mahkamah Agung Amerika Serikat
Sura	Surah
Surface tension	Tegangan permukaan
Surgeon	Ahli bedah
Surgery	Bedah
Surgery	Kategori:Bedah
Suriname	Suriname
Suriname	Kategori:Suriname
Surrey	Surrey
Sushi	Sushi
Suva	Suva
Svalbard	Svalbard
Swan	Angsa
Swastika	Swastika
Swaziland	Swaziland
Swaziland	Kategori:Swaziland
Sweden	Swedia
Sweden	Kategori:Swedia
Swedish krona	Krona Swedia
Sweet potato	Ubi jalar
Swimming	Berenang
Switzerland	Swiss
Switzerland	Kategori:Swiss
Sword	Pedang
Sydney	Sydney
Sylvia Plath	Sylvia Plath
Symbiosis	Simbiosis
Symbol	Lambang
Symphony	Simfoni
Synagogue	Sinagoga
Synonym	Sinonim
Syntax	Sintaksis
Synthesizer	Synthesizer
Syphilis	Sifilis
Syracuse	Siracusa
Syria	Suriah
Syria	Kategori:Suriah
System	Sistem
T. S. Eliot	Thomas Stearns Eliot
Table (furniture)	Meja
Table tennis	Tenis meja
Taboo	Tabu
Taekwondo	Taekwondo
Tagus	Tagus
Tahiti	Tahiti
Tai chi chuan	Taijiquan
Tail	Ekor
Taipei	Kota Taipei
Taiwan	Kategori:Taiwan
Taj Mahal	Taj Mahal
Tajikistan	Tajikistan
Tajikistan	Kategori:Tajikistan
Taliban	Taliban
Tallahassee	Tallahassee, Florida
Tallinn	Tallinn
Talmud	Talmud
Tamil Nadu	Tamil Nadu
Tampa	Tampa
Tampere	Tampere
Tanakh	Tanakh
Tang Dynasty	Dinasti Tang
Tangier	Tangier
Tank	Tank
Tantalum	Tantalum
Tanzania	Tanzania
Tanzania	Kategori:Tanzania
Taoism	Taoisme
Tarn	Tarn (departemen)
Tarragon	Tarragon
Tartu	Tartu
Tashkent	Tashkent
Tasman Sea	Laut Tasman
Tasmania	Tasmania
Tasmanian Devil	Setan Tasmania
Taste	Pengecapan
Tattoo	Rajah
Tau	Tau
Taurus (constellation)	Taurus
Tax	Pajak
Taxation	Kategori:Perpajakan
Taxicab	Taksi
Taxonomy	Taksonomi
Tbilisi	Tbilisi
Tea	Teh
Tea	Kategori:Teh
Teacher	Guru
Technetium	Teknesium
Technology	Teknologi
Technology	Kategori:Teknologi
Tegucigalpa	Tegucigalpa
Tehran	Teheran
Tel Aviv	Tel Aviv
Telecommunication	Telekomunikasi
Telegraphy	Telegrafi
Telephone	Telepon
Telescope	Teleskop
Television	Televisi
Television	Kategori:Televisi
Tellurium	Telurium
Temperature	Suhu
Temple	Klenteng
Temple of Artemis	Kuil Artemis
Ten Commandments	Sepuluh Perintah Allah
Tenerife	Pulau Tenerife
Tennessee	Tennessee
Tennessee	Kategori:Tennessee
Tennis	Tenis
Tennis	Kategori:Tenis
Tenzing Norgay	Tenzing Norgay
Terbium	Terbium
Terrorism	Terorisme
Terrorism	Kategori:Terorisme
Tertullian	Tertulianus
Tesla (unit)	Tesla
Testicle	Testis
Testosterone	Testosteron
Tetanus	Tetanus
Tethys (moon)	Tethys
Texas	Texas
Texas	Kategori:Texas
Textile	Tekstil
Thailand	Thailand
Thailand	Kategori:Thailand
Thales	Thales
Thallium	Talium
Thanksgiving	Thanksgiving
The Gambia	Gambia
The Gambia	Kategori:Gambia
The Hague	Den Haag
The Star-Spangled Banner	The Star-Spangled Banner
Theatre	Teater
Thebes	Thebes, Yunani
Themis	Themis
Theocracy	Teokrasi
Theodor Mommsen	Theodor Mommsen
Theodore Roosevelt	Theodore Roosevelt
Theology	Teologi
Theology	Kategori:Teologi
Theorem	Teorema
Theory	Teori
Theory of relativity	Teori relativitas
Thermodynamics	Termodinamika
Thermodynamics	Kategori:Termodinamika
Thermometer	Termometer
Theseus	Theseus
Thessaloniki	Thessaloniki
Think tank	Wadah pemikir
Third World	Dunia Ketiga
Thirty Years' War	Perang Tiga Puluh Tahun
Thomas Aquinas	Thomas Aquinas
Thomas Edison	Thomas Alva Edison
Thomas Hardy	Thomas Hardy
Thomas Jefferson	Thomas Jefferson
Thomas Malthus	Thomas Malthus
Thomas Mann	Paul Thomas Mann
Thor	Thor
Thorium	Torium
Thought	Pikiran
Thulium	Tulium
Thumb	Ibu jari
Thuringia	Thüringen
Thuringia	Kategori:Thüringen
Thursday	Kamis
Thylacine	Harimau Tasmania
Thymine	Timin
Tianjin	Tianjin
Tibet	Tibet
Tibet	Kategori:Tibet
Ticino	Kanton Ticino
Tide	Pasang surut
Tierra del Fuego	Tierra del Fuego
Tiger	Harimau
Tigris	Sungai Tigris
Timbuktu	Timbuktu
Time	Waktu
Time	Kategori:Waktu
Time (magazine)	TIME
Time zone	Zona waktu
Timor	Pulau Timor
Timur	Tamerlane
Tin	Timah
Tirana	Tirana
Tissue (biology)	Jaringan
Titan (moon)	Titan
Titan (mythology)	Titan (mitologi)
Titanic (disambiguation)	Titanic
Titanium	Titanium
Titian	Tiziano Vecelli
Titus	Titus Flavius Vespasianus
Tobacco	Tembakau
Tocantins (state)	Tocantins (negara bagian)
Tofu	Tahu
Togo	Togo
Togo	Kategori:Togo
Tokyo	Tokyo
Toledo	Toledo, Spanyol
Toluene	Toluena
Tom Hanks	Tom Hanks
Tom and Jerry	Tom and Jerry
Tomato	Tomat
Ton	Ton
Tonga	Tonga
Tonga	Kategori:Tonga
Tongue	Lidah
Toni Morrison	Toni Morrison
Tonne	Ton
Tony Blair	Tony Blair
Tool	Alat
Tooth	Gigi
Toothbrush	Sikat gigi
Topeka	Topeka, Kansas
Topology	Topologi
Topology	Kategori:Topologi
Torah	Taurat
Tornado	Tornado
Toronto	Toronto
Torpedo	Torpedo
Torque	Torsi
Tortoise	Kura-kura dan penyu
Torture	Siksaan
Toulon	Toulon
Toulouse	Toulouse
Tour de France	Tour de France
Tourism	Pariwisata
Tourism	Kategori:Pariwisata
Tours	Tours
Tower	Menara
Tower of Babel	Menara Babel
Tower of London	Menara London
Town	Kota
Toy	Mainan
Toyota	Toyota
Trade	Perdagangan
Trademark	Merek
Tradition	Tradisi
Train	Kereta api
Train station	Stasiun kereta api
Tram	Trem
Transformer	Transformator
Transistor	Transistor
Transliteration	Alihaksara
Transmission Control Protocol	TCP
Transportation	Kategori:Transportasi
Transsexualism	Transseksualisme
Transylvania	Transylvania
Trapezoid	Trapesium (geometri)
Treaty	Perjanjian internasional
Treaty of Versailles	Perjanjian Versailles
Tree	Pohon
Trenton	Trenton, New Jersey
Triangle	Segitiga
Triassic	Trias
Tributary	Anak sungai
Triceratops	Triceratops
Trier	Trier
Trigonometry	Trigonometri
Trinidad	Trinidad
Trinidad and Tobago	Trinidad dan Tobago
Trinidad and Tobago	Kategori:Trinidad dan Tobago
Trinitrotoluene	Trinitrotoluena
Trinity	Tritunggal
Tripoli	Tripoli
Tritium	Tritium
Trojan War	Perang Troya
Trojan horse (computing)	Trojan horse
Troll	Troll
Troll (Internet)	Internet troll
Trombone	Trombon
Trondheim	Trondheim
Tropic of Cancer	Garis balik utara
Tropic of Capricorn	Garis balik selatan
Tropics	Tropis
Troposphere	Troposfer
Troy	Troya
Truck	Truk
Trumpet	Terompet
Truth	Kebenaran
Trygve Lie	Trygve Lie
Tryptophan	Triptofan
Tsar	Tsar
Tsunami	Tsunami
Tuareg	Tuareg
Tuberculosis	Tuberkulosa
Tucson	Tucson
Tuesday	Selasa
Tulip	Tulip
Tumor	Tumor
Tundra	Tundra
Tungsten	Wolfram
Tunis	Tunis
Tunisia	Tunisia
Tunisia	Kategori:Tunisia
Tunnel	Terowongan
Turbine	Turbin
Turin	Torino
Turing machine	Mesin Turing
Turkey	Turki
Turkey	Kategori:Turki
Turkmenistan	Turkmenistan
Turkmenistan	Kategori:Turkmenistan
Turmeric	Kunir
Turtle	Kura-kura dan penyu
Tuscany	Toscana
Tuvalu	Tuvalu
Tuvalu	Kategori:Tuvalu
Tux	Tux
Tycho Brahe	Tycho Brahe
Typewriter	Mesin ketik
Typography	Tipografi
Typography	Kategori:Tipografi
Tyrannosaurus	Tyrannosaurus Rex
Tyre	Tirus
Tyrol (state)	Tirol
Tyrrhenian Sea	Laut Tirrhenia
UNESCO	Organisasi Pendidikan, Ilmu Pengetahuan, dan Kebudayaan PBB
Ufa	Ufa
Uganda	Uganda
Uganda	Kategori:Uganda
Ukraine	Ukraina
Ukraine	Kategori:Ukraina
Ulan Bator	Ulan Bator
Ultrasound	Ultrasonik
Ultraviolet	Ultraungu
Ulysses S. Grant	Ulysses S. Grant
Umbrella	Payung
Umbria	Umbria
Uncertainty principle	Prinsip Ketidakpastian Heisenberg
Unemployment	Pengangguran
Unicorn	Unicorn
Unidentified flying object	Benda Terbang Aneh
Uniform Resource Locator	URL
Union (set theory)	Gabungan (teori himpunan)
United Arab Emirates	Uni Emirat Arab
United Arab Emirates	Kategori:Uni Emirat Arab
United Arab Republic	Republik Arab Bersatu
United Kingdom	Britania Raya
United Kingdom	Kategori:Britania Raya
United Nations	Perserikatan Bangsa-Bangsa
United Nations	Kategori:Perserikatan Bangsa-Bangsa
United Nations Children's Fund	Dana Anak-anak PBB
United States	Amerika Serikat
United States	Kategori:Amerika Serikat
United States Air Force	Angkatan Udara Amerika Serikat
United States Congress	Kongres Amerika Serikat
United States Constitution	Konstitusi Amerika Serikat
United States House of Representatives	Dewan Perwakilan Amerika Serikat
United States Military Academy	Akademi Militer Amerika Serikat
United States Navy	Angkatan Laut Amerika Serikat
United States Senate	Senat Amerika Serikat
United States Virgin Islands	Kepulauan Virgin Amerika Serikat
United States dollar	Dolar Amerika Serikat
Universe	Alam semesta
University	Universitas
University of Pennsylvania	Universitas Pennsylvania
Unix	Unix
Unix	Kategori:Unix
Ununbium	Ununbium
Upanishad	Upanisad
Uppsala	Uppsala
Uracil	Urasil
Ural Mountains	Pegunungan Ural
Uranium	Uranium
Uranus	Uranus
Uranus (mythology)	Uranus (mitologi)
Urdu	Bahasa Urdu
Urea	Urea
Urine	Urin
Ursa Major	Ursa Major
Ursa Minor	Ursa Minor
Uruguay	Uruguay
Uruguay	Kategori:Uruguay
Utah	Utah
Utah	Kategori:Utah
Uterus	Rahim (anatomi)
Utopia	Utopia
Utrecht (city)	Utrecht
Utrecht (province)	Provinsi Utrecht
Uttar Pradesh	Uttar Pradesh
Uzbekistan	Uzbekistan
Uzbekistan	Kategori:Uzbekistan
Vaccine	Vaksin
Vacuole	Vakuola
Vacuum tube	Tabung vakum
Vaduz	Vaduz
Vagina	Vagina
Valence	Valence, Drôme
Valencia	Valencia
Valencia	Valencia (disambiguasi)
Valentina Tereshkova	Valentina Tereshkova
Valentine's Day	Hari Valentine
Valkyrie	Valkyrie
Valletta	Valletta
Valley	Lembah
Vampire	Vampir
Vanadium	Vanadium
Vancouver	Vancouver
Vancouver Island	Pulau Vancouver
Vanir	Vanir
Vanuatu	Vanuatu
Vanuatu	Kategori:Vanuatu
Var (department)	Var (departemen)
Variance	Varians
Varna	Varna
Vatican City	Vatikan
Vatican City	Kategori:Vatikan
Vector (spatial)	Vektor (spasial)
Vega	Vega
Vegetable	Sayur
Vegetarianism	Vegetarian
Vein	Pembuluh balik
Vela (constellation)	Vela
Velociraptor	Velociraptor
Veneto	Veneto
Venezuela	Venezuela
Venezuela	Kategori:Venezuela
Venice	Venesia
Venus	Venus
Venus (mythology)	Venus (mitologi)
Verb	Verba
Vermont	Vermont
Vermont	Kategori:Vermont
Verona	Verona
Versailles	Versailles
Vertebra	Tulang punggung
Vertebrate	Vertebrata
Veto	Hak veto
Vice President of the United States	Daftar wakil presiden Amerika Serikat
Vichy	Vichy
Victor Hugo	Victor Hugo
Victoria	Victoria, Seychelles
Victoria	Victoria, British Columbia
Victoria	Victoria
Victoria (Australia)	Victoria, Australia
Victoria Falls	Air terjun Victoria
Video	Video
Vienna	Wina
Vienne	Vienne (departemen)
Vientiane	Vientiane
Vietnam	Vietnam
Vietnam	Kategori:Vietnam
Vietnam War	Perang Vietnam
Vietnam War	Kategori:Perang Vietnam
Viking	Viking
Village	Desa
Vilnius	Vilnius
Vincent van Gogh	Vincent van Gogh
Violence	Kekerasan
Violin	Biola
Virgil	Publius Vergilius Maro
Virginia	Virginia
Virginia	Kategori:Virginia
Virginia Woolf	Virginia Woolf
Virginity	Perawan
Virgo (constellation)	Virgo
Virtual memory	Memori virtual
Virtual reality	Realitas maya
Virus	Virus
Viscosity	Viskositas
Vishnu	Wisnu
Vistula	Sungai Vistula
Vitamin	Vitamin
Vitamin A	Retinol
Vitamin C	Vitamin C
Vitamin D	Vitamin D
Vitamin K	Vitamin K
Vittorio De Sica	Vittorio De Sica
Vivien Leigh	Vivien Leigh
Vladimir Lenin	Vladimir Lenin
Vladimir Nabokov	Vladimir Nabokov
Vladimir Putin	Vladimir Putin
Vladivostok	Vladivostok
Vodka	Vodka
Volcano	Gunung berapi
Volcanology	Vulkanologi
Volga River	Sungai Volga
Volgograd	Volgograd
Volleyball	Bola voli
Volleyball	Kategori:Bola voli
Volt	Volt
Voltage	Tegangan listrik
Voltaire	Voltaire
Volume	Volume
Voodoo	Voodoo
Vulgar Latin	Bahasa Latin Rakyat
Vulgate	Vulgata
Vulpecula	Vulpecula
Wahhabism	Wahhabi
Wake Island	Pulau Wake
Wales	Wales
Wales	Kategori:Wales
Walt Disney	Walt Disney
War	Perang
War	Kategori:Perang
War crime	Kejahatan perang
Wars of the Roses	Perang Mawar
Warsaw	Warsawa
Washing machine	Mesin cuci
Washington	Washington, DC
Washington	Washington
Washington	Kategori:Washington
Washington (disambiguation)	Washington (disambiguasi)
Waste	Sampah
Water	Air
Water	Kategori:Air
Water polo	Polo air
Waterfall	Air terjun
Watergate scandal	Skandal Watergate
Watermelon	Semangka
Watt	Watt
Wave	Gelombang
Wavelength	Panjang gelombang
Weak interaction	Gaya nuklir lemah
Weapon	Senjata
Weather	Cuaca
Web browser	Penjelajah web
Web page	Situs web
Webcam	Webcam
Website	Situs web
Wednesday	Rabu
Week	Pekan
Weight	Berat
Weightlifting	Angkat besi
Weimar	Weimar
Weimar Republic	Republik Weimar
Wellington	Wellington
Werewolf	Manusia serigala
West Africa	Afrika Barat
West Bank	Tepi Barat
West Bengal	Benggala Barat
West Berlin	Berlin Barat
West Germany	Jerman Barat
West Sussex	West Sussex
West Virginia	West Virginia
West Virginia	Kategori:Virginia Barat
Western Australia	Australia Barat
Western Roman Empire	Kekaisaran Romawi Barat
Western Sahara	Sahara Barat
Westminster Abbey	Westminster Abbey
Whale	Paus (mamalia)
Wheat	Gandum
Wheel	Roda
Whisky	Wiski
White House	Gedung Putih
White Sea	Laut Putih
White blood cell	Sel darah putih
Whitehorse	Whitehorse, Yukon
Wide area network	WAN
Wiesbaden	Wiesbaden
Wildcat	Kucing liar
William Faulkner	William Faulkner
William Gladstone	William Ewart Gladstone
William Golding	William Golding
William Harvey	William Harvey
William Henry Harrison	William Henry Harrison
William Herschel	William Herschel
William Howard Taft	William Howard Taft
William II	Wilhelm II
William McKinley	William McKinley
William Shakespeare	William Shakespeare
William Shockley	William Shockley
William Wordsworth	William Wordsworth
William of Ockham	William Ockham
Willow	Dedalu
Willy Brandt	Willy Brandt
Wind instrument	Alat musik tiup
Wind power	Tenaga angin
Windhoek	Windhoek
Windmill	Kincir angin
Window	Jendela
Wine	Anggur (minuman)
Winnipeg	Winnipeg, Manitoba
Winston Churchill	Winston Churchill
Winter	Musim dingin
Winter Olympic Games	Olimpiade Musim Dingin
Winter Olympic Games	Kategori:Olimpiade Musim Dingin
Wisconsin	Wisconsin
Wisconsin	Kategori:Wisconsin
Wolfgang Amadeus Mozart	Wolfgang Amadeus Mozart
Wolfgang Pauli	Wolfgang Pauli
Woman	Wanita
Wood	Kayu
Woodrow Wilson	Woodrow Wilson
Woodwind instrument	Alat musik tiup kayu
Woody Allen	Woody Allen
Worcestershire	Worcestershire
Word	Kata
Word processor	Pengolah kata
World Bank	Bank Dunia
World Health Organization	Organisasi Kesehatan Dunia
World Trade Center	World Trade Center
World Trade Organization	Organisasi Perdagangan Dunia
World War I	Perang Dunia I
World War I	Kategori:Perang Dunia I
World War II	Perang Dunia II
World War II	Kategori:Perang Dunia II
World Wide Web	World Wide Web
World Wide Web	Kategori:WWW
World war	Perang dunia
Wuhan	Wuhan
Wyoming	Wyoming
Wyoming	Kategori:Wyoming
X-ray	Sinar-X
Xenon	Xenon
Xenophobia	Xenofobia
Xi	Xi
Xinjiang	Xinjiang
Xylophone	Silofon
Yahweh	Tetragrammaton
Yak	Yak
Yakuza	Yakuza
Yale University	Universitas Yale
Yalta Conference	Konferensi Yalta
Yangon	Yangon
Yangtze River	Sungai Panjang
Yard	Yard
Yasser Arafat	Yasser Arafat
Year	Tahun
Years	Kategori:Tahun
Yeast	Khamir
Yellow	Kuning
Yellow River	Sungai Kuning
Yellow Sea	Laut Kuning
Yellowstone National Park	Taman Nasional Yellowstone
Yemen	Yaman
Yemen	Kategori:Yaman
Yerevan	Yerevan
Yeti	Yeti
Yggdrasil	Yggdrasil
Yo-yo	Yo-yo
Yoga	Yoga
Yoghurt	Yoghurt
Yoko Ono	Yoko Ono
Yokohama	Yokohama
Yom Kippur	Yom Kippur
Yom Kippur War	Perang Yom Kippur
York	York, Inggris
Ytterbium	Iterbium
Yttrium	Itrium
Yuan Dynasty	Dinasti Yuan
Yugoslavia	Yugoslavia
Yugoslavia	Kategori:Yugoslavia
Yukon	Yukon
Yunnan	Yunnan
Yuri Gagarin	Yuri Alekseyevich Gagarin
Zachary Taylor	Zachary Taylor
Zagreb	Zagreb
Zambezi	Sungai Zambezi
Zambia	Zambia
Zambia	Kategori:Zambia
Zanzibar	Zanzibar
Zaragoza	Zaragoza
Zealand	Sjælland
Zebra	Zebra
Zen	Zen
Zenith	Zenith
Zeno (emperor)	Zeno (kaisar)
Zeta	Zeta
Zeus	Zeus
Zeus (disambiguation)	Zeus
Ziggurat	Ziggurat
Zimbabwe	Zimbabwe
Zimbabwe	Kategori:Zimbabwe
Zinc	Seng
Zionism	Zionisme
Zirconium	Zirkonium
Zodiac	Zodiak
Zombie	Zombie
Zoo	Kebun binatang
Zoology	Zoologi
Zoology	Kategori:Zoologi
Zoroaster	Zarathustra
Zoroastrianism	Zoroastrianisme
