Greek	English
Μηδέν	0 (number)
1	1
10	10
100	100
1000	1000
101	101
105	105
11	11
110	110
115	115
12	12
120	120
125	125
13	13
130	130
135	135
14	14
140	140
144	144
145	145
15	15
150	150
155	155
16	16
160	160
165	165
17	17
170	170
1728	1728
175	175
18	18
180	180
Κατηγορία:Δεκαετία 1870	1870s
Κατηγορία:Δεκαετία 1880	1880s
Κατηγορία:Δεκαετία 1890	1890s
19	19
190	190
Δεκαετία 1900	1900s
Κατηγορία:Δεκαετία 1900	1900s
Δεκαετία 1920	1920s
Κατηγορία:Δεκαετία 1920	1920s
Δεκαετία 1930	1930s
Κατηγορία:Δεκαετία 1930	1930s
Δεκαετία 1940	1940s
Κατηγορία:Δεκαετία 1940	1940s
Δεκαετία 1950	1950s
Κατηγορία:Δεκαετία 1950	1950s
Δεκαετία 1960	1960s
Κατηγορία:Δεκαετία 1960	1960s
Δεκαετία 1970	1970s
Κατηγορία:Δεκαετία 1970	1970s
Δεκαετία 1980	1980s
Κατηγορία:Δεκαετία 1980	1980s
Δεκαετία 1990	1990s
Κατηγορία:Δεκαετία 1990	1990s
2	2
20	20
200	200
21	21
22	22
23	23
24	24
24 (τηλεοπτική σειρά)	24 (TV series)
25	25
26	26
27	27
28	28
29	29
3	3
30	30
300	300
31	31
32	32
33	33
34	34
35	35
36	36
37	37
38	38
39	39
4	4
40	40
400	400
41	41
42	42
43	43
44	44
45	45
46	46
47	47
48	48
49	49
5	5
50	50
500	500
51	51
52	52
53	53
54	54
55	55
56	56
57	57
58	58
59	59
6	6
60	60
61	61
62	62
63	63
64	64
65	65
66	66
67	67
68	68
69	69
7	7
Seven	7 (number)
70	70
71	71
72	72
73	73
74	74
75	75
76	76
77	77
78	78
79	79
8	8
80	80
81	81
82	82
83	83
84	84
85	85
86	86
87	87
88	88
89	89
9	9
90	90
91	91
92	92
93	93
94	94
95	95
96	96
97	97
98	98
99	99
A	A
ABC	ABC
AIDS	AIDS
Άαχεν	Aachen
Άλμπορκ	Aalborg
Άαρ	Aar
Ώρχους	Aarhus
Ααρών	Aaron
Άβακας	Abacus
Αββάς	Abbot
Συντομογραφία	Abbreviation
Άμπελ Τάσμαν	Abel Tasman
Αβελιανή ομάδα	Abelian group
Αμπερντήν	Aberdeen
Αμπχαζία	Abkhazia
Κατηγορία:Αμπχαζία	Abkhazia
Έκτρωση	Abortion
Αβραάμ	Abraham
Αβραάμ Λίνκολν	Abraham Lincoln
Απόλυτο μηδέν	Absolute zero
Απολυταρχία	Absolutism (European history)
Αφηρημένη τέχνη	Abstract art
Αφηρημένος Εξπρεσιονισμός	Abstract expressionism
Ακακία	Acacia
Όσκαρ	Academy Award
Επιτάχυνση	Acceleration
Λογιστική	Accountancy
Κατηγορία:Λογιστική	Accountancy
Άκρα	Accra
Αιτιατική	Accusative case
Οξικό οξύ	Acetic acid
Ακετόνη	Acetone
Ακετυλοχολίνη	Acetylcholine
Αιθίνιο	Acetylene
Αχέρων	Acheron
Αχιλλέας	Achilles
Οξύ	Acid
Ακμή	Acne vulgaris
Ακουστική	Acoustics
Έικρ	Acre
Αντιόχεια (της Πτολεμαΐδος)	Acre
Ακτινίδες	Actinide
Ακτίνιο	Actinium
Ηθοποιός	Actor
Ad hominem	Ad hominem
Ada	Ada (programming language)
Αδάμ	Adam
Άνταμ Σμιθ	Adam Smith
Άδανα	Adana
Αδανσονία	Adansonia
Αντίς Αμπέμπα	Addis Ababa
Άθροιση	Addition
Αδελαΐδα	Adelaide
Αδενίνη	Adenine
Αδιαβατική μεταβολή	Adiabatic process
Άντολφ Άιχμαν	Adolf Eichmann
Αδόλφος Χίτλερ	Adolf Hitler
Άδωνις	Adonis
Αδριατική θάλασσα	Adriatic Sea
Σαρανταήμερο (νηστεία)	Advent
Διαφήμιση	Advertising
Αιγαίο Πέλαγος	Aegean Sea
Αινείας	Aeneas
Αίολος (μυθολογία)	Aeolus
Αεροδυναμική	Aerodynamics
Αισχύλος	Aeschylus
Αίσωπος	Aesop
Αισθητική	Aesthetics
Αφγανιστάν	Afghanistan
Κατηγορία:Αφγανιστάν	Afghanistan
Αφρική	Africa
Κατηγορία:Αφρική	Africa
Αφρικάανς γλώσσα	Afrikaans
Αγαμέμνονας	Agamemnon
Άγαρ	Agar
Αγκάθα Κρίστι	Agatha Christie
Αγνωστικισμός	Agnosticism
Αρχαία Αγορά	Agora
Αγοραφοβία	Agoraphobia
Άγκρα	Agra
Αγκριτζέντο	Agrigento
Αϊκίντο	Aikido
Airbus	Airbus
Κατηγορία:Αεροσκάφη	Aircraft
Αεροπλανοφόρο	Aircraft carrier
Αεροδρόμιο	Airport
Ακενατόν	Akhenaten
Ακίρα Κουροσάβα	Akira Kurosawa
Αλ Καπόνε	Al Capone
Αλ Γκορ	Al Gore
Αλ Κάιντα	Al-Qaeda
Αλαμπάμα	Alabama
Άλαν Τούρινγκ	Alan Turing
Αλανίνη	Alanine
Αλάσκα	Alaska
Κατηγορία:Αλάσκα	Alaska
Αλβανία	Albania
Κατηγορία:Αλβανία	Albania
Λευκαύγεια	Albedo
Αλμπέρ Καμύ	Albert Camus
Άλμπερτ Αϊνστάιν	Albert Einstein
Άλμπερτ Σβάιτσερ	Albert Schweitzer
Άλμπερτ Σπέερ	Albert Speer
Αλμπέρτα	Alberta
Άλμπουμ	Album
Αλχημεία	Alchemy
Αλντεμπαράν	Aldebaran
Άλεκ Γκίνες	Alec Guinness
Αλέξανδρος	Alexander
Αλεξάντερ Γκράχαμ Μπελ	Alexander Graham Bell
Αλέξανδρος Πούσκιν	Alexander Pushkin
Αλέξανδρος ο Μέγας	Alexander the Great
Αλέξανδρος Δουμάς (πατέρας)	Alexandre Dumas
Αλεξάνδρεια	Alexandria
Άλφρεντ Χίτσκοκ	Alfred Hitchcock
Άλφρεντ Νομπέλ	Alfred Nobel
Άλφρεντ Ράσελ Γουάλας	Alfred Russel Wallace
Αλφρέδος του Ουέσσεξ	Alfred the Great
Φύκη	Algae
Άλγεβρα	Algebra
Κατηγορία:Άλγεβρα	Algebra
Αλγεβρικός αριθμός	Algebraic number
Αλγερία	Algeria
Κατηγορία:Αλγερία	Algeria
Αλγέρι	Algiers
Αλγόριθμος	Algorithm
Αλάμπρα	Alhambra
Αλκάλια	Alkali metal
Αλκάνια	Alkane
Αλκένια	Alkene
Αλκίνιο	Alkyne
Αλληγορία	Allegory
Άλλεν Γκίνσμπεργκ	Allen Ginsberg
Αλλόσαυρος	Allosaurus
Αλλότροπα	Allotropy
Κράμα	Alloy
Αλμανάκ	Almanac
Άλφα	Alpha (letter)
Αλφάβητο	Alphabet
Άλπεις	Alps
Αλσατία	Alsace
Εναλλασσόμενο ρεύμα	Alternating current
Εναλλακτική ιατρική	Alternative medicine
Αργίλιο	Aluminium
Αλβάρ Αάλτο	Alvar Aalto
Αμαζόνιος	Amazon River
Κεχριμπάρι	Amber
Αμβρόσιος Μεδιολάνων	Ambrose
Αμεντέο Αβογκάντρο	Amedeo Avogadro
Αμέλια Έρχαρτ	Amelia Earhart
Αμερικανικός Εμφύλιος Πόλεμος	American Civil War
Αμερικανική Σαμόα	American Samoa
ASCII	American Standard Code for Information Interchange
Αμερίκιο	Americium
Αμέριγκο Βεσπούκι	Amerigo Vespucci
Αμέθυστος	Amethyst
Αμινοξύ	Amino acid
Αμμάν	Amman
Αμπερόμετρο	Ammeter
Αμμωνία	Ammonia
Αμνηστία	Amnesty
Αμπέρ (μονάδα μέτρησης)	Ampere
Αμφεταμίνη	Amphetamine
Αμφίβια	Amphibian
Αμφιθέατρο	Amphitheatre
Αμφορέας	Amphora
Άμστερνταμ	Amsterdam
Κατηγορία:Άμστερνταμ	Amsterdam
Άμων	Amun
Αναβαπτιστές	Anabaptist
Αναρχισμός	Anarchism
Κατηγορία:Αναρχισμός	Anarchism
Κατηγορία:Ανατομία	Anatomy
Ανατομία	Anatomy
Αναξαγόρας	Anaxagoras
Αναξίμανδρος	Anaximander
Άγκυρα πλοίου	Anchor
Αρχαία ελληνική γλώσσα	Ancient Greek
Κατηγορία:Αρχαία ιστορία	Ancient history
Ανδαλουσία	Andalusia
Άνδεις	Andes
Ανδόρρα	Andorra
Κατηγορία:Ανδόρρα	Andorra
Αντρέι Ζαχάρωφ	Andrei Sakharov
Αντρέι Ταρκόφσκι	Andrei Tarkovsky
Ανδρομέδα	Andromeda
Ανδρομέδα (αστερισμός)	Andromeda (constellation)
Ανδρομέδα (μυθολογία)	Andromeda (mythology)
Γαλαξίας της Ανδρομέδας	Andromeda Galaxy
Αναιμία	Anemia
Άγγελος	Angel
Γωνία	Angle
Αγκόλα	Angola
Κατηγορία:Αγκόλα	Angola
Ανγκουίλα	Anguilla
Στροφορμή	Angular momentum
Ζώο	Animal
Κτηνοτροφία	Animal husbandry
Anime	Anime
Ανιμισμός	Animism
Άγκυρα	Ankara
Άννα Μπολέυν	Anne Boleyn
Ευαγγελισμός της Θεοτόκου	Annunciation
Μυρμήγκι	Ant
Αντιόχεια	Antakya
Αττάλεια	Antalya
Ανταναναρίβο	Antananarivo
Ανταρκτική	Antarctica
Κατηγορία:Ανταρκτική	Antarctica
Αντάρης	Antares
Άντονυ Χόπκινς	Anthony Hopkins
Ανθρωπολογία	Anthropology
Κατηγορία:Ανθρωπολογία	Anthropology
Αντιβιoτικό	Antibiotic
Αντίχριστος	Antichrist
Υψηλό Βαρομετρικό	Anticyclone
Αντιγόνο	Antigen
Αντιγόνη (μυθολογία)	Antigone
Αντίγκουα και Μπαρμπούντα	Antigua and Barbuda
Κατηγορία:Αντίγκουα και Μπαρμπούντα	Antigua and Barbuda
Αντιύλη	Antimatter
Αντιμόνιο	Antimony
Αντισημιτισμός	Antisemitism
Κατηγορία:Αντισημιτισμός	Antisemitism
Αντλία (αστερισμός)	Antlia
Αντουάν Λωράν Λαβουαζιέ	Antoine Lavoisier
Άντον Μπρούκνερ	Anton Bruckner
Αντόν Τσέχωφ	Anton Chekhov
Αντόνιο Βιβάλντι	Antonio Vivaldi
Αμβέρσα	Antwerp
Αμβέρσα (επαρχία)	Antwerp (province)
Άνουβις	Anubis
Αορτή	Aorta
Αφροδίτη (μυθολογία)	Aphrodite
Άπια	Apia
Απόκρυφα	Apocrypha
Απόλλων	Apollo
Μήλο	Apple
Βερικοκιά	Apricot
Απρίλιος	April
14 Απριλίου	April 14
Πρωταπριλιά	April Fools' Day
Απουλία	Apulia
Πτηνόν	Apus
Άκαμπα	Aqaba
Βασιλικό Ύδωρ	Aqua regia
Υδροχόος (αστερισμός)	Aquarius (constellation)
Υδραγωγείο	Aqueduct
Αετός (αστερισμός)	Aquila (constellation)
Ακουιτανία	Aquitaine
Βωμός (αστερισμός)	Ara (constellation)
Αραβικός Σύνδεσμος	Arab League
Αραβία	Arabian Peninsula
Αραβικό αλφάβητο	Arabic alphabet
Αραβική γλώσσα	Arabic language
Αραγωνία	Aragon
Αράλη	Aral Sea
Άραμ Χατσατουριάν	Aram Khachaturian
Νομός Αρκαδίας	Arcadia
Αρκάντζελο Κορέλι	Arcangelo Corelli
Αρχαιολογία	Archaeology
Κατηγορία:Αρχαιολογία	Archaeology
Αρχιεπίσκοπος	Archbishop
Αρχαιοζωικός αιώνας	Archean
Αρχιμήδης	Archimedes
Αρχιπέλαγος	Archipelago
Αρχιτεκτονική	Architecture
Κατηγορία:Αρχιτεκτονική	Architecture
Αρκτική	Arctic
Αρκτικός Κύκλος	Arctic Circle
Αρκτικός Ωκεανός	Arctic Ocean
Αρκτική αλεπού	Arctic fox
Έκταση	Area
Άρης (μυθολογία)	Ares
Αργεντινή	Argentina
Κατηγορία:Αργεντινή	Argentina
Αργό	Argon
Άργος	Argos
Άρια	Aria
Αριάδνη	Ariadne
Αρειανισμός	Arianism
Κριός (αστερισμός)	Aries (constellation)
Αρίσταρχος ο Σάμιος	Aristarchus of Samos
Αριστοφάνης	Aristophanes
Αριστοτέλης	Aristotle
Αριθμητική	Arithmetic
Άρειος	Arius
Αριζόνα	Arizona
Κιβωτός της Διαθήκης	Ark of the Covenant
Αρλ	Arles
Αρμαντίλλο	Armadillo
Αρμενία	Armenia
Κατηγορία:Αρμενία	Armenia
Αρμενική γλώσσα	Armenian language
Στρατός	Army
Βέλος (όπλο)	Arrow
Αρσενικό (χημικό στοιχείο)	Arsenic
Τέχνη	Art
Κατηγορία:Ιστορία της τέχνης	Art history
Άρτεμις	Artemis
Αρτηρία	Artery
Ουρική αρθρίτιδα	Arthritis
Αρθρόποδα	Arthropod
Αρθούρος Ρεμπώ	Arthur Rimbaud
Αρθούρος Σοπενχάουερ	Arthur Schopenhauer
Τεχνητή νοημοσύνη	Artificial intelligence
Κατηγορία:Τεχνητή νοημοσύνη	Artificial intelligence
Πυροβολικό	Artillery
Κατηγορία:Τέχνες	Arts
Αρούμπα	Aruba
Κατηγορία:Αρούμπα	Aruba
Αμίαντος	Asbestos
Ασκληπιός	Asclepius
Άσγκαρντ	Asgard
Ασία	Asia
Κατηγορία:Ασία	Asia
Ασμάρα	Asmara
Άσφαλτος	Asphalt
Ασπιρίνη	Aspirin
Assembly (γλώσσα προγραμματισμού)	Assembly language
Ένωση Χωρών της Νοτιοανατολικής Ασίας	Association of Southeast Asian Nations
Ασσυρία	Assyria
Κατηγορία:Ασσυρία	Assyria
Άστατο	Astatine
Αστεροειδής	Asteroid
Ασθενόσφαιρα	Asthenosphere
Άσθμα	Asthma
Άστραχαν	Astrakhan
Βιοαστρονομία	Astrobiology
Αστρολάβος	Astrolabe
Αστρολογία	Astrology
Αστρομετρία	Astrometry
Αστρονομική μονάδα	Astronomical unit
Αστρονομία	Astronomy
Κατηγορία:Αστρονομία	Astronomy
Αστροφυσική	Astrophysics
Κατηγορία:Αστροφυσική	Astrophysics
Ασσουάν	Aswan
Ατακάμα	Atacama Desert
Ατέν	Aten
Αθηνά	Athena
Αθήνα	Athens
Στίβος	Athletics (track and field)
Ατλάντα	Atlanta
Ατλαντικός Ωκεανός	Atlantic Ocean
Κατηγορία:Ατλαντικός Ωκεανός	Atlantic Ocean
Ατλαντίδα	Atlantis
Άτλας	Atlas (disambiguation)
Άτλας (δορυφόρος)	Atlas (moon)
Άτλας (μυθολογία)	Atlas (mythology)
Ατμόσφαιρα (μονάδα)	Atmosphere (unit)
Ατμοσφαιρική πίεση	Atmospheric pressure
Ατόλη	Atoll
Άτομο	Atom
Ατομικό βάρος	Atomic mass
Ατομικός αριθμός	Atomic number
Ατομική Φυσική	Atomic physics
Ατρέας	Atreus
Αττική	Attica
Αττίλας	Attila the Hun
AU	Au
Ώκλαντ	Auckland
Αύγουστος	August
1 Αυγούστου	August 1
15 Αυγούστου	August 15
6 Αυγούστου	August 6
Αύγουστος Κοντ	Auguste Comte
Αύγουστος Ροντέν	Auguste Rodin
Αυγουστίνος Ιππώνος	Augustine of Hippo
Ηνίοχος (αστερισμός)	Auriga (constellation)
Σέλας	Aurora (astronomy)
Ώστιν	Austin
Αυστραλασία	Australasia
Αυστραλία	Australia
Κατηγορία:Αυστραλία	Australia
Αυστρία	Austria
Κατηγορία:Αυστρία	Austria
Αυστροουγγαρία	Austria-Hungary
Συγγραφέας	Author
Αυτισμός	Autism
Αυτοκίνητο	Automobile
Φθινόπωρο	Autumn
Αβατάρ	Avatar
Αβερρόης	Averroes
Αβέστα	Avesta
Κατηγορία:Αεροπορία	Aviation
Αβικέννας	Avicenna
Αβινιόν	Avignon
Αβοκάντο	Avocado
Υπόθεση Αβογκάντρο	Avogadro's law
Αζερμπαϊτζάν	Azerbaijan
Κατηγορία:Αζερμπαϊτζάν	Azerbaijan
Αζιμούθιο	Azimuth
Αζόρες	Azores
Αζτέκοι	Aztec
Αζουρίτης	Azurite
B	B
BASIC	BASIC
Βαβυλώνα	Babylon
Τάβλι	Backgammon
Βακτήριο	Bacteria
Φάγος	Bacteriophage
Αντιπτέριση	Badminton
Βαγδάτη	Baghdad
Κατηγορία:Μπαχάμες	Bahamas
Μπαχρέιν	Bahrain
Κατηγορία:Μπαχρέιν	Bahrain
Μπακλαβάς	Baklava
Μπακού	Baku
Μπαλαλάικα	Balalaika
Μπαλντρ	Baldr
Βαλεαρίδες Νήσοι	Balearic Islands
Μπαλί	Bali
Βαλκανικοί πόλεμοι	Balkan Wars
Βαλκάνια	Balkans
Μπάλα	Ball
Βαλτική Θάλασσα	Baltic Sea
Βαλτιμόρη	Baltimore
Μπαμπού	Bamboo
Μπανάνα	Banana
Μπανανία	Banana republic
Μπανγκόκ	Bangkok
Μπανγκλαντές	Bangladesh
Κατηγορία:Μπανγκλαντές	Bangladesh
Τράπεζα	Bank
Χαρτονόμισμα	Banknote
Βάπτισμα (Χριστιανισμός)	Baptism
Βαρομετρική μονάδα	Bar (unit)
Μπαρμπάντος	Barbados
Κατηγορία:Μπαρμπάντος	Barbados
Βάρβαροι	Barbarian
Βαρκελώνη	Barcelona
Κατηγορία:Βαρκελώνη	Barcelona
Θάλασσα Μπάρεντς	Barents Sea
Μπάρι	Bari
Βάριο	Barium
Βαρόμετρο	Barometer
Μπαρόκ	Baroque
Βαρυόνιο	Baryon
Βάση	Base (chemistry)
Κατηγορία:Μπέιζμπολ	Baseball
Βασιλεία (Ελβετία)	Basel
Βασιλικός	Basil
Βασίλειος Καισαρείας	Basil of Caesarea
Ρυθμός της Βασιλικής	Basilica
Φλάβιος Βασιλίσκος	Basiliscus
Καλαθοσφαίριση	Basketball
Κατηγορία:Καλαθοσφαίριση	Basketball
Φαγκότο	Bassoon
Βαστίλη	Bastille
Μπάτμαν	Batman
Μπαταρία	Battery (electricity)
Ναυμαχία της Ναυπάκτου	Battle of Lepanto (1571)
Μάχη του Μαραθώνα	Battle of Marathon
Μάχη των Θερμοπυλών	Battle of Thermopylae
Ναυμαχία του Τραφάλγκαρ	Battle of Trafalgar
Μάχη του Βερντέν	Battle of Verdun
Μάχη των Αρδεννών	Battle of the Bulge
Μάχη του Σομμ	Battle of the Somme
Μπάουχαους	Bauhaus
Βωξίτης	Bauxite
Βαυαρία	Bavaria
Κατηγορία:Βαυαρία	Bavaria
Δάφνη (φυτό)	Bay Laurel
Βισκαϊκός κόλπος	Bay of Biscay
Παραλία	Beach
Αρκούδα	Bear
Θάλασσα Μποφόρ	Beaufort Sea
Κλίμακα Μποφόρ	Beaufort scale
Μπίμποπ	Bebop
Κρεβάτι	Bed
Βεδουίνοι	Bedouin
Μέλισσα	Bee
Οξιά	Beech
Μπίρα	Beer
Κολεόπτερα	Beetle
Πεκίνο	Beijing
Βηρυτός	Beirut
Λευκορωσία	Belarus
Κατηγορία:Λευκορωσία	Belarus
Μπέλφαστ	Belfast
Βέλγιο	Belgium
Κατηγορία:Βέλγιο	Belgium
Βελιγράδι	Belgrade
Μπελίζε	Belize
Κατηγορία:Μπελίζε	Belize
Βελλεροφόντης	Bellerophon
Χορός οριεντάλ	Belly dance
Μπενελούξ	Benelux
Βεγγάζη	Benghazi
Μπενίν	Benin
Κατηγορία:Μπενίν	Benin
Μπενίτο Μουσολίνι	Benito Mussolini
Βενιαμίν Φραγκλίνος	Benjamin Franklin
Μπέογουλφ (έπος)	Beowulf
Βερίγγειος Πορθμός	Bering Strait
Μπερκέλιο	Berkelium
Μπέρκσαϊρ	Berkshire
Βερολίνο	Berlin
Κατηγορία:Βερολίνο	Berlin
Βερμούδες	Bermuda
Κατηγορία:Βερμούδες	Bermuda
Βέρνη	Berne
Μπέρναρντ Ρίμαν	Bernhard Riemann
Μούρο	Berry
Μπέρτολτ Μπρεχτ	Bertolt Brecht
Μπέρτραντ Ράσελ	Bertrand Russell
Βηρύλλιο	Beryllium
Βήτα	Beta (letter)
Διάσπαση βήτα	Beta decay
Βηθλεέμ	Bethlehem
Μπέτι Ντέιβις	Bette Davis
Μπέης	Bey
Μπουτάν	Bhutan
Αγία Γραφή	Bible
Κατηγορία:Βίβλος	Bible
Ποδήλατο	Bicycle
Μεγάλη έκρηξη	Big Bang
Χολή	Bile
Μπιλ Κλίντον	Bill Clinton
Μπιλ Γκέιτς	Bill Gates
Βιοχημεία	Biochemistry
Κατηγορία:Βιοχημεία	Biochemistry
Βιοποικιλότητα	Biodiversity
Βιογεωγραφία	Biogeography
Βιολογία	Biology
Κατηγορία:Βιολογία	Biology
Βιομάζα	Biomass
Βιοφυσική	Biophysics
Βιόσφαιρα	Biosphere
Βιοτεχνολογία	Biotechnology
Διπολική διαταραχή	Bipolar disorder
Σημύδα	Birch
Αμφιφυλοφιλία	Bisexuality
Επίσκοπος	Bishop
Αξιωματικός (σκάκι)	Bishop (chess)
Βισμούθιο	Bismuth
Μπισσάου	Bissau
Bit	Bit
Βιθυνία	Bithynia
Μαύρο	Black
Μαύρη Πανώλη	Black Death
Μέλανας Δρυμός	Black Forest
Μαύρη Θάλασσα	Black Sea
Μαυροπελαργός	Black Stork
Μέλαν σώμα	Black body
Μαύρη τρύπα	Black hole
Μπλουμφοντέιν	Bloemfontein
Ιστολόγιο	Blog
Αίμα	Blood
Μπλε	Blue
Μπλουζ	Blues
Αγριόχοιρος	Boar
Επιτραπέζιο	Board game
Λέμβος	Boat
Μπομπ Ντίλαν	Bob Dylan
Μπόμπι Φίσερ	Bobby Fischer
Σωματοδόμηση	Bodybuilding
Βοημία	Bohemia
Μπόριο	Bohrium
Βολιβία	Bolivia
Κατηγορία:Βολιβία	Bolivia
Μπολόνια	Bologna
Μπολτζάνο	Bolzano
Βόμβα	Bomb
Ομόλογο	Bond (finance)
Οστό	Bone
Βόννη	Bonn
Βιβλίο	Book
Το Βιβλίο του Μόρμον	Book of Mormon
Αποκάλυψη του Ιωάννη	Book of Revelation
Μπορντό	Bordeaux
Μπαρίς Γκοντουνόβ	Boris Godunov
Μπορίς Παστερνάκ	Boris Pasternak
Μπόρις Σπάσκυ	Boris Spassky
Βόριο	Boron
Βοσνία και Ερζεγοβίνη	Bosnia and Herzegovina
Κατηγορία:Βοσνία και Ερζεγοβίνη	Bosnia and Herzegovina
Μποζόνιο	Boson
Βόσπορος	Bosporus
Βοστώνη	Boston
Βοτανικός Κήπος	Botanical garden
Βοτανική	Botany
Κατηγορία:Βοτανική	Botany
Μποτσουάνα	Botswana
Κατηγορία:Μποτσουάνα	Botswana
Φιάλη (δοχείο)	Bottle
Βουργουνδία	Bourgogne
Μπουβέ	Bouvet Island
Τόξο (όπλο)	Bow (weapon)
Μπόουλινγκ	Bowling
Κατηγορία:Πυγμάχοι	Boxers
Πυγμαχία	Boxing
Νόμος του Μπόιλ	Boyle's law
Μπράγκα	Braga
Σύστημα Μπράιγ	Braille
εγκέφαλος	Brain
Μπραμ Στόκερ	Bram Stoker
Βραδεμβούργο	Brandenburg
Ορείχαλκος	Brass
Μπρατισλάβα	Bratislava
Βραζιλία	Brazil
Κατηγορία:Βραζιλία	Brazil
Ψωμί	Bread
Βρέμη	Bremen
Βρέστη	Brest
Τούβλο	Brick
Γέφυρα	Bridge
Κατηγορία:Γέφυρες	Bridges
Μπριτζτάουν	Bridgetown
Μπρίντιζι	Brindisi
Βρετανική Κολομβία	British Columbia
Βρετανικά Νησιά	British Isles
Βρετανικές Παρθένοι Νήσοι	British Virgin Islands
Κατηγορία:Βρετανοί	British people
Μπρνο	Brno
Μπρόκολο	Broccoli
Βρώμιο	Bromine
Κρατέρωμα	Bronze
Εποχή του Χαλκού	Bronze Age
Καφέ αρκούδα	Brown Bear
Κίνηση Μπράουν	Brownian motion
Μπρους Λη	Bruce Lee
Μπριζ	Bruges
Μπρουνέι	Brunei
Κατηγορία:Μπρουνέι	Brunei
Βρυξέλλες	Brussels
Βουκουρέστι	Bucharest
Ανάκτορα του Μπάκιγχαμ	Buckingham Palace
Ρίτσαρτ Μπάκμινστερ Φύλλερ	Buckminster Fuller
Βουδαπέστη	Budapest
Βούδας	Buddha
Βουδισμός	Buddhism
Μπουένος Άιρες	Buenos Aires
Κτίριο	Building
Βουλγαρία	Bulgaria
Κατηγορία:Βουλγαρία	Bulgaria
Αρχή του Αρχιμήδη	Buoyancy
Δήμαρχος	Burgomaster
Μπουρκίνα Φάσο	Burkina Faso
Κατηγορία:Μπουρκίνα Φάσο	Burkina Faso
Μιανμάρ	Burma
Προύσα	Bursa
Κατηγορία:Μπουρούντι	Burundi
Λεωφορείο	Bus
Επιχείρηση	Business
Κατηγορία:Επιχειρηματίες	Businesspeople
Βουτάνιο	Butane
Φαινόμενο της πεταλούδας	Butterfly effect
Μπιντγκός	Bydgoszcz
Byte	Byte
Κατηγορία:Βυζαντινή Αυτοκρατορία	Byzantine Empire
C	C
C (γλώσσα προγραμματισμού)	C (programming language)
COBOL	COBOL
Κρυφή μνήμη ΚΜΕ	Cache
Κάδμιο	Cadmium
Κάδμος	Cadmus
Γλυφείον (αστερισμός)	Caelum
Καίσιο	Caesium
Κάιρο	Cairo
Καλαβρία	Calabria
Καλαί	Calais
Ασβέστιο	Calcium
Αριθμομηχανή	Calculator
Απειροστικός λογισμός	Calculus
Καλδέρα	Caldera
Ημερολόγιο	Calendar
Καλιφόρνια	California
Κατηγορία:Καλιφόρνια	California
Καλιφόρνιο	Californium
Χαλίφης	Caliph
Καλλιόπη (μυθολογία)	Calliope
Καλλιστώ (δορυφόρος)	Callisto (moon)
Καλλιστώ (μυθολογία)	Callisto (mythology)
Θερμίδα	Calorie
Γολγοθάς	Calvary
Καλυψώ	Calypso (mythology)
Καμπότζη	Cambodia
Κατηγορία:Καμπότζη	Cambodia
Κάμβρια περίοδος	Cambrian
Κέμπριτζ	Cambridge
Καμήλα	Camel
Φωτογραφική μηχανή	Camera
Καμερούν	Cameroon
Κατηγορία:Καμερούν	Cameroon
Καμπανία Ιταλίας	Campania
Καναδάς	Canada
Κατηγορία:Καναδάς	Canada
Κανάριες Νήσοι	Canary Islands
Κατηγορία:Κανάριες νήσοι	Canary Islands
Καμπέρα	Canberra
Καρκίνος	Cancer
Καρκίνος (αστερισμός)	Cancer (constellation)
Κύων Μέγας	Canis Major
Κύων Μικρός	Canis Minor
Κάνναβις	Cannabis
Κάννες	Cannes
Κάνωπος (αστέρας)	Canopus
Καντάτα	Cantata
Κνούτος	Canute the Great
Πυκνωτής	Capacitor
Κέιπ Τάουν	Cape Town
Πράσινο Ακρωτήριο	Cape Verde
Κατηγορία:Πράσινο Ακρωτήριο	Cape Verde
Πρωτεύουσα	Capital
Θανατική ποινή	Capital punishment
Καπιταλισμός	Capitalism
Καππαδοκία	Cappadocia
Αιγόκερως	Capricornus
Πιπεριά	Capsicum
Καράκας	Caracas
Καραβάτζιο	Caravaggio
Υδατάνθρακες	Carbohydrate
Άνθρακας	Carbon
Διοξείδιο του άνθρακα	Carbon dioxide
Εξαερωτήρας	Carburetor
Κάρντιφ	Cardiff
Καρδινάλιος	Cardinal (Catholicism)
Καραϊβική Θάλασσα	Caribbean Sea
Γελοιογραφία	Caricature
Τρόπις (αστερισμός)	Carina (constellation)
Καρλ Γκούσταβ Γιουνγκ	Carl Jung
Απόκριες	Carnival
Σαρκοφάγα	Carnivore
Κάρολος Λινναίος	Carolus Linnaeus
Καρπάθια Όρη	Carpathian Mountains
Καρότο	Carrot
Καρτεσιανό σύστημα συντεταγμένων	Cartesian coordinate system
Καρχηδόνα	Carthage
Χαρτογραφία	Cartography
Κατηγορία:Χαρτογραφία	Cartography
Καζαμπλάνκα	Casablanca
Καζίνο	Casino
Κασπία Θάλασσα	Caspian Sea
Κασσάνδρα	Cassandra
Κασσιόπη (αστερισμός)	Cassiopeia (constellation)
Χυτοσίδηρος	Cast iron
Ροκέ	Castling
Αφορμή πολέμου	Casus belli
Γάτα	Cat
Καταλωνία	Catalonia
Κατηγορία:Καταλωνία	Catalonia
Καταλύτης	Catalysis
Κατάφρακτος	Cataphract
Καύκασος	Caucasus
Κουνουπίδι	Cauliflower
Αιτιότητα	Causality
Σπήλαιο	Cave
Καγιέν	Cayenne
Νησιά Καϋμάν	Cayman Islands
Κέδρος	Cedar
Σέλινο	Celery
Ουράνιος ισημερινός	Celestial equator
Ουράνια μηχανική	Celestial mechanics
Ουράνια σφαίρα	Celestial sphere
Αγαμία (θρησκευτική)	Celibacy
Κύτταρο	Cell (biology)
Βιολοντσέλο	Cello
Νεκροταφείο	Cemetery
Απογραφή	Census
Κένταυρος	Centaur
Κένταυρος (αστερισμός)	Centaurus
Κέντρο μάζας	Center of mass
Εκατοστόμετρο	Centimetre
Κεντροαφρικανική Δημοκρατία	Central African Republic
Κατηγορία:Κεντροαφρικανική Δημοκρατία	Central African Republic
Κεντρική Αμερική	Central America
Κατηγορία:Κεντρική Αμερική	Central America
CIA	Central Intelligence Agency
Σέντραλ Παρκ	Central Park
Κεντρική Τράπεζα	Central bank
Κεντρική Μονάδα Επεξεργασίας	Central processing unit
Αιώνας	Century
Κηφεύς	Cepheus (constellation)
Κεραμική	Ceramic
Κέρβερος	Cerberus
1 Δήμητρα	Ceres (dwarf planet)
Κέρες	Ceres (mythology)
Δημήτριο	Cerium
Κητώδη	Cetacea
Κήτος (αστερισμός)	Cetus
Τσαντ	Chad
Κατηγορία:Τσαντ	Chad
Χαμαιλέων (αστερισμός)	Chamaeleon
Χάος (μυθολογία)	Chaos (mythology)
Καρλομάγνος	Charlemagne
Σαρλρουά	Charleroi
Κάρολος Μπωντλαίρ	Charles Baudelaire
Κάρολος Δαρβίνος	Charles Darwin
Σαρλ Φουριέ	Charles Fourier
Σαρλ ντε Γκωλ	Charles de Gaulle
Τσάρλι Τσάπλιν	Charlie Chaplin
Τσάρλι Πάρκερ	Charlie Parker
Οι Μάγισσες	Charmed
Χάρων (μυθολογία)	Charon (mythology)
Σωβινισμός	Chauvinism
Ερνέστο Τσε Γκεβάρα	Che Guevara
Κατηγορία:Δημοκρατία της Τσετσενίας	Chechnya
Τυρί	Cheese
Γατόπαρδος	Cheetah
Τσελιάμπινσκ	Chelyabinsk
Χημικός δεσμός	Chemical bond
Χημικό στοιχείο	Chemical element
Χημική αντίδραση	Chemical reaction
Χημεία	Chemistry
Κατηγορία:Χημεία	Chemistry
Κέμνιτς	Chemnitz
Χημειοθεραπεία	Chemotherapy
Επιταγή	Cheque
Κερασιά (φυτό)	Cherry
Χερουβείμ	Cherub
Σκάκι	Chess
Κατηγορία:Σκάκι	Chess
Καστανιά	Chestnut
Χι	Chi (letter)
Σικάγο	Chicago
Ρεβιθιά	Chickpea
Παιδί	Child
Γέννηση	Childbirth
Χιλή	Chile
Κατηγορία:Χιλή	Chile
Χίμαιρα (μυθολογία)	Chimera (mythology)
Κατηγορία:Κίνα	China
Χίος	Chios
Χείρων	Chiron
Χιτίνη	Chitin
Χλώριο	Chlorine
Χλωροφύλλη	Chlorophyll
Σοκολάτα	Chocolate
Χολέρα	Cholera
Χοληστερίνη	Cholesterol
Χορδωτά	Chordate
Κρίστιαν Χόυχενς	Christiaan Huygens
Κριστιάν Ντιόρ	Christian Dior
Χριστιανισμός	Christianity
Κατηγορία:Χριστιανισμός	Christianity
Χριστούγεννα	Christmas
Κατηγορία:Χριστούγεννα	Christmas
Δένδρο των Χριστουγέννων	Christmas tree
Χριστόφορος Κολόμβος	Christopher Columbus
Χρωματίνη	Chromatin
Χρώμιο	Chromium
Κατηγορία:Χρονολόγηση	Chronology
Εκκλησία	Church
Μάρκος Τύλλιος Κικέρωνας	Cicero
Πελαργόμορφα	Ciconiiformes
Τσιγάρο	Cigarette
Σταχτοπούτα	Cinderella
Κίρκη	Circe
Διαβήτης (αστερισμός)	Circinus
Κύκλος	Circle
Περιτομή	Circumcision
Κιτρικό οξύ	Citric acid
Εμφύλιος πόλεμος	Civil war
Κλαρινέτο	Clarinet
Ομοταξία	Class (biology)
Κλασική Μηχανική	Classical mechanics
Κλασική μουσική	Classical music
Κατηγορία:Κλασική μουσική	Classical music
Κλωντ Μονέ	Claude Monet
Κλαούντιο Μοντεβέρντι	Claudio Monteverdi
Μουσικό κλειδί	Clef
Κλεοπάτρα	Cleopatra (disambiguation)
Κλίμα	Climate
Κατηγορία:Κλιματολογία	Climatology
Κλινική κατάθλιψη	Clinical depression
Κλειώ	Clio
Κλειτορίδα	Clitoris
Ρολόι	Clock
Κλωνοποίηση	Cloning
Κατηγορία:Ένδυση	Clothing
Νέφος	Cloud
Γαριφαλόδενδρο	Clove
Γαιάνθρακας (καύσιμο)	Coal
Ακτή	Coast
Εθνόσημο	Coat of arms
Κοβάλτιο	Cobalt
Κατσαρίδα	Cockroach
Κοκτέιλ	Cocktail
Νησιά Κόκος	Cocos (Keeling) Islands
Καφές	Coffee
Κατηγορία:Καφές	Coffee
Γνωστική ψυχολογία	Cognitive psychology
Γνωσιακή επιστήμη	Cognitive science
Νόμισμα	Coin
Ψυχρός πόλεμος	Cold War
Κατηγορία:Ψυχρός πόλεμος	Cold War
Κολάζ	Collage
Κολωνία	Cologne
Κολομβία	Colombia
Κατηγορία:Κολομβία	Colombia
Κολόμπο	Colombo
Κολοράντο	Colorado
Κολοσσαίο	Colosseum
Κολοσσός της Ρόδου	Colossus of Rhodes
Περιστερά	Columba (constellation)
Κολούμπια	Columbia
Πανεπιστήμιο Κολούμπια	Columbia University
Περιστέρι	Columbidae
Κόμη Βερενίκης	Coma Berenices
Καύση	Combustion
Κομήτης	Comet
Κόμμα (στίξη)	Comma (punctuation)
Κομέντια ντελ άρτε	Commedia dell'arte
Κοινοπολιτεία	Commonwealth of Nations
Επικοινωνία	Communication
Κομμουνισμός	Communism
Κατηγορία:Κομμουνισμός	Communism
Κομόρες	Comoros
Κατηγορία:Κομόρες	Comoros
CD	Compact Disc
Πυξίδα	Compass
Διαβήτης (όργανο)	Compass (drafting)
Ανταγωνισμός	Competition
Μεταγλωττιστής	Compiler
Μιγαδικός αριθμός	Complex number
Συνθέτης	Composer
Αξονική τομογραφία	Computed tomography
Ηλεκτρονικός υπολογιστής	Computer
Αρχείο (υπολογιστές)	Computer file
Επιστήμη υπολογιστών	Computer science
Κατηγορία:Επιστήμη υπολογιστών	Computer science
Ιός (υπολογιστές)	Computer virus
Κοντσέρτο	Concerto
Κόνκορντ Νιου Χάμσαϊρ	Concord
Προφυλακτικό	Condom
Μαέστρος	Conducting
Κώνος	Cone (geometry)
Κομφουκιανισμός	Confucianism
Κομφούκιος	Confucius
Κονγκό	Congo
Κονγκό (ποταμός)	Congo River
Κωνική τομή	Conic section
Σύμφωνο	Consonant
Κωνσταντίνος Α΄ ο Μέγας	Constantine I
Αστερισμός	Constellation
Σύνταγμα	Constitution (political)
Ήπειροι	Continent
Υφαλοκρηπίδα	Continental shelf
Μπριτζ	Contract bridge
Μαγειρική	Cooking
Σύστημα συντεταγμένων	Coordinate system
Coordinated Universal Time	Coordinated Universal Time
Κοπεγχάγη	Copenhagen
Χαλκός	Copper
Πνευματική ιδιοκτησία	Copyright
Κοράλλι	Coral
Θάλασσα των κοραλλίων	Coral Sea
Κόρινθος	Corinth
Κορμοράνος	Cormorant
Στέφανος Βόρειος	Corona Borealis
Κορσική	Corsica
Κορβέττα	Corvette
Κόραξ	Corvus (constellation)
Κοσμικές ακτίνες	Cosmic ray
Κοσμολογία	Cosmology
Κατηγορία:Κοσμολογία	Cosmology
Κόστα Ρίκα	Costa Rica
Κατηγορία:Κόστα Ρίκα	Costa Rica
Κοτονού	Cotonou
Βαμβάκι	Cotton
Κουλόμπ (μονάδα μέτρησης)	Coulomb
Νόμος του Κουλόμπ	Coulomb's law
Σύνοδος της Εφέσου	Council of Ephesus
Αντίστιξη	Counterpoint
Χώρα	Country
Δικαστήριο	Court
Ομοιοπολικός δεσμός	Covalent bond
Κάβουρας	Crab
Νεφέλωμα Καρκίνος	Crab Nebula
Κρατήρ	Crater (constellation)
Κρητιδική περίοδος	Cretaceous
Κρήτη	Crete
Κρίκετ	Cricket
Ποινικό Δίκαιο	Criminal law
Εγκληματολογία	Criminology
Κατηγορία:Εγκληματολογία	Criminology
Κροατία	Croatia
Κατηγορία:Κροατία	Croatia
Κροκόδειλος	Crocodile
Κρόνος (μυθολογία)	Cronus
Σταυρός	Cross
Σταυρόλεξο	Crossword
Σταύρωση	Crucifixion
Καταδρομικό	Cruiser
Σταυρός Νότιος	Crux
Κρυπτογραφία	Cryptography
Κατηγορία:Κρυπτογραφία	Cryptography
Κρύσταλλος	Crystal
Κρυσταλλογραφία	Crystallography
Κούβα	Cuba
Κατηγορία:Κούβα	Cuba
Κύβος (στερεό)	Cube
Κυβικό μέτρο	Cubic metre
Κυβισμός	Cubism
Αγγούρι	Cucumber
Πολιτισμός	Culture
Κατηγορία:Πολιτισμός	Culture
Σωρείτες	Cumulus cloud
Κουριτίμπα	Curitiba
Κιούριο	Curium
Κατηγορία:Νομίσματα	Currency
Κούζκο	Cusco
Γαλάζιο	Cyan
Κυανοβακτήρια	Cyanobacteria
Κυβέλη (μυθολογία)	Cybele
Επιστήμη συστημάτων	Cybernetics
Κυβερνοπάνκ	Cyberpunk
Κυκλάδες	Cyclades
Πεδίο χαμηλού βαρομετρικού	Cyclone
Κύκλωπες	Cyclops
Κύκνος (αστερισμός)	Cygnus (constellation)
Κύπρος	Cyprus
Κατηγορία:Κύπρος	Cyprus
Κυριλλικό αλφάβητο	Cyrillic alphabet
Κύρος	Cyrus the Great
Κυτόπλασμα	Cytoplasm
Τσεχία	Czech Republic
Κατηγορία:Τσεχία	Czech Republic
Τσεχοσλοβακία	Czechoslovakia
Κατηγορία:Τσεχοσλοβακία	Czechoslovakia
D	D
DNA	DNA
DVD	DVD
Ντανταϊσμός	Dada
Δαίδαλος	Daedalus
Νταγκεροτυπία	Daguerreotype
Ντάλια	Dahlia
Ντακάρ	Dakar
Δαλάι Λάμα	Dalai Lama
Ντάλας	Dallas
Δαλματία	Dalmatia
Φράγμα	Dam
Δαμασκός	Damascus
Χορός	Dance
Κατηγορία:Χορός	Dance
Ντάνιελ Μπερνούλι	Daniel Bernoulli
Ντάνιελ Νταφόε	Daniel Defoe
Ντανιέλ Ορτέγκα	Daniel Ortega
Κορόνα Δανίας	Danish krone
Δάντης Αλιγκέρι	Dante Alighieri
Δούναβης	Danube
Δάφνη (νύμφη)	Daphne
Δαρδανέλια	Dardanelles
Σκοτεινή ύλη	Dark matter
Νταρμστάντιο	Darmstadtium
Δαρβίνος	Darwin
Δεδομένα	Data
Βάση δεδομένων	Database
Χουρμάς	Date Palm
Δοτική	Dative case
Δαβίδ	David
Ντάβιντ Χίλμπερτ	David Hilbert
Ντέιβιντ Χιουμ	David Hume
Ντέηβιντ Ρικάρντο	David Ricardo
Κύπελλο Ντέιβις	Davis Cup
Κατηγορία:Ημέρες του έτους	Days
Διάκονος	Deacon
Νεκρά θάλασσα	Dead Sea
Χειρόγραφα της Νεκράς Θάλασσας	Dead Sea scrolls
Κατηγορία:Θάνατος	Death
Δεκέμβριος	December
31 Δεκεμβρίου	December 31
8 Δεκεμβρίου	December 8
Δεκαδικό σύστημα	Decimal
Απόκλιση αστέρος	Declination
Ελάφι	Deer
Δείμος (δορυφόρος)	Deimos (moon)
Ντεϊσμός	Deism
Ντελαγουέρ	Delaware
Ντελφτ	Delft
Δελφοί	Delphi
Δελφίν (αστερισμός)	Delphinus
Δέλτα	Delta (letter)
Κατακλυσμός του Νώε	Deluge (mythology)
Δήμητρα (μυθολογία)	Demeter
Δημοκρατία	Democracy
Δημοκρατικό Κόμμα (ΗΠΑ)	Democratic Party (United States)
Λαϊκή Δημοκρατία του Κονγκό	Democratic Republic of the Congo
Κατηγορία:Λαϊκή Δημοκρατία του Κονγκό	Democratic Republic of the Congo
Δημόκριτος	Democritus
Δημοσθένης	Demosthenes
Ντενγκ Ξιαοπίνγκ	Deng Xiaoping
Ντενί Ντιντερό	Denis Diderot
Δανία	Denmark
Κατηγορία:Δανία	Denmark
Τερηδόνα	Dental caries
Κατηγορία:Οδοντιατρική	Dentistry
Οδοντιατρική	Dentistry
Κατηγορία:Έρημοι	Deserts
Ντεζιντέριους Έρασμος	Desiderius Erasmus
Κατηγορία:Σχεδιασμός	Design
Αντιτορπιλικό	Destroyer
Αιτιοκρατία	Determinism
Ντιτρόιτ	Detroit
Εξελικτική ψυχολογία	Developmental psychology
Δρόσος	Dew
Δεκαδικό Σύστημα Ταξινόμησης Dewey	Dewey Decimal Classification
Ντάρμα	Dharma
Διαβήτης	Diabetes mellitus
Διαλεκτική	Dialectic
Διάμετρος	Diameter
Διαμάντι	Diamond
Ντιάνα	Diana (mythology)
Δικοτυλήδονο	Dicotyledon
Δικτατορία	Dictatorship
Λεξικό	Dictionary
Διαφορική Εξίσωση	Differential equation
Διάχυση	Diffusion
Ψηφιακή φωτογραφική μηχανή	Digital camera
Digital Subscriber Line	Digital subscriber line
Ντιζόν	Dijon
Άνηθος	Dill
Διάσταση	Dimension
Δεινόσαυρος	Dinosaur
Διοκλητιανός	Diocletian
Δίοδος	Diode
Διόνυσος	Dionysus
Κατηγορία:Διπλωματία	Diplomacy
Συνεχές ρεύμα	Direct current
Κατηγορία:Αποσαφήνιση	Disambiguation
Απόσταση	Distance
Απόσταξη	Distillation
Μεραρχία	Division (military)
Ντίζι Γκιλέσπι	Dizzy Gillespie
Κατηγορία:Τζιμπουτί	Djibouti
Τζιμπουτί (πόλη)	Djibouti (city)
Ντμίτρι Μεντελέγιεφ	Dmitri Mendeleev
Ντμίτρι Σοστακόβιτς	Dmitri Shostakovich
Δνείπερος	Dnieper River
Δωδεκάνησα	Dodecanese
Σκύλος	Dog
Δόγμα	Dogma
Τρούλος	Dome
Κατηγορία:Ντομίνικα	Dominica
Δομινικανή Δημοκρατία	Dominican Republic
Κατηγορία:Δομινικανή Δημοκρατία	Dominican Republic
Δον Κιχώτης	Don Quixote
Ντον	Don River (Russia)
Ντόναλντ Ντακ	Donald Duck
Γάιδαρος	Donkey
Πόρτα	Door
Φαινόμενο Ντόπλερ	Doppler effect
Δοράς	Dorado
Δωρικός ρυθμός	Doric order
Ντόρις Λέσινγκ	Doris Lessing
Ντόρτμουντ	Dortmund
Κοντραμπάσο	Double bass
Δράκων (αστερισμός)	Draco (constellation)
Δράκουλας (βιβλίο)	Dracula
Δράκοντας	Dragon
Δράμα	Drama
Όνειρο	Dream
Δρέσδη	Dresden
Δρυίδες	Druid
Δυαλισμός	Dualism
Δουβλίνο	Dublin
Ντούμπνιο	Dubnium
Ντουμπρόβνικ	Dubrovnik
Ντιγκόνγκ	Dugong
Ντιούκ Έλινγκτον	Duke Ellington
Δουνκέρκη	Dunkirk
Ντέρμπαν	Durban
Ντάστιν Χόφμαν	Dustin Hoffman
Κατηγορία:Ολλανδοί	Dutch people
Ντουάιτ Αϊζενχάουερ	Dwight D. Eisenhower
Δυναμική	Dynamics (physics)
Δυσλεξία	Dyslexia
Δυσπρόσιο	Dysprosium
Δυστοπία	Dystopia
E	E
Αριθμός e (μαθηματικά)	E (mathematical constant)
Ηλεκτρονικό ταχυδρομείο	E-mail
ΕΤΑ	ETA
Αετός	Eagle
Αυτί	Ear
Γη	Earth
Κατηγορία:Γη	Earth
Σεισμός	Earthquake
Ανατολή	East
Λαϊκή Δημοκρατία της Γερμανίας	East Germany
Ανατολικό Τιμόρ	East Timor
Κατηγορία:Ανατολικό Τιμόρ	East Timor
Πάσχα	Easter
Ορθόδοξη Εκκλησία	Eastern Orthodox Church
Εκκεντρότητα	Eccentricity (mathematics)
Έχιδνα (μυθολογία)	Echidna (mythology)
Έκλειψη	Eclipse
Οικολογία	Ecology
Κατηγορία:Οικολογία	Ecology
Οικονομετρία	Econometrics
Οικονομικά	Economics
Κατηγορία:Οικονομικά	Economics
Οικονομικά	Economy
Οικοσύστημα	Ecosystem
Ισημερινός (χώρα)	Ecuador
Κατηγορία:Ισημερινός	Ecuador
Οικουμενικές σύνοδοι	Ecumenical council
Έντγκαρ Άλλαν Πόε	Edgar Allan Poe
Εντγκάρ Ντεγκά	Edgar Degas
Εδιμβούργο	Edinburgh
Αδριανούπολη	Edirne
Έντμουντ Χάλλεϋ	Edmond Halley
Έντμοντον	Edmonton
Έντμουντ Χίλαρι	Edmund Hillary
Έντο	Edo
Εκπαίδευση	Education
Κατηγορία:Εκπαίδευση	Education
Έντβαρτ Μουνκ	Edvard Munch
Έντουαρντ του Ουέσσεξ	Edward the Confessor
Έντγουιν Χαμπλ	Edwin Hubble
Μελιτζάνα	Eggplant
Αίγυπτος	Egypt
Κατηγορία:Αίγυπτος	Egypt
Λίρα Αιγύπτου	Egyptian pound
Αιγυπτιολογία	Egyptology
Πύργος του Άιφελ	Eiffel Tower
Αϊντχόφεν	Eindhoven
Αϊνσταΐνιο	Einsteinium
Ελ Σιντ	El Cid
Δομήνικος Θεοτοκόπουλος	El Greco
Ελ Σαλβαδόρ	El Salvador
Κατηγορία:Ελ Σαλβαδόρ	El Salvador
Ελάμ	Elam
Έλινορ Ρούζβελτ	Eleanor Roosevelt
Εκλογές	Election
Ηλέκτρα (μυθολογία)	Electra
Ηλεκτρικό φορτίο	Electric charge
Ηλεκτρικό ρεύμα	Electric current
Ηλεκτρικό πεδίο	Electric field
Ηλεκτρική αντίσταση	Electrical resistance
Ηλεκτρισμός	Electricity
Ηλεκτροκαρδιογράφημα	Electrocardiogram
Ηλεκτροχημεία	Electrochemistry
Ηλεκτρόλυση	Electrolysis
Ηλεκτρομαγνητική ακτινοβολία	Electromagnetic radiation
Ηλεκτρομαγνητισμός	Electromagnetism
Κατηγορία:Ηλεκτρομαγνητισμός	Electromagnetism
Ηλεκτρόνιο	Electron
Ηλεκτρονική	Electronics
Κατηγορία:Ηλεκτρονική	Electronics
Στοιχειώδες σωματίδιο	Elementary particle
Ελέφαντας	Elephant
Ανελκυστήρας	Elevator
Ξωτικά	Elf
Ελία Καζάν	Elia Kazan
Ηλίας (προφήτης)	Elijah
Ελίζαμπεθ Τέιλορ	Elizabeth Taylor
Έλλα Φιτζέραλντ	Ella Fitzgerald
Έλλειψη	Ellipse
Έλβις Πρίσλεϊ	Elvis Presley
Έμμα Γκόλντμαν	Emma Goldman
Κατηγορία:Συναισθήματα	Emotion
Εμπεδοκλής	Empedocles
Αυτοκρατορία	Empire
Εγκυκλοπαίδεια	Encyclopedia
Ενέργεια	Energy
Ενέργεια	Energy (society)
Αγγλία	England
Κατηγορία:Αγγλία	England
Μάγχη	English Channel
Αγγλική γλώσσα	English language
Κατηγορία:Άγγλοι	English people
Ένκι	Enki
Ενρίκο Φέρμι	Enrico Fermi
Ενθαλπία	Enthalpy
Εντροπία	Entropy
Κατηγορία:Περιβάλλον	Environment
Ένζυμο	Enzyme
Ηώς	Eos
Έφεσος	Ephesus
Έπος	Epic poetry
Επίκτητος	Epictetus
Επίκουρος	Epicurus
Επιδημιολογία	Epidemiology
Επιληψία	Epilepsy
Επιμηθέας	Epimetheus (mythology)
Επινεφρίνη	Epinephrine
Θεοφάνια	Epiphany (Christian)
Ήπειρος	Epirus (periphery)
Έψιλον	Epsilon
Εξίσωση	Equation
Ισημερινός	Equator
Ισημερινή Γουινέα	Equatorial Guinea
Κατηγορία:Ισημερινή Γουινέα	Equatorial Guinea
Ιππίδες	Equidae
Ισημερία	Equinox
Erasure	Erasure
Ερατώ	Erato
Ερατοσθένης ο Κυρηναίος	Eratosthenes
Έρβιο	Erbium
Έρεβος (μυθολογία)	Erebus
Ηριδανός (αστερισμός)	Eridanus (constellation)
Έρικ Άξελ Kάρλφελντ	Erik Axel Karlfeldt
Έρις	Eris (mythology)
Κατηγορία:Ερυθραία	Eritrea
Έρνεστ Χέμινγουεϊ	Ernest Hemingway
Έρως	Eros (mythology)
Διάβρωση	Erosion
Έρβιν Ρόμελ	Erwin Rommel
Εσχατολογία	Eschatology
Ισφαχάν	Esfahan
Οισοφάγος	Esophagus
Εσπεράντο	Esperanto
Έσποο	Espoo
Έσσεν	Essen
Έσσεξ	Essex
Κατηγορία:Εσθονία	Estonia
Οιστρογόνο	Estrogen
Ήτα	Eta (letter)
Αιθάνιο	Ethane
Αιθανόλη	Ethanol
Ethernet	Ethernet
Ηθική	Ethics
Κατηγορία:Ηθική	Ethics
Αιθιοπία	Ethiopia
Κατηγορία:Αιθιοπία	Ethiopia
Κατηγορία:Εθνολογία	Ethnology
Αιθένιο	Ethylene
Ευκάλυπτος	Eucalyptus
Θεία Ευχαριστία	Eucharist
Ευκλείδης	Euclid
Ευκλείδεια γεωμετρία	Euclidean geometry
Ευφράτης	Euphrates
Ευρασία	Eurasia
Ευριπίδης	Euripides
Ευρώ	Euro
Ευρώπη (δορυφόρος)	Europa (moon)
Αρπαγή της Ευρώπης	Europa (mythology)
Ευρώπη	Europe
Κατηγορία:Ευρώπη	Europe
Ευρωπαϊκή Κεντρική Τράπεζα	European Central Bank
Ευρωπαϊκή Κοινότητα	European Community
Ευρωπαϊκή Ένωση	European Union
Κατηγορία:Ευρωπαϊκή Ένωση	European Union
Ευρώπιο	Europium
Ευσέβιος ο Καισαρείας	Eusebius of Caesarea
Ευτέρπη	Euterpe
Ευθανασία	Euthanasia
Εύα Μπράουν	Eva Braun
Evanescence	Evanescence
Ευαντζελίστα Τοριτσέλι	Evangelista Torricelli
Εξάτμιση	Evaporation
Αρτιοδάκτυλα	Even-toed ungulate
Εξέλιξη (βιολογία)	Evolution
Εξκάλιμπερ	Excalibur
Θρησκευτικές ποινές	Excommunication
Εκτελεστική εξουσία	Executive (government)
Υπαρξισμός	Existentialism
Μέση τιμή	Expected value
Πείραμα	Experiment
Έκρηξη	Explosion
Εξπρεσιονισμός	Expressionism
Μάτι	Eye
Έζρα Πάουντ	Ezra Pound
F	F
Φράνσις Σκοτ Φιτζέραλντ	F. Scott Fitzgerald
Παραμύθι	Fable
Πρότυπο:Εκκρεμεί παραπομπή	Fact
Εργοστάσιο	Factory
Φάντο	Fado
Γεράκι	Falcon
Ιερακόμορφα	Falconiformes
Νήσοι Φώκλαντ	Falkland Islands
Λογική πλάνη	Fallacy
Κατηγορία:Οικογένεια	Family
Οικογένεια (βιολογία)	Family (biology)
Γενεαλογία	Family history
Φαράντ (μονάδα μέτρησης)	Farad
Κατηγορία:Νήσοι Φερόες	Faroe Islands
Φασισμός	Fascism
Κατηγορία:Φασισμός	Fascism
Κατηγορία:Μόδα	Fashion
Νηστεία	Fasting
Πανίδα	Fauna
Φωβισμός	Fauvism
Τηλεομοιοτυπία	Fax
Φόβος	Fear
Φεβρουάριος	February
12 Φεβρουαρίου	February 12
14 Φεβρουαρίου	February 14
2 Φεβρουαρίου	February 2
22 Φεβρουαρίου	February 22
29 Φεβρουαρίου	February 29
FBI	Federal Bureau of Investigation
Ομόσπονδες Πολιτείες της Μικρονησίας	Federated States of Micronesia
Φεντερίκο Φελίνι	Federico Fellini
Φεμινισμός	Feminism
Κατηγορία:Φεμινισμός	Feminism
Ξιφασκία	Fencing
Μάραθο	Fennel
Φερδινάνδος Μαγγελάνος	Ferdinand Magellan
Φερντινάντ ντε Σωσσύρ	Ferdinand de Saussure
Ζύμωση	Fermentation (food)
Φερμιόνιο	Fermion
Φέρμιο	Fermium
Φτέρη	Fern
Φερράρα	Ferrara
Πορθμείο	Ferry
Φεουδαρχία	Feudalism
Πυρετός	Fever
Όμιλος Fiat	Fiat
Ακολουθία Φιμπονάτσι	Fibonacci number
Φιντέλ Κάστρο	Fidel Castro
Σώμα (άλγεβρα)	Field (mathematics)
Καλλιτεχνικό πατινάζ	Figure skating
Φίτζι	Fiji
Κατηγορία:Φίτζι	Fiji
File Allocation Table	File Allocation Table
File Transfer Protocol	File Transfer Protocol
Κατηγορία:Κινηματογράφος	Film
Πύλη:Κινηματογράφος	Film
Σκηνοθέτης	Film director
Κατηγορία:Χρηματοοικονομικά	Finance
Χρηματοοικονομικά	Finance
Φινλανδία	Finland
Κατηγορία:Φινλανδία	Finland
Ελάτη	Fir
Φωτιά	Fire
Πυροσβεστική	Firefighter
Firewall	Firewall (networking)
Πρώτη Σύνοδος της Κωνσταντινούπολης	First Council of Constantinople
Πρώτη Σύνοδος της Νίκαιας	First Council of Nicaea
Α' Σταυροφορία	First Crusade
Ψάρι	Fish
Κατηγορία:Ψάρια	Fish
Αλιεία	Fishing
Κατηγορία:Αλιεία	Fishing
Φιόρδ	Fjord
Σημαία	Flag
Φλάνδρα	Flanders
Πλατυέλμινθες	Flatworm
Φλαμανδική γλώσσα	Flemish (linguistics)
Φλωρεντία	Florence
Φλόριντα	Florida
Αλεύρι	Flour
Άνθος	Flower
Αγγειόσπερμο	Flowering plant
Ρευστό	Fluid
Υδρομηχανική	Fluid mechanics
Φλάουτο	Flute
Μύγα	Fly
Ομίχλη	Fog
Λαογραφία	Folklore
Κατηγορία:Λαογραφία	Folklore
Πόδι (μονάδα μήκους)	Foot (unit of length)
Ποδόσφαιρο	Football (soccer)
Κατηγορία:Ποδόσφαιρο	Football (soccer)
Κατηγορία:Ποδόσφαιρο ανά χώρα	Football (soccer) by country
Κατηγορία:Ξένοι αθλητικοί σύλλογοι	Football (soccer) clubs
Κατηγορία:Προπονητές ποδοσφαίρου	Football (soccer) managers
Κατηγορία:Ποδοσφαιριστές	Football (soccer) players
Κατηγορία:Γήπεδα ποδοσφαίρου	Football (soccer) venues
Δύναμη	Force
Δάσος	Forest
Φορμαλδεΰδη	Formaldehyde
Μυρμηκικό οξύ	Formic acid
Κάμινος (αστερισμός)	Fornax
Fortran	Fortran
Απολίθωμα	Fossil
Δ' Σταυροφορία	Fourth Crusade
Φράκταλ	Fractal
Γαλλία	France
Κατηγορία:Γαλλία	France
Φρανθίσκο Φράνκο	Francisco Franco
Φρανσίσκο Γκόγια	Francisco Goya
Φράγκιο	Francium
Γαλλοπρωσικός Πόλεμος	Franco-Prussian War
Φρανκφούρτη	Frankfurt
Κατηγορία:Φρανκφούρτη	Frankfurt
Φραντς Κάφκα	Franz Kafka
Φραντς Λιστ	Franz Liszt
Φραντς Σούμπερτ	Franz Schubert
Φρεντ Ασταίρ	Fred Astaire
Φρειδερίκος Β' Χοενστάουφεν	Frederick II
Φρέντρικτον	Fredericton
Βούληση	Free will
Ελευθεροτεκτονισμός	Freemasonry
Γαλλική Πολυνησία	French Polynesia
Κατηγορία:Γαλλική Πολυνησία	French Polynesia
Γαλλική Επανάσταση	French Revolution
Κατηγορία:Γαλλική Επανάσταση	French Revolution
Γαλλικό Φράγκο	French franc
Κατηγορία:Γάλλοι	French people
Συχνότητα	Frequency
Νωπογραφία	Fresco
Φρέγια	Freyja
Φρέιρ	Freyr
Παρασκευή	Friday
Φρίντριχ Ένγκελς	Friedrich Engels
Φρεγάτα	Frigate
Φρίγκα	Frigg
Φριτς Χάμπερ	Fritz Haber
Βάτραχος	Frog
Φρουκτόζη	Fructose
Φρούτα	Fruit
Κατηγορία:Φρούτα	Fruit
Φούκινγκ	Fucking
Κυψέλη καυσίμου	Fuel cell
Φούγκα	Fugue
Πανσέληνος	Full moon
Συνάρτηση	Function (mathematics)
Κατηγορία:Θεμελιώδης	Fundamental
Θεμελιώδης αλληλεπίδραση	Fundamental interaction
Φονταμενταλισμός	Fundamentalism
Κατηγορία:Μύκητες	Fungi
Μύκητας	Fungus
Κατηγορία:Έπιπλα	Furniture
Φουτουρισμός	Futurism (art)
Φιοντόρ Ντοστογιέφσκι	Fyodor Dostoevsky
G	G
GIMP	GIMP
GNOME	GNOME
GNU	GNU
Γκαμπόν	Gabon
Κατηγορία:Γκαμπόν	Gabon
Αρχάγγελος Γαβριήλ	Gabriel
Γαδολίνιο	Gadolinium
Γαία (μυθολογία)	Gaia (mythology)
Γαλαξίες	Galaxy
Γαληνός	Galen
Γαλικία	Galicia (Spain)
Γαλιλαία	Galilee
Γαλιλαίος Γαλιλέι	Galileo Galilei
Χοληδόχος κύστη	Gallbladder
Γαλέα	Galley
Γάλλιο	Gallium
Γκαμάλ Άμπντελ Νάσερ	Gamal Abdel Nasser
Παιχνίδι	Game
Θεωρία παιγνίων	Game theory
Γάμμα	Gamma
Γκανέσα	Ganesha
Γκαντζά	Ganja
Γανυμήδης (μυθολογία)	Ganymede
Γανυμήδης (δορυφόρος)	Ganymede (moon)
Κήπος	Garden
Εδέμ	Garden of Eden
Σκόρδο	Garlic
Αέριο	Gas
Βενζίνη	Gasoline
Γαστρεντερικό σύστημα	Gastrointestinal tract
Σιντάρτα Γκαουτάμα	Gautama Buddha
Ομοφυλόφιλος	Gay
Λωρίδα της Γάζας	Gaza Strip
Γκεμπ	Geb
Γκέισα	Geisha
Δίδυμοι (αστερισμός)	Gemini (constellation)
Γονίδιο	Gene
Γενεαλογία	Genealogy
Κατηγορία:Γενεαλογία	Genealogy
Γενική σχετικότητα	General relativity
Γενετική	Genetics
Κατηγορία:Γενετική	Genetics
Γενεύη	Geneva
Τζίνι	Genie
Γενική	Genitive case
Γένοβα	Genoa
Γενοκτονία	Genocide
Γονιδίωμα	Genome
Γένος (βιολογία)	Genus
Γεωχημεία	Geochemistry
Γεωδαισία	Geodesy
Τζέφρι Τσόσερ	Geoffrey Chaucer
Γεωγραφία	Geography
Κατηγορία:Γεωγραφία	Geography
Κατηγορία:Γεωλογία	Geology
Γεωλογία	Geology
Γεωμετρία	Geometry
Κατηγορία:Γεωμετρία	Geometry
Κατηγορία:Γεωμορφολογία	Geomorphology
Γεωφυσική	Geophysics
Κατηγορία:Γεωφυσική	Geophysics
Γεωπολιτική	Geopolitics
Γκέοργκ Βίλχελμ Φρήντριχ Χέγκελ	Georg Wilhelm Friedrich Hegel
Τζορτζ Μπέρναρντ Σω	George Bernard Shaw
Τζωρτζ Μπους	George Bush
Γκέοργκ Χαίντελ	George Frideric Handel
Τζορτζ Γκέρσουιν	George Gershwin
Τζωρτζ Χάρισον	George Harrison
Τζορτζ Όργουελ	George Orwell
Γεωργία Σάνδη	George Sand
Τζωρτζ Μπους (νεότερος)	George W. Bush
Τζωρτζ Ουάσινγκτων	George Washington
Ζωρζ Μπρακ	Georges Braque
Γεωργία (Πολιτεία ΗΠΑ)	Georgia (U.S. state)
Γεωργία	Georgia (country)
Κατηγορία:Γεωργία	Georgia (country)
Τζέραλντ Φορντ	Gerald Ford
Γκέραρντ Κάιπερ	Gerard Kuiper
Γερμανικός Ποιμενικός	German Shepherd Dog
Γερμανική γλώσσα	German language
Γερμανικό Μάρκο	German mark
Γερμάνιο	Germanium
Γερμανία	Germany
Κατηγορία:Γερμανία	Germany
Γκεστάπο	Gestapo
Θερμοπίδακας	Geyser
Γκάνα	Ghana
Κατηγορία:Γκάνα	Ghana
Γάνδη	Ghent
Γκέτο	Ghetto
Φάντασμα	Ghost
Τζιάκομο Πουτσίνι	Giacomo Puccini
Γιβραλτάρ	Gibraltar
Κατηγορία:Γιβραλτάρ	Gibraltar
Γκιλγκαμές	Gilgamesh
Γκίγκο	Ginkgo
Τζιορντάνο Μπρούνο	Giordano Bruno
Τζόρτζιο Βαζάρι	Giorgio Vasari
Τζόρτζιο ντε Κίρικο	Giorgio de Chirico
Βοκάκιος	Giovanni Boccaccio
Καμηλοπάρδαλη	Giraffe
Τζιρόλαμο Σαβοναρόλα	Girolamo Savonarola
Τζουζέπε Βέρντι	Giuseppe Verdi
Παγετώνας	Glacier
Αδένας	Gland
Γλασκώβη	Glasgow
Γυαλί	Glass
Γυαλιά	Glasses
Global Positioning System	Global Positioning System
Παγκόσμια θέρμανση	Global warming
Αγκινάρα	Globe artichoke
Γκλουόνιο	Gluon
Γνωστικισμός	Gnosticism
Γκο	Go (board game)
Κατσίκα	Goat
Θεός	God
Χρυσός	Gold
Γκόλντα Μέιρ	Golda Meir
Χρυσή Ορδή	Golden Horde
Γκολφ	Golf
Κατηγορία:Γκολφ	Golf
Σωμάτιο Golgi	Golgi apparatus
Google	Google
Googol	Googol
Γοργόνες (μυθολογία)	Gorgon
Γορίλας	Gorilla
Ευαγγέλιο	Gospel
Κατά Λουκάν Ευαγγέλιον	Gospel of Luke
Γκέτεμποργκ	Gothenburg
Ουρική αρθρίτιδα	Gout
Κυβέρνηση	Government
Γκράφιτι	Graffiti
Γραμμάριο	Gram
Γραμματική	Grammar
Κατηγορία:Γραμματική	Grammar
Γραμματικό γένος	Grammatical gender
Γρανάδα	Granada
Διεθνής γκρανμαίτρ	Grandmaster (chess)
Γκρέιπ-φρουτ	Grapefruit
Κατηγορία:Γραφιστική	Graphic design
Γραφιστική	Graphic design
Γραφικό Περιβάλλον Χρήστη	Graphical user interface
Βαρύτητα	Gravitation
Βαρυτόνιο	Graviton
Λύκος	Gray Wolf
Γκρατς	Graz
Μέγα Σινικό Τείχος	Great Wall of China
Μείζων Περιοχή του Λονδίνου	Greater London
Ελλάδα	Greece
Κατηγορία:Ελλάδα	Greece
Ελληνικό αλφάβητο	Greek alphabet
Κατηγορία:Ελληνικό αλφάβητο	Greek alphabet
Υγρό πυρ	Greek fire
Ελληνική μυθολογία	Greek mythology
Κατηγορία:Ελληνική μυθολογία	Greek mythology
Πράσινο	Green
Θερμοκήπιο	Greenhouse
Φαινόμενο του θερμοκηπίου	Greenhouse effect
Γροιλανδία	Greenland
Κατηγορία:Γροιλανδία	Greenland
Greenpeace	Greenpeace
Μέση Ώρα Γκρίνουιτς	Greenwich Mean Time
Γκρέγκορ Μέντελ	Gregor Mendel
Γρηγοριανό ημερολόγιο	Gregorian calendar
Κατηγορία:Γρενάδα	Grenada
Γκρενόμπλ	Grenoble
Γκρέτα Γκάρμπο	Greta Garbo
Γκρι	Grey
Γρύπας	Griffin
Όρνιο	Griffon Vulture
Ακαθάριστο Εγχώριο Προϊόν	Gross domestic product
Ομάδα	Group (mathematics)
Γκρόζνυ	Grozny
Γερανός (αστερισμός)	Grus (constellation)
Γουαδελούπη	Guadeloupe
Γκουάμ	Guam
Καντώνα	Guangzhou
Γουανίνη	Guanine
Κατηγορία:Γουατεμάλα	Guatemala
Γουαγιακίλ	Guayaquil
Γκέρνσεϊ	Guernsey
Γουλιέλμο Μαρκόνι	Guglielmo Marconi
Συντεχνία (Ελλάδα)	Guild
Γκιγιώμ Απολλιναίρ	Guillaume Apollinaire
Γκιλοτίνα	Guillotine
Γουινέα	Guinea
Κατηγορία:Γουινέα	Guinea
Γουινέα-Μπισσάου	Guinea-Bissau
Κατηγορία:Γουινέα-Μπισσάου	Guinea-Bissau
Κιθάρα	Guitar
Γκούλαγκ	Gulag
Ρεύμα του Κόλπου	Gulf Stream
Πόλεμος του Κόλπου	Gulf War
Βοθνιακός κόλπος	Gulf of Bothnia
Φινλανδικός κόλπος	Gulf of Finland
Κόλπος του Μεξικού	Gulf of Mexico
Συνωμοσία της Πυρίτιδας	Gunpowder Plot
Γκούσταφ Κλιμτ	Gustav Klimt
Γκούσταβ Μάλερ	Gustav Mahler
Γκουστάβ Κουρμπέ	Gustave Courbet
Γκάι Φωκς	Guy Fawkes
Κατηγορία:Γουιάνα	Guyana
Γυμνόσπερμο	Gymnosperm
Γύψος	Gypsum
Γυροσκόπιο	Gyroscope
H	H
HIV	HIV
HTML	HTML
Καταρχαιοζωικός αιώνας	Hadean
Άδης (μυθολογία)	Hades
Αδριανός	Hadrian
Αδρόνιο	Hadron
Αιμοφιλία	Haemophilia
Άφνιο	Hafnium
Αγία Σοφία (Κωνσταντινούπολη)	Hagia Sophia
Χάιφα	Haifa
Χαλάζι	Hail
Άβε Μαρία	Hail Mary
Τρίχα	Hair
Αϊτή	Haiti
Κατηγορία:Αϊτή	Haiti
Αλογόνα	Halogen
Αμβούργο	Hamburg
Κατηγορία:Αμβούργο	Hamburg
Άμλετ	Hamlet
Σφυρί	Hammer
Σφυροδρέπανο	Hammer and sickle
Χαμουραμπί	Hammurabi
Κρεμαστοί κήποι της Βαβυλώνας	Hanging Gardens of Babylon
Χάνα Άρεντ	Hannah Arendt
Αννίβας	Hannibal
Αννόβερο	Hanover
Χανς Κρίστιαν Άντερσεν	Hans Christian Andersen
Τευτονική Χάνσα	Hanseatic League
Αρμονία (μουσική)	Harmony
Χάρολντ Πίντερ	Harold Pinter
Άρπα	Harp
Τσέμπαλο	Harpsichord
Άρπυιες	Harpy
Χάσιο	Hassium
Αβάνα	Havana
Χαβάη	Hawaii
Κατηγορία:Χαβάη	Hawaii
Φουντουκιά	Hazel
Υγεία	Health
Κατηγορία:Υγεία	Health
Καρδιά	Heart
Θερμότητα	Heat
Παράδεισος	Heaven
Βαρύ ύδωρ	Heavy water
Ήβη (μυθολογία)	Hebe (mythology)
Εβραϊκό ημερολόγιο	Hebrew calendar
Εκάτη	Hecate
Εκτάριο	Hectare
Έκτορας	Hector
Χέιμνταλ	Heimdall
Χάινριχ Χερτζ	Heinrich Hertz
Χάινριχ Χίμλερ	Heinrich Himmler
Ερρίκος Σλήμαν	Heinrich Schliemann
Χελ	Hel (being)
Ελένη (μυθολογία)	Helen
Ελικόπτερο	Helicopter
Ήλιος (μυθολογία)	Helios
Ήλιο	Helium
Κόλαση	Hell
Χέλμουτ Σμιτ	Helmut Schmidt
Ελσίνκι	Helsinki
Αιματίτης	Hematite
Αιμορροΐδες	Hemorrhoid
Ανρί Μπεργκσόν	Henri Bergson
Ανρί Ματίς	Henri Matisse
Ερρίκος Ίψεν	Henrik Ibsen
Χένρι Κάβεντις	Henry Cavendish
Χένρυ Κίσινγκερ	Henry Kissinger
Χένρυ Μίλλερ	Henry Miller
Χένρυ Μουρ	Henry Moore
Χένρυ Πέρσελ	Henry Purcell
Ηπατίτιδα	Hepatitis
Ήφαιστος	Hephaestus
Ήρα (μυθολογία)	Hera
Ηρακλής (μυθολογία)	Heracles
Ηράκλειτος	Heraclitus
Ηρακλής (μυθολογία)	Hercules
Ηρακλής (αστερισμός)	Hercules (constellation)
Αίρεση	Heresy
Έρμαν Έσσε	Hermann Hesse
Ερμής (μυθολογία)	Hermes
Ήρωας	Hero
Ήρων	Hero of Alexandria
Ηρόδοτος	Herodotus
Ησίοδος	Hesiod
Εσπερίδες	Hesperides
Έσση	Hesse
Κατηγορία:Έσση	Hesse
Εστία (μυθολογία)	Hestia
Δεκαεξαδικό σύστημα αρίθμησης	Hexadecimal
Χεζμπολάχ	Hezbollah
Χιντέκι Γιουκάβα	Hideki Yukawa
Ιερώνυμος Μπος	Hieronymus Bosch
Χώρος Χίλμπερτ	Hilbert space
Ιμαλάια	Himalayas
Ινδουισμός	Hinduism
Κατηγορία:Ινδουισμός	Hinduism
Ίππαρχος ο Ρόδιος	Hipparchus
Ιπποκράτης	Hippocrates
Όρκος του Ιπποκράτη	Hippocratic Oath
Ιπποπόταμος	Hippopotamus
Χιροχίτο	Hirohito
Χιροσίμα	Hiroshima
Ιστολογία	Histology
Ιστορία	History
Κατηγορία:Ιστορία	History
Σαϊγκόν	Ho Chi Minh City
Κατσουσίκα Χοκουσάι	Hokusai
Αργία	Holiday
Χόλυγουντ	Hollywood
Όλμιο	Holmium
Άγιο Δισκοπότηρο	Holy Grail
Αγία Ρωμαϊκή Αυτοκρατορία	Holy Roman Empire
Κατηγορία:Αγία Ρωμαϊκή Αυτοκρατορία	Holy Roman Empire
Άγιο Πνεύμα	Holy Spirit
Ομοιοπαθητική	Homeopathy
Όμηρος	Homer
Ανθρωπίδαι	Hominidae
Ομοφοβία	Homophobia
Ομοφυλοφιλία	Homosexuality
Ονδούρα	Honduras
Κατηγορία:Ονδούρα	Honduras
Μέλι	Honey
Χονγκ Κονγκ	Hong Kong
Κατηγορία:Χονγκ Κονγκ	Hong Kong
Χονιάρα	Honiara
Χονολουλού	Honolulu
Ναργιλές	Hookah
Νόμος του Χουκ	Hooke's law
Οράτιος	Horace
Ορμόνη	Hormone
Κέρας της Αφρικής	Horn of Africa
Άλογο	Horse
Ώρος	Horus
Χόσνι Μουμπάρακ	Hosni Mubarak
Ώρα	Hour
Κατοικία	House
Ιατρικές υποθέσεις (τηλεσειρά)	House (TV series)
Χιούστον	Houston
Αερόστρωμνο	Hovercraft
Ούγος Καπέτος	Hugh Capet
Ούγκο Γκρότιους	Hugo Grotius
Ουγενότοι	Huguenot
Άνθρωπος	Human
Κατηγορία:Ανθρωπιστικές επιστήμες	Humanities
Υγρασία ατμόσφαιρας	Humidity
Χιούμορ	Humour
Χούμος	Humus
Εκατονταετής πόλεμος	Hundred Years' War
Ουγγαρία	Hungary
Κατηγορία:Ουγγαρία	Hungary
Κυνήγι	Hunting
Χούτου	Hutu
Υβρίδιο	Hybrid
Ύδρα (αστερισμός)	Hydra (constellation)
Υδρογόνο	Hydrogen
Δεσμός υδρογόνου	Hydrogen bond
Υδρολογία	Hydrology
Υδρόσφαιρα	Hydrosphere
Ύδρος	Hydrus
Κατηγορία:Υγιεινή	Hygiene
Υμενόπτερα	Hymenoptera
Υπερβολή (γεωμετρία)	Hyperbola
Υπερίων (μυθολογία)	Hyperion (mythology)
Υπερκείμενο	Hypertext
Πρωτόκολλο Μεταφοράς Υπερκειμένου	Hypertext Transfer Protocol
I	I
Ι.Μ. Πέι	I. M. Pei
IPod	IPod
Ίαν Φλέμινγκ	Ian Fleming
Ιαπετός (μυθολογία)	Iapetus (mythology)
Ιβηρική Χερσόνησος	Iberian Peninsula
Πάγος	Ice
Χόκεϊ επί πάγου	Ice hockey
Κατηγορία:Χόκεϊ επί πάγου	Ice hockey
Ισλανδία	Iceland
Κατηγορία:Ισλανδία	Iceland
Ιχθυολογία	Ichthyology
Αϊντάχο	Idaho
Ιδεαλισμός	Idealism
Ιδεολογία	Ideology
Ιγκόρ Στραβίνσκι	Igor Stravinsky
Ιλιάδα	Iliad
Ιλλυρία	Illyria
Εμμάνουελ Καντ	Immanuel Kant
Ιμπεριαλισμός	Imperialism
Ιμπρεσιονισμός	Impressionism
Ανεξαρτησία	Independence
Ινδία	India
Κατηγορία:Ινδία	India
Ινδικός Ωκεανός	Indian Ocean
Κατηγορία:Ινδικός Ωκεανός	Indian Ocean
Ιντιάνα	Indiana
Ίνδιο	Indium
Ινδονησία	Indonesia
Κατηγορία:Ινδονησία	Indonesia
Επαγωγή (Φιλοσοφία)	Inductive reasoning
Συγχωροχάρτι	Indulgence
Ινδός (αστερισμός)	Indus (constellation)
Ινδός ποταμός	Indus River
Βιομηχανική Eπανάσταση	Industrial Revolution
Αδράνεια	Inertia
Φαντάρος	Infantry
Απαρέμφατο	Infinitive
Άπειρο	Infinity
Πληθωρισμός	Inflation
Γρίπη	Influenza
Πληροφορία	Information
Ίνγκμαρ Μπέργκμαν	Ingmar Bergman
Ίνγκριντ Μπέργκμαν	Ingrid Bergman
Εσωτερική Μογγολία	Inner Mongolia
Καινοτομία	Innovation
Ίνσμπρουκ	Innsbruck
Ανόργανη χημεία	Inorganic chemistry
Έντομα	Insect
Θεσμός	Institution
Ινσουλίνη	Insulin
Ακέραιος αριθμός	Integer
Ολοκληρωμένο κύκλωμα	Integrated circuit
Διανοητική ιδιοκτησία	Intellectual property
Δείκτης Νοημοσύνης	Intelligence quotient
Τόκος	Interest
Διεθνής Οργανισμός Πολιτικής Αεροπορίας	International Civil Aviation Organization
Διεθνές Δικαστήριο της Δικαιοσύνης	International Court of Justice
Διεθνές Νομισματικό Ταμείο	International Monetary Fund
Διεθνές σύστημα μονάδων	International System of Units
Κατηγορία:Διεθνές Δίκαιο	International law
Διαδίκτυο	Internet
Κατηγορία:Διαδίκτυο	Internet
Internet Explorer	Internet Explorer
Διερμηνέας (υπολογιστές)	Interpreter (computing)
Έντερο	Intestine
Intranet	Intranet
Εφεύρεση	Invention
Ιώ (δορυφόρος)	Io (moon)
Ιώ (μυθολογία)	Io (mythology)
Ιώδιο	Iodine
Ιόν	Ion
Ιωνία	Ionia
Ιόνιο Πέλαγος	Ionian Sea
Ιονόσφαιρα	Ionosphere
Ιώτα	Iota
Αϊόβα	Iowa
Ιράν	Iran
Κατηγορία:Ιράν	Iran
Ιράκ	Iraq
Κατηγορία:Ιράκ	Iraq
Ιρλανδία	Ireland
Κατηγορία:Ιρλανδία	Ireland
Ειρηναίος της Λυών	Irenaeus
Ιρίδιο	Iridium
Ίρις (οφθαλμού)	Iris (anatomy)
Ίρις (μυθολογία)	Iris (mythology)
Κατηγορία:Ιρλανδοί	Irish people
Σίδηρος	Iron
Εποχή του Σιδήρου	Iron Age
Σιδηρούν παραπέτασμα	Iron Curtain
Iron Maiden	Iron Maiden
Άρρητος αριθμός	Irrational number
Ισαάκ	Isaac
Ισαάκ Ασίμωφ	Isaac Asimov
Ισαάκ Νεύτων	Isaac Newton
Ισιδώρα Ντάνκαν	Isadora Duncan
Ίσις	Isis
Ισλάμ	Islam
Κατηγορία:Ισλάμ	Islam
Ισλαμαμπάντ	Islamabad
Έτος Εγίρας	Islamic calendar
Νησί	Island
Νήσος του Μαν	Isle of Man
Κατηγορία:Νήσος του Μαν	Isle of Man
Ισομέρεια	Isomer
Ισορόκου Γιαμαμότο	Isoroku Yamamoto
Ισότοπο	Isotope
Ισραήλ	Israel
Κατηγορία:Ισραήλ	Israel
Κωνσταντινούπολη	Istanbul
Κατηγορία:Κωνσταντινούπολη	Istanbul
Ισθμός	Isthmus
Ιταλική χερσόνησος	Italian Peninsula
Ίταλο Καλβίνο	Italo Calvino
Ιταλία	Italy
Κατηγορία:Ιταλία	Italy
Ιθάκη	Ithaca
Ιβάν Παβλόφ	Ivan Pavlov
Ιβάν Τουργκένιεφ	Ivan Turgenev
J	J
Τζέιμς Μάθιου Μπάρι	J. M. Barrie
Τζακ Κέρουακ	Jack Kerouac
Τζακ Λέμον	Jack Lemmon
Τζακ Λόντον	Jack London
Τζακ ο Αντεροβγάλτης	Jack the Ripper
Τζάκσον Πόλοκ	Jackson Pollock
Ιακώβ	Jacob
Ζακ Καρτιέ	Jacques Cartier
Ζακ Όφενμπαχ	Jacques Offenbach
Τζαϊνισμός	Jainism
Τζακάρτα	Jakarta
Τζαμάικα	Jamaica
Κατηγορία:Τζαμάικα	Jamaica
Απόστολος Ιάκωβος	James
Τζέιμς Κλερκ Μάξγουελ	James Clerk Maxwell
Τζαίημς Τζόυς	James Joyce
Τζαίημς Μάντισον	James Madison
Τζαίημς Μονρόε	James Monroe
Τζέιμς Πρέσκοτ Τζάουλ	James Prescott Joule
Τζέιμς Βαττ	James Watt
Γιαν Χους	Jan Hus
Τζάνις Τζόπλιν	Janis Joplin
Γενίτσαροι	Janissary
Ιανουάριος	January
1 Ιανουαρίου	January 1
19 Ιανουαρίου	January 19
20 Ιανουαρίου	January 20
6 Ιανουαρίου	January 6
Ιανός (δορυφόρος)	Janus (moon)
Ιανός	Janus (mythology)
Ιαπωνία	Japan
Κατηγορία:Ιαπωνία	Japan
Ιάσονας	Jason
Ιάβα	Java
Java	Java (programming language)
Τζαζ	Jazz
Κατηγορία:Τζαζ μουσική	Jazz
Ρακίνας	Jean Racine
Ζαν Ζακ Ρουσσώ	Jean-Jacques Rousseau
Ζαν-Πωλ Σαρτρ	Jean-Paul Sartre
Τζέντα	Jeddah
Μάρτυρες του Ιεχωβά	Jehovah's Witnesses
Μέδουσα (ζώο)	Jellyfish
Τζέρσεϊ	Jersey
Ιερουσαλήμ	Jerusalem
Κατηγορία:Ιερουσαλήμ	Jerusalem
Ιησούς Χριστός	Jesus
Εβραίοι	Jew
Τζίμι Χέντριξ	Jimi Hendrix
Τζίμμυ Κάρτερ	Jimmy Carter
Ιωάννα της Λωραίνης	Joan of Arc
Γιόχαν Σεμπάστιαν Μπαχ	Johann Sebastian Bach
Γιόχαν Βόλφγκανγκ Γκαίτε	Johann Wolfgang von Goethe
Γιοχάνες Μπραμς	Johannes Brahms
Γουτεμβέργιος	Johannes Gutenberg
Γιοχάνες Κέπλερ	Johannes Kepler
Γιοχάνεσμπουργκ	Johannesburg
Τζων Άνταμς	John Adams
Τζον Μπαρντίν	John Bardeen
Ιωάννης Καλβίνος	John Calvin
Ιωάννης ο Χρυσόστομος	John Chrysostom
Τζον Χέρσελ	John Herschel
Τζων Λένον	John Lennon
Τζων Λοκ	John Locke
Τζων Κέυνς	John Maynard Keynes
Τζον Μίλτον	John Milton
Τζον Ράσκιν	John Ruskin
Τζον Στάινμπεκ	John Steinbeck
Τζον Στιούαρτ Μιλλ	John Stuart Mill
Τζον φον Νόιμαν	John von Neumann
Ιορδανία	Jordan
Κατηγορία:Ιορδανία	Jordan
Ιορδάνης ποταμός	Jordan River
Χόρχε Λουίς Μπόρχες	Jorge Luis Borges
Τζόζεφ Κόνραντ	Joseph Conrad
Γιόζεφ Γκαίμπελς	Joseph Goebbels
Φραντς Γιόζεφ Χάυντν	Joseph Haydn
Τζόζεφ Πούλιτζερ	Joseph Pulitzer
Ιωσήφ Στάλιν	Joseph Stalin
Ιώσηπος Φλάβιος	Josephus
Τζάουλ (μονάδα μέτρησης)	Joule
Ιοβιανός	Jovian
Ιουδαϊσμός	Judaism
Κατηγορία:Ιουδαϊσμός	Judaism
Ιουδαία	Judea
Τζούντο	Judo
Ζίου Ζίτσου	Jujutsu
Ιούλιος Βερν	Jules Verne
Ιουλιανό ημερολόγιο	Julian calendar
Ιουλιανός	Julian the Apostate
Ιούλιος Καίσαρας	Julius Caesar
Ιούλιος	July
1 Ιουλίου	July 1
4 Ιουλίου	July 4
Ιούνιος	June
14 Ιουνίου	June 14
21 Ιουνίου	June 21
23 Ιουνίου	June 23
24 Ιουνίου	June 24
29 Ιουνίου	June 29
3 Ιουνίου	June 3
Γιουνίπερος	Juniper
Γιούνο	Juno (mythology)
Δίας (πλανήτης)	Jupiter
Γιούπιτερ	Jupiter (mythology)
Ιουστινιανός Α'	Justinian I
Γιουτλάνδη	Jutland
K	K
Κάαμπα	Kaaba
Έρημος Καλαχάρι	Kalahari Desert
Καμικάζι	Kamikaze
Καμπάλα	Kampala
Καγκουρό	Kangaroo
Κάππα	Kappa
Καράτσι	Karachi
Καράτε	Karate
Καρλ Μαρξ	Karl Marx
Κάρμα	Karma
Κάθριν Χέπμπορν	Katharine Hepburn
Κατοβίτσε	Katowice
Κάουνας	Kaunas
Καζακστάν	Kazakhstan
Κατηγορία:Καζακστάν	Kazakhstan
Καζάν	Kazan
Κλίμακα Kelvin	Kelvin
Κεντ	Kent
Κένυα	Kenya
Κατηγορία:Κένυα	Kenya
Πυρήνας (υπολογιστές)	Kernel (computer science)
Κέτσαπ	Ketchup
Κετόνη	Ketone
Πληκτρολόγιο	Keyboard (computing)
Κιμπούτς	Kibbutz
Κίεβο	Kiev
Κιγκάλι	Kigali
Κιλομπάιτ	Kilobyte
Χιλιόγραμμο	Kilogram
Νηπιαγωγείο	Kindergarten
Κινηματική	Kinematics
Κινητική ενέργεια	Kinetic energy
Βασιλιάς (σκάκι)	King (chess)
Βασιλιάς Αρθούρος	King Arthur
Βασίλειο (βιολογία)	Kingdom (biology)
Κιριμπάτι	Kiribati
Κατηγορία:Κιριμπάτι	Kiribati
Φιλί	Kiss
Χαρταετός	Kite
Nož	Knife
Ίππος (σκάκι)	Knight (chess)
Κνωσός	Knossos
Κόμβος	Knot (speed)
Γνώση	Knowledge
Κοάλα	Koala
Κόνραντ Αντενάουερ	Konrad Adenauer
Κατηγορία:Κορέα	Korea
Κοσσυφοπέδιο	Kosovo
Κατηγορία:Κοσσυφοπέδιο	Kosovo
Κρεμλίνο	Kremlin
Κρυπτό	Krypton
Κου Κλουξ Κλαν	Ku Klux Klan
Ζώνη του Κάιπερ	Kuiper belt
Κουμκουάτ	Kumquat
Κουρδιστάν	Kurdistan
Κατηγορία:Κουρδιστάν	Kurdistan
Κουρτ Βαλντχάιμ	Kurt Waldheim
Κουβέιτ	Kuwait
Κατηγορία:Κουβέιτ	Kuwait
Κιότο	Kyoto
Κιργιζία	Kyrgyzstan
Κατηγορία:Κιργιζία	Kyrgyzstan
L	L
Λ'Ακουίλα	L'Aquila
Λα Παζ	La Paz
Εργατικό κόμμα (Ηνωμένο Βασίλειο)	Labour Party (UK)
Σαύρα (αστερισμός)	Lacerta
Γαλακτικό οξύ	Lactic acid
Λίμνη	Lake
Βαϊκάλη	Lake Baikal
Λίμνη της Γενεύης	Lake Geneva
Λάντογκα	Lake Ladoga
Τανγκανίκα	Lake Tanganyika
Λίμνη Βικτόρια	Lake Victoria
Λάμδα	Lambda
Γυπαετός	Lammergeier
Γλώσσα	Language
Λανθάνιο	Lanthanum
Λάος	Laos
Κατηγορία:Λάος	Laos
Φορητός υπολογιστής	Laptop
Λέιζερ	Laser
Λατινική γλώσσα	Latin
Λατινική Αμερική	Latin America
Λατινικό αλφάβητο	Latin alphabet
Γεωγραφικό πλάτος	Latitude
Λεττονία	Latvia
Κατηγορία:Λεττονία	Latvia
Λωζάνη	Lausanne
Δίκαιο	Law
Κατηγορία:Δίκαιο	Law
Λωρένσιο	Lawrencium
Δικηγόρος	Lawyer
Λάτιο	Lazio
Λε Κορμπυζιέ	Le Corbusier
Χάβρη	Le Havre
Μόλυβδος	Lead
Φύλλο (βοτανική)	Leaf
Κοινωνία των Εθνών	League of Nations
Δίσεκτο έτος	Leap year
Λίβανος	Lebanon
Κατηγορία:Λίβανος	Lebanon
Λήδα	Leda (mythology)
Λη Χάρβεϊ Όσβαλντ	Lee Harvey Oswald
Θρύλος	Legend
Λειψία	Leipzig
Λένας ποταμός	Lena River
Μήκος	Length
Φακός	Lens (optics)
Φακή	Lentil
Λέων (αστερισμός)	Leo (constellation)
Λέων Α'	Leo I (emperor)
Λέων Τρότσκι	Leon Trotsky
Λεονάρντο ντα Βίντσι	Leonardo da Vinci
Λέοναρντ Όιλερ	Leonhard Euler
Λεονίντ Μπρέζνιεφ	Leonid Brezhnev
Πάνθηρας	Leopard
Λεπτόνιο	Lepton
Λαγωός	Lepus (constellation)
Λεσότο	Lesotho
Κατηγορία:Λεσότο	Lesotho
Λητώ (μυθολογία)	Leto
Λεβάντες	Levant
Λιούις Κάρολ	Lewis Carroll
Λάσα	Lhasa
Φιλελευθερισμός	Liberalism
Λιβερία	Liberia
Κατηγορία:Λιβερία	Liberia
Ζυγός (αστερισμός)	Libra (constellation)
Βιβλιοθήκη	Library
Βιβλιοθηκονομία και Επιστήμη της Πληροφόρησης	Library science
Λιβύη	Libya
Κατηγορία:Λιβύη	Libya
Λειχήνα	Lichen
Ψέμα	Lie
Λιχτενστάιν	Liechtenstein
Κατηγορία:Λιχτενστάιν	Liechtenstein
Ανθυπολοχαγός	Lieutenant
Ζωή	Life
Κατηγορία:Ζωή	Life
Φως	Light
Δίοδος Εκπομπής Φωτός	Light-emitting diode
Έτος φωτός	Light-year
Φάρος	Lighthouse
Αστραπή	Lightning
Λίλιθ	Lilith
Λίμα	Lima
Ασβεστόλιθος	Limestone
Όριο (μαθηματικά)	Limit (mathematics)
Γραμμή	Line (mathematics)
Γραμμική Άλγεβρα	Linear algebra
Lingua franca	Lingua franca
Γλωσσολογία	Linguistics
Κατηγορία:Γλωσσολογία	Linguistics
Linux	Linux
Λιντς	Linz
Λιοντάρι	Lion
Υγρό	Liquid
Λισαβόνα	Lisbon
Lisp	Lisp (programming language)
Λογοτεχνία	Literature
Κατηγορία:Λογοτεχνία	Literature
Λίθιο	Lithium
Λιθουανία	Lithuania
Κατηγορία:Λιθουανία	Lithuania
Λίτρο	Litre
Λίβερπουλ	Liverpool
Σαύρα	Lizard
Λιουμπλιάνα	Ljubljana
Λάμα	Llama
Δάνειο (γλώσσα)	Loanword
Τοπικό δίκτυο υπολογιστών	Local area network
Λογάριθμος	Logarithm
Κατηγορία:Λογική	Logic
Λογική πύλη	Logic gate
Logo	Logo
Λίγηρας	Loire River
Λόκι	Loki
Λομβαρδία	Lombardy
Λονδίνο	London
Άλμα εις μήκος	Long jump
Κυριακή προσευχή	Lord's Prayer
Λωρραίνη	Lorraine (region)
Λος Άντζελες	Los Angeles
Ηχείο	Loudspeaker
Λουί Αραγκόν	Louis Aragon
Λούις Άρμστρονγκ	Louis Armstrong
Λουδοβίκος Μπράιγ	Louis Braille
Λουί Παστέρ	Louis Pasteur
Λουδοβίκος ο Ευσεβής	Louis the Pious
Λουιζιάνα	Louisiana
Μουσείο του Λούβρου	Louvre
Αγάπη	Love
Κάτω Σαξωνία	Lower Saxony
Λουάντα	Luanda
Λουκέρνη	Lucerne
Λουτσιάνο Παβαρόττι	Luciano Pavarotti
Λουκρήτιος	Lucretius
Λούντβιχ Μπόλτζμαν	Ludwig Boltzmann
Μις φαν ντερ Ρόε	Ludwig Mies van der Rohe
Λούντβιχ Βιτγκενστάιν	Ludwig Wittgenstein
Λούντβιχ βαν Μπετόβεν	Ludwig van Beethoven
Λουίτζι Γκαλβάνι	Luigi Galvani
Λουίτζι Πιραντέλλο	Luigi Pirandello
Φωταύγεια	Luminescence
Λουντ	Lund
Καρκίνος του πνεύμονα	Lung cancer
Λύκος (αστερισμός)	Lupus (constellation)
Λαούτο	Lute
Λουτήτιο	Lutetium
Λουξεμβούργο	Luxembourg
Κατηγορία:Λουξεμβούργο	Luxembourg
Λουξεμβούργο (πόλη)	Luxembourg (city)
Λυδία	Lydia
Λεμφικό σύστημα	Lymphatic system
Λυών	Lyon
Λύρα (αστερισμός)	Lyra
Διαιθυλαμίδιο του λυσεργικού οξέος	Lysergic acid diethylamide
Λυσόσωμα	Lysosome
M	M
Θεωρία-Μ	M-theory
MIME	MIME
MS-DOS	MS-DOS
Μακάου	Macau
Μάκβεθ	Macbeth
Μακεδονικό βασίλειο	Macedon
Μακεδονία (διαμέρισμα)	Macedonia (Greece)
Αριθμός Μαχ	Mach number
Μηχανή	Machine
Γλώσσα μηχανής	Machine code
Macintosh	Macintosh
Μακροοικονομία	Macroeconomics
Μαδαγασκάρη	Madagascar
Κατηγορία:Μαδαγασκάρη	Madagascar
Μαδέρα	Madeira
Μαντόνα	Madonna (entertainer)
Μαδρίτη	Madrid
Σικελική μαφία	Mafia
Μάγμα	Magma
Μάγκνα Κάρτα	Magna Carta
Μαγνήσιο	Magnesium
Μαγνητικό φάσμα	Magnetic field
Μαγνητική τομογραφία	Magnetic resonance imaging
Μαγνητισμός	Magnetism
Κατηγορία:Μαγνητισμός	Magnetism
Μαγνητίτης	Magnetite
Μαχάτμα Γκάντι	Mahatma Gandhi
Μαχαγιάνα	Mahayana
Μαϊμονίδης	Maimonides
Μάιν	Main
Κεντρικός υπολογιστής	Mainframe computer
Καλαμπόκι	Maize
Ταγματάρχης	Major
Μαγιόρκα	Majorca
Μαλάμπο	Malabo
Ελονοσία	Malaria
Κατηγορία:Μαλάουι	Malawi
Μαλαισία	Malaysia
Κατηγορία:Μαλαισία	Malaysia
Μαλδίβες	Maldives
Κατηγορία:Μαλδίβες	Maldives
Μάλι	Mali
Κατηγορία:Μάλι	Mali
Αγριόπαπια	Mallard
Μάλτα	Malta
Κατηγορία:Μάλτα	Malta
Μαλτεζική γλώσσα	Maltese language
Θηλαστικό	Mammal
Μαμούθ	Mammoth
Διοίκηση	Management
Μανάτος	Manatee
Μάντσεστερ	Manchester
Μανταρίνι	Mandarin orange
Μαγγάνιο	Manganese
Μάνγκο	Mango
Μανχάταν	Manhattan
Μανιτόμπα	Manitoba
Μανιερισμός	Mannerism
Μάνχαϊμ	Mannheim
Μανδύας (γεωλογία)	Mantle (geology)
Χειρόγραφο	Manuscript
Μάο Τσετούνγκ	Mao Zedong
Μαοϊσμός	Maoism
Μαπούτο	Maputo
Μαραθώνας	Marathon
Μάρμαρο	Marble
Μαρκ Σαγκάλ	Marc Chagall
Μαρσέλ Ντυσάν	Marcel Duchamp
Μαρσέλ Μαρσώ	Marcel Marceau
Μάρτιος	March
17 Μαρτίου	March 17
19 Μαρτίου	March 19
2 Μαρτίου	March 2
25 Μαρτίου	March 25
Μάρκο Πόλο	Marco Polo
Μάρκος Αυρήλιος	Marcus Aurelius
Βρούτος	Marcus Junius Brutus
Μάργκαρετ Θάτσερ	Margaret Thatcher
Μαρία Κάλλας	Maria Callas
Μαρία Αντουανέτα	Marie Antoinette
Μαρία Κιουρί	Marie Curie
Μάρκος Αντώνιος	Mark Antony
Μαρκ Τουαίην	Mark Twain
Μάρκετινγκ	Marketing
Κατηγορία:Μάρκετινγκ	Marketing
Μάρλεν Ντήτριχ	Marlene Dietrich
Μαρκήσιος ντε Σαντ	Marquis de Sade
Μαρακές	Marrakech
Γάμος	Marriage
Άρης	Mars (disambiguation)
Μαρς	Mars (mythology)
Μασσαλία	Marseille
Νήσοι Μάρσαλ	Marshall Islands
Κατηγορία:Νήσοι Μάρσαλ	Marshall Islands
Σχέδιο Μάρσαλ	Marshall Plan
Μαρσιποφόρα	Marsupial
Μάρτιν Χάιντεγκερ	Martin Heidegger
Μαρτίνος Λούθηρος	Martin Luther
Μάρτιν Λούθερ Κινγκ	Martin Luther King
Μάρτιν Σκορσέζε	Martin Scorsese
Μαρτινίκα	Martinique
Μαρξισμός	Marxism
Κατηγορία:Μαρξισμός	Marxism
Παναγία	Mary (mother of Jesus)
Μαρία Μαγδαληνή	Mary Magdalene
Μαίρη Σέλλεϋ	Mary Shelley
Μαζέρου	Maseru
Μάζα	Mass
Μαζικός αριθμός	Mass number
Μασαχουσέτη	Massachusetts
Κατηγορία:Μασαχουσέτη	Massachusetts
Τεχνολογικό Ινστιτούτο Μασαχουσέτης	Massachusetts Institute of Technology
Αυνανισμός	Masturbation
Σπίρτο	Match
Υλισμός	Materialism
Μαθηματική λογική	Mathematical logic
Μαθηματική απόδειξη	Mathematical proof
Μαθηματικά	Mathematics
Κατηγορία:Μαθηματικά	Mathematics
Ύλη	Matter
Μαυριτανία	Mauritania
Κατηγορία:Μαυριτανία	Mauritania
Μαυρίκιος (κράτος)	Mauritius
Κατηγορία:Μαυρίκιος	Mauritius
Μαξ Μπορν	Max Born
Μαξ Ερνστ	Max Ernst
Μαξ Πλανκ	Max Planck
Μαξ Βέμπερ	Max Weber
Μαξιμιανός	Maximian
Εξισώσεις Μάξγουελ	Maxwell's equations
Μάιος	May
1 Μαΐου	May 1
24 Μαΐου	May 24
Εφημερόπτερα	Mayfly
Δήμαρχος	Mayor
Μέκκα	Mecca
Μηχανολογία	Mechanical engineering
Κατηγορία:Επιστήμες Μηχανικών	Mechanical engineering
Κατηγορία:Μηχανική	Mechanics
Μηχανική (φυσική)	Mechanics
Μήδεια	Medea
Ιατρική	Medicine
Κατηγορία:Ιατρική	Medicine
Κατηγορία:Μεσόγειος Θάλασσα	Mediterranean
Μεσόγειος Θάλασσα	Mediterranean Sea
Μέδουσα (μυθολογία)	Medusa
Μαϊτνέριο	Meitnerium
Μελανησία	Melanesia
Πεπονιά	Melon
Μελπομένη	Melpomene
Τήξη	Melting
Σημείο τήξης	Melting point
Μέμφις (Αίγυπτος)	Memphis
Μεντελέβιο	Mendelevium
Μενέλαος	Menelaus
Μηνιγγίτιδα	Meningitis
Τράπεζα (αστερισμός)	Mensa (constellation)
Μέντα	Mentha
Υδράργυρος	Mercury (element)
Ερμής (πλανήτης)	Mercury (planet)
Μεσημβρινός	Meridian (geography)
Μεροβίγγειοι	Merovingian
Μέριλ Στριπ	Meryl Streep
Μεσολιθική περίοδος	Mesolithic
Μεσόνιο	Meson
Μεσοποταμία	Mesopotamia
Κατηγορία:Μεσοποταμία	Mesopotamia
Μεσόσφαιρα	Mesosphere
Μεσσίας	Messiah
Μεταδεδομένα	Metadata
Μέταλλα	Metal
Μεταλλοειδή	Metalloid
Μεταλλουργία	Metallurgy
Μεταφυσική	Metaphysics
Βροχή διαττόντων	Meteor shower
Μετεωρίτης	Meteorite
Μετέωρο	Meteoroid
Κατηγορία:Μετεωρολογία	Meteorology
Μετεωρολογία	Meteorology
Μέτρο (μονάδα μήκους)	Metre
Μετρικός χώρος	Metric space
Μεύσης	Meuse River
Μεξικό	Mexico
Κατηγορία:Μεξικό	Mexico
Πόλη του Μεξικού	Mexico City
Μαϊάμι	Miami
Αρχάγγελος Μιχαήλ	Michael (archangel)
Μάικλ Φαραντέι	Michael Faraday
Μισέλ Νέϋ	Michel Ney
Μιχαήλ Άγγελος	Michelangelo
Μίσιγκαν	Michigan
Μικροβιολογία	Microbiology
Μικροοικονομία	Microeconomics
Μικρονησία	Micronesia
Μικροοργανισμός	Microorganism
Μικροσκόπιον	Microscopium
Μικροκύματα	Microwave
Μεσαίωνας	Middle Ages
Κατηγορία:Μεσαίωνας	Middle Ages
Μέση Ανατολή	Middle East
Κατηγορία:Μέση Ανατολή	Middle East
Ήλιος του μεσονυχτίου	Midnight sun
Μιγκέλ ντε Θερβάντες	Miguel de Cervantes
Μιχαήλ Μπακούνιν	Mikhail Bakunin
Μιχαήλ Γκορμπατσώφ	Mikhail Gorbachev
Μιλάνο	Milan
Μίλι	Mile
Κατηγορία:Στρατός	Military
Γάλα	Milk
Γαλαξίας	Milky Way
Χιλιετία	Millennium
Χιλιοστόμετρο	Millimetre
Μίλτον Φρίντμαν	Milton Friedman
Ορυκτό	Mineral
Ορυκτολογία	Mineralogy
Μινέρβα	Minerva
Δυναστεία Μινγκ	Ming Dynasty
Μεταλλευτική	Mining
Υπουργός	Minister (government)
Μινωικός πολιτισμός	Minoan civilization
Μινώταυρος	Minotaur
Μινσκ	Minsk
Λεπτό	Minute
Θαύμα	Miracle
Κάτοπτρο	Mirror
Μισισιπής (ποταμός)	Mississippi River
Μιζούρι (πολιτεία)	Missouri
Μιζούρι (ποταμός)	Missouri River
Μιτοχόνδριο	Mitochondrion
Μνημοσύνη	Mnemosyne
Κινητό τηλέφωνο	Mobile phone
Μόντεμ	Modem
Μοντερνισμός	Modernism
Μοίρες	Moirae
Μολδαβία	Moldova
Κατηγορία:Μολδαβία	Moldova
Γραμμομόριο	Mole (unit)
Μοριακή Βιολογία	Molecular biology
Μόριο	Molecule
Μαλάκια	Mollusca
Κοκτέιλ μολότωφ	Molotov cocktail
Μολυβδαίνιο	Molybdenum
Ορμή	Momentum
Μονακό	Monaco
Κατηγορία:Μονακό	Monaco
Μοναρχία	Monarchy
Κατηγορία:Μοναρχία	Monarchy
Δευτέρα	Monday
Χρήμα	Money
Μογγολία	Mongolia
Μαγκούστα	Mongoose
Μονοκοτυλήδονο	Monocotyledon
Μονοπώλιο	Monopoly
Monopoly	Monopoly (game)
Μονοτρήματα	Monotreme
Μονς	Mons
Λευκό Όρος	Mont Blanc
Μαυροβούνιο	Montenegro
Κατηγορία:Μαυροβούνιο	Montenegro
Μοντεβιδέο	Montevideo
Μόντρεαλ	Montreal
Μοντσερράτ	Montserrat
Σελήνη	Moon
Μοραβία	Moravia
Μαρόκο	Morocco
Κατηγορία:Μαρόκο	Morocco
Κώδικας Μορς	Morse code
Ψηφιδωτό	Mosaic
Μόσχα	Moscow
Κατηγορία:Μόσχα	Moscow
Μωυσής	Moses
Μοσέ Νταγιάν	Moshe Dayan
Τζαμί	Mosque
Κουνούπι	Mosquito
Mossad	Mossad
Μοτέτο	Motet
Κίνηση	Motion (physics)
Μοτοσικλέτα	Motorcycle
Αραράτ	Mount Ararat
Άγιο Όρος	Mount Athos
Αίτνα	Mount Etna
Έβερεστ	Mount Everest
Φούτζι	Mount Fuji
Κιλιμάντζαρο	Mount Kilimanjaro
Όλυμπος	Mount Olympus
Βεζούβιος	Mount Vesuvius
Βουνό	Mountain
Ποντίκι (ζωολογία)	Mouse
Ποντίκι (υπολογιστές)	Mouse (computing)
Μοζαμβίκη	Mozambique
Κατηγορία:Μοζαμβίκη	Mozambique
Μι	Mu (letter)
Μουεζίνης	Muezzin
Μωάμεθ	Muhammad
Μοχάμεντ Άλι	Muhammad Ali
Μουριά (φυτό)	Mulberry
Πολλαπλή σκλήρυνση	Multiple sclerosis
Μούμια	Mummy
Μόναχο	Munich
Δήμος	Municipality
Μούρμανσκ	Murmansk
Μπανάνα	Musa (genus)
Μυία	Musca
Μούσες	Muse
Μουσείο	Museum
Μανιτάρι	Mushroom
Μουσική	Music
Κατηγορία:Μουσική	Music
MIDI	Musical Instrument Digital Interface
Κλίμακα (μουσική)	Musical scale
Μουσικολογία	Musicology
Μετάλλαξη	Mutation
Μυκήνες	Mycenae
Έμφραγμα του μυοκαρδίου	Myocardial infarction
Μυωπία	Myopia
Μυστικισμός	Mysticism
Μύθος	Myth
Μυθολογία	Mythology
Κατηγορία:Μυθολογία	Mythology
N	N
Ντζαμένα	N'Djamena
ΝΑΤΟ	NATO
Ναντίν Γκόρντιμερ	Nadine Gordimer
Ναδίρ	Nadir
Ναγκασάκι	Nagasaki
Ναχουάτλ γλώσσα	Nahuatl
Καρφί	Nail (fastener)
Ναϊρόμπι	Nairobi
Ναμίμπια	Namibia
Κατηγορία:Ναμίμπια	Namibia
Ναμούρ	Namur (city)
Νανσύ	Nancy
Ναντζίνγκ	Nanjing
Νανοτεχνολογία	Nanotechnology
Νάντη	Nantes
Νάπολη	Naples
Ναπολεόντειοι πόλεμοι	Napoleonic Wars
Νάρκισσος (μυθολογία)	Narcissus (mythology)
Έθνος (κοινωνιολογία)	Nation
NSA	National Security Agency
Εθνικός ύμνος	National anthem
Εθνικισμός	Nationalism
Κατηγορία:Εθνικισμός	Nationalism
Φυσικό αέριο	Natural gas
Φυσικός αριθμός	Natural number
Φυσική επιστήμη	Natural science
Φυσική επιλογή	Natural selection
Φύση	Nature
Κατηγορία:Φύση	Nature
Ναουρού	Nauru
Κατηγορία:Ναουρού	Nauru
Κατηγορία:Ναυσιπλοΐα	Navigation
Ναυσιπλοΐα	Navigation
Ναζαρέτ	Nazareth
Ναζιστική Γερμανία	Nazi Germany
Κατηγορία:Ναζιστική Γερμανία	Nazi Germany
Εθνικοσοσιαλιστικό Γερμανικό Εργατικό Κόμμα	Nazi Party
Νεμπράσκα	Nebraska
Ναβουχοδονόσορ Β'	Nebuchadrezzar II
Νεφέλωμα	Nebula
Γραβάτα	Necktie
Νηλ Άρμστρονγκ	Neil Armstrong
Νέλσον Μαντέλα	Nelson Mandela
Λέων της Νεμέας	Nemean Lion
Νέμεσις	Nemesis (mythology)
Νεοδύμιο	Neodymium
Νεολιθική περίοδος	Neolithic
Νεολογισμός	Neologism
Νέον	Neon
Νεοπλατωνισμός	Neoplatonism
Νεπάλ	Nepal
Κατηγορία:Νεπάλ	Nepal
Νέφθυς	Nephthys
Ποσειδώνας (πλανήτης)	Neptune
Ποσειδώνιο	Neptunium
Νηρηίδα (δορυφόρος)	Nereid (moon)
Νέρων	Nero
Νέρβας	Nerva
Νευρικό σύστημα	Nervous system
Φωλιά	Nest
Νεστοριανισμός	Nestorianism
Ολλανδία	Netherlands
Κατηγορία:Ολλανδία	Netherlands
Ολλανδικές Αντίλλες	Netherlands Antilles
Τοπολογία δικτύου	Network topology
Νευρολογία	Neurology
Νευρώνας	Neuron
Νευροδιαβιβαστής	Neurotransmitter
Νετρίνο	Neutrino
Νετρόνιο	Neutron
Αστέρας νετρονίων	Neutron star
Νέβας	Neva River
Νεβάδα	Nevada
Νέβιλ Τσάμπερλεν	Neville Chamberlain
Νέα Βρουνσβίκη	New Brunswick
Νέα Καληδονία	New Caledonia
Νέο Δελχί	New Delhi
Νέα Αγγλία	New England
Νέα Γουινέα	New Guinea
Νιου Χάμσαϊρ	New Hampshire
Νέο Μεξικό	New Mexico
Νέα Ορλεάνη	New Orleans
Καινή Διαθήκη	New Testament
Πρωτοχρονιά	New Year
Νέα Υόρκη (πολιτεία)	New York
Νέα Υόρκη	New York City
Νέα Ζηλανδία	New Zealand
Κατηγορία:Νέα Ζηλανδία	New Zealand
Νέα Γη	Newfoundland (island)
Νέα Γη και Λαμπραντόρ	Newfoundland and Labrador
Νιούπορτ	Newport
Νικαράγουα	Nicaragua
Κατηγορία:Νικαράγουα	Nicaragua
Νίκαια (Γαλλία)	Nice
Νικέλιο	Nickel
Νικόλαος Κοπέρνικος	Nicolaus Copernicus
Λευκωσία	Nicosia
Νικοτίνη	Nicotine
Νιλς Μπορ	Niels Bohr
Νιλς Χένρικ Άμπελ	Niels Henrik Abel
Νίγηρας	Niger
Κατηγορία:Νίγηρας	Niger
Νίγηρας ποταμός	Niger River
Νιγηρία	Nigeria
Κατηγορία:Νιγηρία	Nigeria
Νίκη (μυθολογία)	Nike (mythology)
Νίκολα Τέσλα	Nikola Tesla
Νείλος ποταμός	Nile
Νινευή	Nineveh
Νιόβιο	Niobium
Νιρβάνα	Nirvana
Άζωτο	Nitrogen
Νγιορντ	Njord
Νώε	Noah
Νόαμ Τσόμσκι	Noam Chomsky
Βραβείο Νόμπελ	Nobel Prize
Κατηγορία:Βραβεία Νόμπελ	Nobel Prize
Νομπέλιο	Nobelium
Ευγενή αέρια	Noble gas
Ονομαστική	Nominative case
Αμέταλλα	Nonmetal
Νησί Νόρφολκ	Norfolk Island
Γνώμων (αστερισμός)	Norma (constellation)
Νόρμαν Μέιλερ	Norman Mailer
Νορμανδία	Normandy
Νορν	Norn
Σκανδιναβική μυθολογία	Norse mythology
Κατηγορία:Σκανδιναβική μυθολογία	Norse mythology
Βορράς	North
Βόρεια Αφρική	North Africa
Βόρεια Αμερική	North America
Κατηγορία:Βόρεια Αμερική	North America
Βόρειο Νησί (Νέα Ζηλανδία)	North Island
Βόρεια Κορέα	North Korea
Κατηγορία:Βόρεια Κορέα	North Korea
Βόρειος Πόλος	North Pole
Βόρεια Θάλασσα	North Sea
Βόρειο Ημισφαίριο	Northern Hemisphere
Βόρεια Ιρλανδία	Northern Ireland
Βόρειες Μαριάνες Νήσοι	Northern Mariana Islands
Βορειοδυτικά Εδάφη	Northwest Territories
Νορβηγία	Norway
Κατηγορία:Νορβηγία	Norway
Κορόνα Νορβηγίας	Norwegian krone
Μύτη	Nose
Νουακσότ	Nouakchott
Ουσιαστικό	Noun
Νέα Σκωτία	Nova Scotia
Μυθιστόρημα	Novel
Νοέμβριος	November
1 Νοεμβρίου	November 1
11 Νοεμβρίου	November 11
2 Νοεμβρίου	November 2
5 Νοεμβρίου	November 5
Νοβοσιμπίρσκ	Novosibirsk
Νι	Nu (letter)
Πυρηνική σχάση	Nuclear fission
Πυρηνική σύντηξη	Nuclear fusion
Πυρηνική φυσική	Nuclear physics
Ατομική βόμβα	Nuclear weapon
Νουκλεϊκά οξέα	Nucleic acid
Νουκλεοτίδιο	Nucleotide
Αριθμός	Number
Κατηγορία:Αριθμοί	Numbers
Νομισματική	Numismatics
Κατηγορία:Νομισματική	Numismatics
Νούναβουτ	Nunavut
Νυρεμβέργη	Nuremberg
Μοσχοκαρυδιά	Nutmeg
Νύμφες	Nymph
O	O
Οργανισμός εξαγωγών πετρελαιοπαραγωγών χωρών	OPEC
Βελανιδιά	Oak
Βρώμη	Oat
Ομπ	Ob River
Αντικειμενοστρεφής προγραμματισμός	Object-oriented programming
Όμποε	Oboe
Αστεροσκοπείο	Observatory
Οψιανός	Obsidian
Ξυράφι του Όκαμ	Occam's razor
Ωκεανός	Ocean
Ωκεανία	Oceania
Κατηγορία:Ωκεανία	Oceania
Ωκεανίδες	Oceanid
Ωκεανογραφία	Oceanography
Ωκεανός (μυθολογία)	Oceanus
Οκταδικό σύστημα αρίθμησης	Octal
Οκτάς	Octans
Οκτώβριος	October
12 Οκτωβρίου	October 12
24 Οκτωβρίου	October 24
Χταπόδι	Octopus
Οδησσός	Odessa
Οντίν	Odin
Οδοντόγναθα	Odonata
Οδυσσέας (μυθολογία)	Odysseus
Οδύσσεια	Odyssey
Οιδίποδας	Oedipus
Οφσάιντ	Offside (football)
Οχάιο	Ohio
Ωμ (μονάδα μέτρησης)	Ohm
Νόμος του Ωμ	Ohm's law
Λάδι	Oil
Λάδι	Oil (disambiguation)
Οκτόμπερφεστ	Oktoberfest
Αρχαία σκανδιναβική γλώσσα	Old Norse
Παλαιά Διαθήκη	Old Testament
Ολιγαρχία	Oligarchy
Ελιά	Olive
Ελαιόλαδο	Olive oil
Ολυμπία	Olympia
Ολυμπιακοί Αγώνες	Olympic Games
Κατηγορία:Ολυμπιακοί Αγώνες	Olympics
Ομάν	Oman
Κατηγορία:Ομάν	Oman
Ωμέγα	Omega
Όμικρον	Omicron
Ομσκ	Omsk
Κρεμμύδι	Onion
Οντάριο	Ontario
Οντολογία	Ontology
Νέφος του Oort	Oort cloud
Opel	Opel
Όπερα	Opera
Opera (φυλλομετρητής)	Opera (Internet suite)
Λειτουργικό σύστημα	Operating system
Οπερέτα	Operetta
Οφιούχος (αστερισμός)	Ophiuchus
Οπτική	Optics
Κατηγορία:Οπτική	Optics
Βελτιστοποίηση	Optimization (mathematics)
Στοματικό σεξ	Oral sex
Πορτοκαλί	Orange (colour)
Πορτοκαλιά	Orange (fruit)
Ορατόριο	Oratorio
Συμφωνική ορχήστρα	Orchestra
Τάξη (βιολογία)	Order (biology)
Βενεδικτίνοι	Order of Saint Benedict
Ρίγανη	Oregano
Ορέστης	Orestes (mythology)
Οργανίδιο	Organelle
Οργανική Χημεία	Organic chemistry
Οργανική ένωση	Organic compound
Οργανισμός (βιολογία)	Organism
Οργασμός	Orgasm
Οριγκάμι	Origami
Ωριγένης	Origen
Ωρίων (αστερισμός)	Orion (constellation)
Ορφέας (μυθολογία)	Orpheus
Ορθογραφία	Orthography
Οσάκα	Osaka
Οσάμα μπιν Λάντεν	Osama bin Laden
Όσκαρ Ουάιλντ	Oscar Wilde
Ταλάντωση	Oscillation
Όσιρις	Osiris
Όσλο	Oslo
Οσμάν Α΄	Osman I
Όσμιο	Osmium
Οστεϊχθύες	Osteichthyes
Οστεοπόρωση	Osteoporosis
Οστράβα	Ostrava
Οθέλος	Othello
Οττάβα	Ottawa
Ότο φον Μπίσμαρκ	Otto von Bismarck
Οθωμανική αυτοκρατορία	Ottoman Empire
Κατηγορία:Οθωμανική αυτοκρατορία	Ottoman Empire
Οβίδιος	Ovid
Κουκουβάγια	Owl
Οξφόρδη	Oxford
Οξείδιο	Oxide
Οξυγόνο	Oxygen
Όζον	Ozone
P	P
PH	PH
Πάμπλο Πικάσο	Pablo Picasso
Ειρηνικός Ωκεανός	Pacific Ocean
Κατηγορία:Ειρηνικός Ωκεανός	Pacific Ocean
Πάδοβα	Padua
Παγανισμός	Paganism
Κατηγορία:Ζωγραφική	Painting
Πακιστάν	Pakistan
Κατηγορία:Πακιστάν	Pakistan
Βερσαλλίες (παλάτι)	Palace of Versailles
Παλάου	Palau
Κατηγορία:Παλάου	Palau
Παλαιολιθική περίοδος	Paleolithic
Παλαιοντολογία	Paleontology
Κατηγορία:Παλαιοντολογία	Paleontology
Παλαιοζωική εποχή	Paleozoic
Παλέρμο	Palermo
Παλαιστίνη (ιστορική περιοχή)	Palestine
Κατηγορία:Παλαιστίνη	Palestine
Καρκινική επιγραφή	Palindrome
Παλλάδιο	Palladium
Παλμύρα	Palmyra
Παμίρ	Pamir Mountains
Πάνας	Pan (mythology)
Παναμάς	Panama
Κατηγορία:Παναμάς	Panama
Διώρυγα Παναμά	Panama Canal
Πανδώρα	Pandora
Παγγαία	Pangaea
Πανθεϊσμός	Pantheism
Πάνθεον (Ρώμη)	Pantheon
Παπούα Νέα Γουινέα	Papua New Guinea
Κατηγορία:Παπούα Νέα Γουινέα	Papua New Guinea
Πάπυρος	Papyrus
Παραβολή (γεωμετρία)	Parabola
Παράκελσος	Paracelsus
Αλεξίπτωτο	Parachute
Αλεξίπτωτο πλαγιάς	Paragliding
Παραγουάη	Paraguay
Κατηγορία:Παραγουάη	Paraguay
Παραλληλόγραμμο	Parallelogram
Παραμαρίμπο	Paramaribo
Παραψυχολογία	Parapsychology
Παρασιτισμός	Parasitism
Περγαμηνή	Parchment
Παρίσι	Paris
Κατηγορία:Παρίσι	Paris
Πάρις	Paris (mythology)
Άρτιοι και περιττοί αριθμοί	Parity (mathematics)
Νόσος του Πάρκινσον	Parkinson's disease
Παρμενίδης	Parmenides
Παπαγάλος	Parrot
Παρσέκ	Parsec
Μαϊντανός	Parsley
Παρθενώνας	Parthenon
Παρθία	Parthia
Σωματιδιακή Φυσική	Particle physics
Κατηγορία:Σωματιδιακή Φυσική	Particle physics
Pascal	Pascal (programming language)
Πασκάλ	Pascal (unit)
Παστερίωση	Pasteurization
Ευρεσιτεχνία	Patent
Πάτρα	Patras
Πατριάρχης	Patriarch
Πωλ Γκωγκέν	Paul Gauguin
Πωλ Γιόχαν Λ. Χάισε	Paul Johann Ludwig von Heyse
Πάουλ Κλέε	Paul Klee
Πωλ Μακάρτνεϋ	Paul McCartney
Πωλ Βερλαίν	Paul Verlaine
Απόστολος Παύλος	Paul the Apostle
Πάουλ φον Χίντενμπουργκ	Paul von Hindenburg
Ταώς (αστρονομία)	Pavo (constellation)
Πιόνι (σκάκι)	Pawn (chess)
Ροδακινιά	Peach
Αχλαδιά	Pear
Περλ Χάρμπορ	Pearl Harbor
Πήγασος (μυθολογία)	Pegasus
Πήγασος (αστερισμός)	Pegasus (constellation)
Πελοπόννησος	Peloponnese
Πελοποννησιακός Πόλεμος	Peloponnesian War
Μολύβι	Pencil
Πηνελόπη	Penelope
Πιγκουίνος	Penguin
Χερσόνησος	Peninsula
Κανονικό πεντάγωνο	Pentagon
Πεντάγραμμο	Pentagram
Πεντηκοστή	Pentecost
Πεντηκοστιανισμός	Pentecostalism
Λαϊκή Δημοκρατία της Κίνας	People's Republic of China
Πέπσι κόλα	Pepsi
Πεπτίδιο	Peptide
Κρουστά μουσικά όργανα	Percussion instrument
Πετρίτης	Peregrine Falcon
Περικλής	Pericles
Περιοδικός πίνακας των χημικών στοιχείων	Periodic table
Πέρμια περίοδος	Permian
Περσεφόνη	Persephone
Περσέπολη	Persepolis
Περσέας	Perseus
Περσεύς (αστερισμός)	Perseus (constellation)
Περσία	Persian Empire
Περσικός Κόλπος	Persian Gulf
Περθ	Perth
Περού	Peru
Κατηγορία:Περού	Peru
Πέτρος Αβελάρδος	Peter Abelard
Πέτερ Πάουλ Ρούμπενς	Peter Paul Rubens
Πίτερ Σέλλερς	Peter Sellers
Πετρέλαιο	Petroleum
Πετρολογία	Petrology
Φανεροζωικός αιώνας	Phanerozoic
Φαραώ	Pharaoh
Φαρμακολογία	Pharmacology
Κατηγορία:Φαρμακευτική	Pharmacology
Φάρυγγας	Pharynx
Κατάσταση της ύλης	Phase (matter)
Φαινόλη	Phenol
Φαινομενολογία	Phenomenology
Φαινυλκετονουρία	Phenylketonuria
Φι	Phi (letter)
Φιλαδέλφεια (ΗΠΑ)	Philadelphia
Φιλοτελισμός	Philately
Φίλιππος Β'	Philip II of Macedon
Φίλιππος Β' της Ισπανίας	Philip II of Spain
Φιλιππίνες	Philippines
Κατηγορία:Φιλιππίνες	Philippines
Φιλολογία	Philology
Κατηγορία:Φιλολογία	Philology
Φιλοσοφία	Philosophy
Κατηγορία:Φιλοσοφία	Philosophy
Πνομ Πενχ	Phnom Penh
Φοβία	Phobia
Φόβος (δορυφόρος)	Phobos (moon)
Φοίνικες	Phoenicia
Φοίνικας	Phoenix
Φοίνιξ (αστερισμός)	Phoenix (constellation)
Φοίνικας (μυθολογία)	Phoenix (mythology)
Φώνημα	Phoneme
Φωνητική	Phonetics
Κατηγορία:Φωνητική	Phonetics
Φωνολογία	Phonology
Φωσφόρος	Phosphorus
Φωτογραφία	Photography
Κατηγορία:Φωτογραφία	Photography
Φωτόνιο	Photon
Φωτοσύνθεση	Photosynthesis
Φυσικοχημεία	Physical chemistry
Κατηγορία:Φυσικοχημεία	Physical chemistry
Φυσική	Physics
Κατηγορία:Φυσική	Physics
Φυσιολογία (βιολογία)	Physiology
Αριθμός π	Pi
Πι	Pi (letter)
Πιάνο	Piano
Οκρίβας	Pictor
Πεδεμόντιο	Piedmont
Πιέ Μοντριάν	Piet Mondrian
Πιέτερ Ζέεμαν	Pieter Zeeman
Πίλζεν	Pilsen
Πίνδαρος	Pindar
Πεύκο	Pine
Ανανάς	Pineapple
Ping	Ping
Ροζ	Pink
Πίζα	Pisa
Ιχθύες (αστερισμός)	Pisces (constellation)
Εικονοστοιχείο	Pixel
Πίτσα	Pizza
Πλανήτης	Planet
Πλαγκτόν	Plankton
Φυτό	Plant
Πλάσμα	Plasma (physics)
Πλαστίδιο	Plastid
Λευκόχρυσος	Platinum
Πλάτων	Plato
Πλειάδες (Αστρονομία)	Pleiades (star cluster)
Πλέβεν	Pleven
Πλίνιος ο Πρεσβύτερος	Pliny the Elder
Πλίνιος ο Νεότερος	Pliny the Younger
Πλωτίνος	Plotinus
Φιλιππούπολη	Plovdiv
Δαμάσκηνο	Plum
Πλούταρχος	Plutarch
Πλούτωνας (πλανήτης νάνος)	Pluto
Πλουτώνιο	Plutonium
Πνευμονία	Pneumonia
Podcasting	Podcast
Ποίηση	Poetry
Κατηγορία:Ποίηση	Poetry
Πογκρόμ	Pogrom
Σημείο	Point (geometry)
Δηλητήριο	Poison
Πουατιέ	Poitiers
Πόκερ	Poker
Πολωνία	Poland
Κατηγορία:Πολωνία	Poland
Πολική αρκούδα	Polar bear
Αστυνομία	Police
Κατηγορία:Πολιτική επιστήμη	Political science
Πολιτικός	Politician
Πολιτική	Politics
Κατηγορία:Πολιτική	Politics
Πολώνιο	Polonium
Πολύγωνο	Polygon
Πολυμνία	Polyhymnia
Πολυμερές	Polymer
Πολυνησία	Polynesia
Πολυώνυμο	Polynomial
Πομπήιος	Pompey
Πόντιος Πιλάτος	Pontius Pilate
Ποπ Αρτ	Pop art
Ποπ	Pop music
Πάπας	Pope
Πληθυσμός	Population
Λαϊκισμός	Populism
Πορνογραφία	Pornography
Λιμάνι	Port
Πορ Λουί	Port Louis
Πoρτ Μόρεσμπι	Port Moresby
Πόρτο	Porto
Πορτογαλία	Portugal
Κατηγορία:Πορτογαλία	Portugal
Ποσειδώνας (μυθολογία)	Poseidon
Ποζιτρόνιο	Positron
Γραμματόσημο	Postage stamp
Ταχυδρομικός κώδικας	Postal code
Κάλιο	Potassium
Πατάτα	Potato
Πότσδαμ	Potsdam
Στερλίνα	Pound sterling
Φτώχεια	Poverty
Ισχύς	Power (physics)
Πράγα	Prague
Κατηγορία:Πράγα	Prague
Πράια	Praia
Πρασινοδύμιο	Praseodymium
Προσευχή	Prayer
Προκάμβρια	Precambrian
Υετός	Precipitation (meteorology)
Εγκυμοσύνη	Pregnancy
Πρόεδρος	President
Πίεση	Pressure
Πρίαμος	Priam
Τιμή	Price
Ιερέας	Priest
Πρωτεύοντα θηλαστικά	Primate
Πρωθυπουργός	Prime minister
Πρώτος αριθμός	Prime number
Νήσος του Πρίγκηπα Εδουάρδου	Prince Edward Island
Φίλιππος, Δούκας του Εδιμβούργου	Prince Philip
Θεωρία της Σχετικότητας	Principle of relativity
Πρίσμα (οπτική)	Prism (optics)
Βραβείο Γκονκούρ	Prix Goncourt
Πιθανότητα	Probability theory
Προγραμματιστής	Programmer
Γλώσσα προγραμματισμού	Programming language
Έργο	Project
Προμηθέας	Prometheus
Προμήθειο	Promethium
Προπαγάνδα	Propaganda
Προπάνιο	Propane
Προφήτης	Prophet
Προστάτης	Prostate
Πρωτακτίνιο	Protactinium
Προτεκτοράτο	Protectorate
Πρωτεΐνη	Protein
Προτεροζωικός αιώνας	Proterozoic
Μεταρρύθμιση	Protestant Reformation
Προτεσταντισμός	Protestantism
Πρώτιστα	Protist
Κατηγορία:Πρώτιστα	Protista
Πρωτόνιο	Proton
Πρωτόζωο	Protozoa
Πρωσία	Prussia
Ψαλμός	Psalms
Ψευδοεπιστήμη	Pseudoscience
Ψι	Psi (letter)
Ψωρίαση	Psoriasis
Κατηγορία:Ψυχιατρική	Psychiatry
Ψυχολογία	Psychology
Κατηγορία:Ψυχολογία	Psychology
Δυναστεία των Πτολεμαίων	Ptolemaic dynasty
Κλαύδιος Πτολεμαίος	Ptolemy
Κοινό κτήμα	Public domain
Δημόσιες Σχέσεις	Public relations
Πουέρτο Ρίκο	Puerto Rico
Κατηγορία:Πουέρτο Ρίκο	Puerto Rico
Πούλα (Κροατία)	Pula
Τροχαλία	Pulley
Πάλσαρ	Pulsar
Κατηγορία:Πανκ μουσική	Punk
Πανκ	Punk rock
Κόρη (ανατομία)	Pupil
Πρύμνη (αστερισμός)	Puppis
Πυραμίδα (γεωμετρία)	Pyramid (geometry)
Πυρηναία	Pyrenees
Πύρρειος νίκη	Pyrrhic victory
Πυθαγόρας ο Σάμιος	Pythagoras
Python	Python (programming language)
Πυξίς	Pyxis
Q	Q
Κατάρ	Qatar
Κατηγορία:Κατάρ	Qatar
Δευτεροβάθμια εξίσωση	Quadratic equation
Τετράπλευρο	Quadrilateral
Κβαντική Μηχανική	Quantum mechanics
Κατηγορία:Κβαντική μηχανική	Quantum mechanics
Κουάρκ	Quark
Χαλαζίας	Quartz
Κβάζαρ	Quasar
Τετραδόνιο	Quaternion
Κεμπέκ (επαρχία)	Quebec
Κατηγορία:Κεμπέκ	Quebec
Κεμπέκ (πόλη)	Quebec City
Κέτσουα γλώσσα	Quechua
Βασίλισσα (σκάκι)	Queen (chess)
Κουέντιν Ταραντίνο	Quentin Tarantino
Κετζαλκοάτλ	Quetzalcoatl
Κίτο	Quito
R	R
RAF (αποσαφήνιση)	RAF (disambiguation)
RNA	RNA
Ρα	Ra
Ραμπάτ	Rabat
Ραββίνος	Rabbi
Ραμπιντρανάθ Ταγκόρ	Rabindranath Tagore
Ρατσισμός	Racism
Ραντάρ	Radar
Κατηγορία:Ραδιόφωνο	Radio
Ραδιοτηλεσκόπιο	Radio telescope
Ραδιενέργεια	Radioactive decay
Ραδιοχρονολόγηση	Radiocarbon dating
Ακτινολογία	Radiology
Ράδιο	Radium
Ακτίνα (γεωμετρία)	Radius
Ραδόνιο	Radon
Βροχή	Rain
Ουράνιο τόξο	Rainbow
Ράινερ Μαρία Ρίλκε	Rainer Maria Rilke
Ραμαζάνι	Ramadan
Μνήμη τυχαίας προσπέλασης	Random access memory
Ραφαήλ	Raphael
Αρχάγγελος Ραφαήλ	Raphael (archangel)
Κατηγορία:Μετρό	Rapid transit
Αρουραίος	Rat
Ρητός αριθμός	Rational number
Πραγματικός αριθμός	Real number
Ορθογώνιο παραλληλόγραμμο	Rectangle
Αναδρομή	Recursion
Ανακύκλωση	Recycling
Κόκκινο	Red
Φράξια Κόκκινος Στρατός	Red Army Faction
Αλεπού	Red Fox
Ερυθρά Θάλασσα	Red Sea
Ερυθρός νάνος	Red dwarf
Ερυθρός γίγαντας	Red giant
Δημοψήφισμα	Referendum
Διάθλαση	Refraction
Ρέγκε	Reggae
Ρεγγίνα	Regina
Ρεμς	Reims
Μετενσάρκωση	Reincarnation
Τάρανδος	Reindeer
Σχετικισμός	Relativism
Κατηγορία:Σχετικότητα	Relativity
Ηλεκτρονόμος	Relay
Θρησκεία	Religion
Κατηγορία:Θρησκεία	Religion
Κουάκεροι	Religious Society of Friends
Ρέμπραντ	Rembrandt
Αναγεννησιακή τέχνη	Renaissance
Αναπαραγωγή	Reproduction
Ερπετό	Reptile
Δημοκρατία της Κίνας	Republic of China
Δημοκρατία της Ιρλανδίας	Republic of Ireland
Κατηγορία:Ιρλανδία	Republic of Ireland
Δημοκρατία του Κονγκό	Republic of the Congo
Κατηγορία:Δημοκρατία του Κονγκό	Republic of the Congo
Ρεπουμπλικανικό Κόμμα (ΗΠΑ)	Republican Party (United States)
Αναπνευστικό σύστημα	Respiratory system
Δίκτυον	Reticulum
Επανάσταση	Revolution
Ρέα (δορυφόρος)	Rhea (moon)
Ρέα (μυθολογία)	Rhea (mythology)
Ρήνιο	Rhenium
Ρητορική	Rhetoric
Ρήνος	Rhine
Ρινόκερος	Rhinoceros
Ρω	Rho (letter)
Ρόουντ Άιλαντ	Rhode Island
Ρόδος	Rhodes
Ρόδιο	Rhodium
Ρόμβος	Rhombus
Ομοιοκαταληξία	Rhyme
Ριβόσωμα	Ribosome
Ρύζι	Rice
Ρίτσαρντ Φάινμαν	Richard Feynman
Ρίτσαρντ Νίξον	Richard Nixon
Ρίχαρντ Στράους	Richard Strauss
Ρίχαρντ Βάγκνερ	Richard Wagner
Ρίτσαρντ Ράιτ	Richard Wright (musician)
Ρίγα	Riga
Ρίγκελ	Rigel
Δακτύλιος (άλγεβρα)	Ring (mathematics)
Ρίνγκο Σταρ	Ringo Starr
Ρίο ντε Τζανέιρο	Rio de Janeiro
Ποταμός	River
Τάμεσης	River Thames
Ριάντ	Riyadh
Ρόαλντ Αμούνδσεν	Roald Amundsen
Ρόμπερτ Μπόιλ	Robert Boyle
Ρόμπερτ Ντε Νίρο	Robert De Niro
Ρόμπερτ Λη	Robert E. Lee
Ρόμπερτ Λούις Στίβενσον	Robert Louis Stevenson
Ρόμπερτ Οπενχάιμερ	Robert Oppenheimer
Ρόμπερτ Σούμαν	Robert Schumann
Ρομπέν των Δασών	Robin Hood
Ρομπότ	Robot
Πέτρωμα	Rock (geology)
Ροκ μουσική	Rock music
Κατηγορία:Ροκ μουσική	Rock music
Ροκοκό	Rococo
Τρωκτικά	Rodent
Ρεντγκένιο	Roentgenium
Καθολική Εκκλησία	Roman Catholic Church
Ρωμαϊκή Αυτοκρατορία	Roman Empire
Ρωμαϊκή Δημοκρατία	Roman Republic
Λεγεώνα	Roman legion
Ρωμαϊκές θεότητες	Roman mythology
Κατηγορία:Ρωμαϊκή μυθολογία	Roman mythology
Ρουμανία	Romania
Κατηγορία:Ρουμανία	Romania
Ρομανσική γλώσσα	Romansh
Ρομαντισμός	Romanticism
Ρώμη	Rome
Κατηγορία:Ρώμη	Rome
Ρόναλντ Ρήγκαν	Ronald Reagan
Πύργος (σκάκι)	Rook (chess)
Ρόζα Παρκς	Rosa Parks
Ροζάριο	Rosary
Δενδρολίβανο	Rosemary
Στήλη της Ροζέττας	Rosetta Stone
Ρότερνταμ	Rotterdam
Δρομολογητής	Router
Κωπηλασία	Rowing (sport)
Βρετανική Βασιλική Αεροπορία	Royal Air Force
Καουτσούκ	Rubber
Ρουβικώνας	Rubicon
Ρουβίδιο	Rubidium
Ρούντολφ Ες (πολιτικός)	Rudolf Hess
Ράντγιαρντ Κίπλινγκ	Rudyard Kipling
Ρωσία	Russia
Κατηγορία:Ρωσία	Russia
Ρουθήνιο	Ruthenium
Ραδερφόρντιο	Rutherfordium
Ρουάντα	Rwanda
Κατηγορία:Ρουάντα	Rwanda
Σίκαλη	Rye
S	S
Σαντάμ Χουσεΐν	Saddam Hussein
Κρόκος	Saffron
Βέλος (αστερισμός)	Sagitta
Τοξότης (αστερισμός)	Sagittarius (constellation)
Σαχάρα	Sahara
Απόστολος Ανδρέας	Saint Andrew
Άγιος Γεώργιος	Saint George
Άγιος Χριστόφορος και Νέβις	Saint Kitts and Nevis
Κατηγορία:Άγιος Χριστόφορος και Νέβις	Saint Kitts and Nevis
Άγιος Λαυρέντιος (ποταμός)	Saint Lawrence River
Αγία Λουκία	Saint Lucia
Κατηγορία:Αγία Λουκία	Saint Lucia
Άγιος Νικόλαος	Saint Nicholas
Άγιος Πατρίκιος	Saint Patrick
Απόστολος Πέτρος	Saint Peter
Αγία Πετρούπολη	Saint Petersburg
Κατηγορία:Αγία Πετρούπολη	Saint Petersburg
Άγιος Βικέντιος και Γρεναδίνες	Saint Vincent and the Grenadines
Κατηγορία:Άγιος Βικέντιος και Γρεναδίνες	Saint Vincent and the Grenadines
Σαλαντίν	Saladin
Σαλαμάνδρα	Salamander
Σαλέρνο	Salerno
Σάλιο	Saliva
Αλάτι	Salt
Άλας	Salt (chemistry)
Σάλτσμπουργκ	Salzburg
Σαμάρα (πόλη)	Samara
Σαμάριο	Samarium
Σαμαρκάνδη	Samarkand
Σαμόα	Samoa
Κατηγορία:Σαμόα	Samoa
Σάμιουελ Μπέκετ	Samuel Beckett
Σάμιουελ Μορς	Samuel F. B. Morse
Σαμουράι	Samurai
Σαν Φρανσίσκο	San Francisco
Άγιος Μαρίνος	San Marino
Κατηγορία:Άγιος Μαρίνος	San Marino
Σαν Σαλβαδόρ	San Salvador
Άμμος	Sand
Σάντρο Μποτιτσέλι	Sandro Botticelli
Σανσκριτική γλώσσα	Sanskrit
Άγιος Βασίλης	Santa Claus
Ζαφείρι	Sapphire
Σαπφώ	Sappho
Σαράγεβο	Sarajevo
Σαρκοφάγος	Sarcophagus
Σαρδηνία	Sardinia
Σάρι	Sari
Σασκάτσουαν	Saskatchewan
Τεχνητός δορυφόρος	Satellite
Σάββατο	Saturday
Κρόνος (πλανήτης)	Saturn
Σατούρνους	Saturn (mythology)
Σάτυροι	Satyr
Σαουδική Αραβία	Saudi Arabia
Κατηγορία:Σαουδική Αραβία	Saudi Arabia
Σαξωνία	Saxony
Κατηγορία:Σαξωνία	Saxony
Σαξόφωνο	Saxophone
Σκανδιναβία	Scandinavia
Κατηγορία:Σκανδιναβία	Scandinavia
Σκανδιναβική Χερσόνησος	Scandinavian Peninsula
Σκάνδιο	Scandium
Σχιζοφρένεια	Schizophrenia
Σχολαστικισμός	Scholasticism
Schutzstaffel	Schutzstaffel
Επιστήμη	Science
Κατηγορία:Επιστήμη	Science
Επιστημονική φαντασία	Science fiction
Επιστημονική μέθοδος	Scientific method
Επιστήμονας	Scientist
Σκιπίων	Scipio Africanus
Ψαλίδι	Scissors
Σκορπιός (αστερισμός)	Scorpius
Σκωτία	Scotland
Κατηγορία:Σκωτία	Scotland
Σκωτική γλώσσα	Scottish Gaelic
Προσκοπισμός	Scouting
Κατσαβίδι	Screwdriver
Γλύπτης (αστερισμός)	Sculptor (constellation)
Γλυπτική	Sculpture
Κατηγορία:Γλυπτική	Sculpture
Θάλασσα	Sea
Μέση Στάθμη Θάλασσας	Sea level
Θάλασσα Αζόφ	Sea of Azov
Θάλασσα του Μαρμαρά	Sea of Marmara
Σιμπόργκιο	Seaborgium
Μηχανή αναζήτησης	Search engine
Εποχές	Season
Σιάτλ	Seattle
Δευτερόλεπτο	Second
Β' Σταυροφορία	Second Crusade
Ιζηματογενές πέτρωμα	Sedimentary rock
Σεγκόβια	Segovia
Σηκουάνας	Seine
Σεισμολογία	Seismology
Σελήνη (μυθολογία)	Selene
Σελήνιο	Selenium
Σέλευκος Α' Νικάτωρ	Seleucus I Nicator
Σημασιολογία	Semantics
Ημιαγωγός	Semiconductor
Σημειωτική	Semiotics
Σημίτες	Semitic
Γερουσία	Senate
Σενεγάλη	Senegal
Κατηγορία:Σενεγάλη	Senegal
Σεούλ	Seoul
Χαρακίρι	Seppuku
Σεπτέμβριος	September
11 Σεπτεμβρίου	September 11
Επιθέσεις της 11ης Σεπτεμβρίου 2001	September 11
17 Σεπτεμβρίου	September 17
29 Σεπτεμβρίου	September 29
Μετάφραση των Εβδομήκοντα	Septuagint
Ακολουθία	Sequence
Σερβία	Serbia
Κατηγορία:Σερβία	Serbia
Σερβία και Μαυροβούνιο	Serbia and Montenegro
Σεργκέι Αϊζενστάιν	Sergei Eisenstein
Σεργκέι Ραχμάνινοφ	Sergei Rachmaninoff
Σειρά	Series (mathematics)
Σεροτονίνη	Serotonin
Όφις (αστερισμός)	Serpens
Εξυπηρετητής	Server (computing)
Σύνολο	Set
Σετ	Set (mythology)
Κατηγορία:Θεωρία συνόλων	Set theory
Επταετής Πόλεμος	Seven Years' War
Σεβίλλη	Seville
Γεννητικά όργανα	Sex organ
Σεξισμός	Sexism
Συνουσία	Sexual intercourse
Κατηγορία:Σεξουαλικότητα	Sexuality
Σεξουαλικώς μεταδιδόμενα νοσήματα	Sexually transmitted disease
Σεϋχέλλες	Seychelles
Κατηγορία:Σεϋχέλλες	Seychelles
Σαμανισμός	Shamanism
Σαγκάη	Shanghai
Καρχαρίας	Shark
Ασπίδα	Shield
Σιντοϊσμός	Shinto
Πλοίο	Ship
Στενογραφία	Shorthand
Σιβηρία	Siberia
Σικελία	Sicily
Κατηγορία:Σικελία	Sicily
Σιέρα Λεόνε	Sierra Leone
Κατηγορία:Σιέρα Λεόνε	Sierra Leone
Σίγμα	Sigma
Σίγκμουντ Φρόυντ	Sigmund Freud
Σίγκριντ Ούντσετ	Sigrid Undset
Σιχισμός	Sikhism
Σιλεσία	Silesia
Πυρίτιο	Silicon
Μετάξι	Silk
Άργυρος	Silver
Σιμόν ντε Μποβουάρ	Simone de Beauvoir
Χερσόνησος του Σινά	Sinai Peninsula
Σίνκλερ Λιούις	Sinclair Lewis
Σιγκαπούρη	Singapore
Κατηγορία:Σιγκαπούρη	Singapore
Σειρήνες	Siren
Σειρηνοειδή	Sirenia
Σείριος	Sirius
Καπέλα Σιξτίνα	Sistine Chapel
Σίσυφος	Sisyphus
Δέρμα	Skin
Σκόπια	Skopje
Ουρανοξύστης	Skyscraper
Δουλεία	Slavery
Ύπνος	Sleep
Σλοβακία	Slovakia
Κατηγορία:Σλοβακία	Slovakia
Σλοβενία	Slovenia
Κατηγορία:Σλοβενία	Slovenia
Φίδι	Snake
Χιόνι	Snow
Σοσιαλισμός	Socialism
Κατηγορία:Σοσιαλισμός	Socialism
Σοσιαλιστικό Κόμμα Γαλλίας	Socialist Party (France)
Κατηγορία:Κοινωνία	Society
Κοινωνία	Society
Αδελφότητα του Ιησού	Society of Jesus
Κοινωνιολογία	Sociology
Κατηγορία:Κοινωνιολογία	Sociology
Σωκράτης	Socrates
Νάτριο	Sodium
Σόφια	Sofia
Έδαφος	Soil
Ηλιακό σύστημα	Solar System
Κατηγορία:Ηλιακό Σύστημα	Solar System
Έκλειψη Ηλίου	Solar eclipse
Ηλιακή ενέργεια	Solar energy
Στερεό	Solid
Στερεό	Solid state
Σολομών	Solomon
Νήσοι Σολομώντα	Solomon Islands
Κατηγορία:Νήσοι Σολομώντα	Solomon Islands
Σόλων	Solon
Ηλιοστάσιο	Solstice
Διάλυμα	Solution
Σομαλία	Somalia
Κατηγορία:Σομαλία	Somalia
Σονάτα	Sonata
Τραγούδι	Song
Σονέτο	Sonnet
Σοφία Λόρεν	Sophia Loren
Σοφοκλής	Sophocles
Υψίφωνος	Soprano
Σορβόνη	Sorbonne
Ψυχή	Soul
Ήχος	Sound
Πηγαίος κώδικας	Source code
Νότος	South
Κατηγορία:Νότια Αφρική	South Africa
Νότια Αμερική	South America
Κατηγορία:Νότια Αμερική	South America
Νότιο Νησί (Νέα Ζηλανδία)	South Island
Νότια Κορέα	South Korea
Κατηγορία:Νότια Κορέα	South Korea
Νότιος Πόλος	South Pole
Νότιο Ημισφαίριο	Southern Hemisphere
Ένωση Σοβιετικών Σοσιαλιστικών Δημοκρατιών	Soviet Union
Κατηγορία:Σοβιετική Ένωση	Soviet Union
Χώρος	Space
Διαστημικό Λεωφορείο	Space Shuttle
Ισπανία	Spain
Κατηγορία:Ισπανία	Spain
Ισπανικός Εμφύλιος	Spanish Civil War
Κατηγορία:Ισπανοί	Spanish people
Σπάρτη	Sparta
Ειδική σχετικότητα	Special relativity
Είδος (βιολογία)	Species
Φασματοσκοπία	Spectroscopy
Ταχύτητα του φωτός	Speed of light
Σπηλαιολογία	Speleology
Σπένσερ Τρέισι	Spencer Tracy
Σφίγγα (μυθολογία)	Sphinx
Μπαχαρικό	Spice
Αράχνη	Spider
Σπιν	Spin (physics)
Σπανάκι	Spinach
Σπλήνας	Spleen
Σπλιτ	Split
Σπόγγος	Sponge
Αθλητισμός	Sport
Άνοιξη	Spring (season)
Σπρίνγκφιλντ (Ιλινόις)	Springfield
Spyware	Spyware
Τετράγωνο	Square (geometry)
Τετραγωνικό μέτρο	Square metre
Σρι Λάνκα	Sri Lanka
Κατηγορία:Σρι Λάνκα	Sri Lanka
Υαλογραφία	Stained glass
Ανοξείδωτος χάλυβας	Stainless steel
Στάνλεϊ Κιούμπρικ	Stanley Kubrick
Αστέρας	Star
Κράτος	State
Στατιστική μηχανική	Statistical mechanics
Στατιστική	Statistics
Κατηγορία:Στατιστική	Statistics
Άγαλμα της Ελευθερίας	Statue of Liberty
Ατμός	Steam
Χάλυβας	Steel
Στέφι Γκραφ	Steffi Graf
Στεγόσαυρος	Stegosaurus
Στήβεν Χώκινγκ	Stephen Hawking
Στέπα	Steppe
Στινγκ	Sting
Χρηματιστήριο αξιών	Stock exchange
Στοκχόλμη	Stockholm
Στωικισμός	Stoicism
Στομάχι	Stomach
Εποχή του Λίθου	Stone Age
Στόουνχεντζ	Stonehenge
Πελαργός	Stork
Πορθμός	Strait
Πορθμός του Μαγγελάνου	Strait of Magellan
Κατηγορία:Πορθμοί	Straits
Στρασβούργο	Strasbourg
Στρατηγική	Strategy
Στρωματογραφία	Stratigraphy
Στρατόσφαιρα	Stratosphere
Φράουλα	Strawberry
Θεωρία Χορδών	String theory
Εγκεφαλικό επεισόδιο	Stroke
Στρόντιο	Strontium
Στρουκτουραλισμός	Structuralism
Πρότυπο:Επέκταση	Stub
Στουτγκάρδη	Stuttgart
Στύγα	Styx
Εξάχνωση	Sublimation (chemistry)
Υποβρύχιο	Submarine
Υποσύνολο	Subset
Αφαίρεση	Subtraction
Σουδάν	Sudan
Κατηγορία:Σουδάν	Sudan
Σουντόκου	Sudoku
Διώρυγα Σουέζ	Suez Canal
Σούφι	Sufism
Ζάχαρη	Sugar
Σουχάρτο	Suharto
Θείο	Sulfur
Διοξείδιο του θείου	Sulfur dioxide
Θειικό οξύ	Sulfuric acid
Σουλτάνος	Sultan
Σουμέριοι	Sumer
Καλοκαίρι	Summer
Ήλιος	Sun
Κατηγορία:Ήλιος	Sun
Κυριακή	Sunday
Σουνίτες	Sunni Islam
Υπερυπολογιστής	Supercomputer
Σούπερμαν	Superman
Υπερκαινοφανείς αστέρες	Supernova
Επιφανειακή τάση	Surface tension
Χειρουργική	Surgery
Σουρινάμ	Suriname
Κατηγορία:Σουρινάμ	Suriname
Υπερρεαλισμός	Surrealism
Σάρρεϋ	Surrey
Αρχιπέλαγος Σβάλμπαρντ	Svalbard
Κύκνος (πτηνό)	Swan
Σβάστικα	Swastika
Σουαζιλάνδη	Swaziland
Κατηγορία:Σουαζιλάνδη	Swaziland
Σουηδία	Sweden
Κατηγορία:Σουηδία	Sweden
Κορόνα Σουηδίας	Swedish krona
Γλυκοπατάτα	Sweet potato
Κολύμβηση	Swimming
Κατηγορία:Κολύμβηση	Swimming
Ελβετικό Φράγκο	Swiss franc
Κατηγορία:Ελβετοί	Swiss people
Ελβετία	Switzerland
Κατηγορία:Ελβετία	Switzerland
Ξίφος	Sword
Σίδνεϊ	Sydney
Σύλβια Πλαθ	Sylvia Plath
Συμβίωση (βιολογία)	Symbiosis
Σύμβολο	Symbol
Συμφωνία (μουσική)	Symphony
Συναγωγή	Synagogue
Συναισθησία	Synesthesia
Σύνταξη	Syntax
Συρακούσες	Syracuse
Συρία	Syria
Κατηγορία:Συρία	Syria
Σύστημα	System
Συστηματική	Systematics
T	T
Τόμας Έντουαρντ Λόρενς	T. E. Lawrence
Τόμας Στερνς Έλιοτ	T. S. Eliot
Τραπέζι	Table (furniture)
Επιτραπέζια αντισφαίριση	Table tennis
Ταμπού	Taboo
Τάε Κβον Ντο	Taekwondo
Τάγος	Tagus
Ταϊτή	Tahiti
Τάι Τζί Σουάν	Tai chi chuan
Ταϊπέι	Taipei
Κατηγορία:Ταϊβάν	Taiwan
Τατζ Μαχάλ	Taj Mahal
Τατζικιστάν	Tajikistan
Κατηγορία:Τατζικιστάν	Tajikistan
Ταλίν	Tallinn
Ταλμούδ	Talmud
Τάμπερε	Tampere
Τανάκ	Tanakh
Ταγγέρη	Tangier
Τανγκό	Tango (dance)
Άρμα μάχης	Tank
Ταντάλιο	Tantalum
Τάνταλος	Tantalus
Τανζανία	Tanzania
Κατηγορία:Τανζανία	Tanzania
Ταοϊσμός	Taoism
Τάπιρος	Tapir
Τασκένδη	Tashkent
Θάλασσα της Τασμανίας	Tasman Sea
Τασμανία	Tasmania
Ταυ	Tau
Ταύρος (αστερισμός)	Taurus (constellation)
Κατηγορία:Φορολογία	Taxation
Ταξί	Taxicab
Ταξινομία	Taxonomy
Τιφλίδα	Tbilisi
Τσάι	Tea
Κατηγορία:Τσάι	Tea
Τεχνήτιο	Technetium
Τεχνολογία	Technology
Κατηγορία:Τεχνολογία	Technology
Τεχεράνη	Tehran
Τελ Αβίβ	Tel Aviv
Τηλεπικοινωνίες	Telecommunication
Τηλεγραφία	Telegraphy
Τηλέφωνο	Telephone
Τηλεσκόπιο	Telescope
Τηλεσκόπιον	Telescopium
Τηλεόραση	Television
Κατηγορία:Τηλεόραση	Television
Τελλούριο	Tellurium
Θερμοκρασία	Temperature
Ναός της Αρτέμιδος στην Έφεσο	Temple of Artemis
Δέκα εντολές	Ten Commandments
Τενερίφη	Tenerife
Τένεσι Ουίλιαμς	Tennessee Williams
Αντισφαίριση	Tennis
Τέρβιο	Terbium
Τερψιχόρη	Terpsichore
Τρομοκρατία	Terrorism
Κατηγορία:Τρομοκρατία	Terrorism
Τερτυλλιανός	Tertullian
Όρχεις	Testicle
Τηθύς (δορυφόρος)	Tethys (moon)
Τηθύς	Tethys (mythology)
Τέξας	Texas
Ταϊλάνδη	Thailand
Κατηγορία:Ταϊλάνδη	Thailand
Θαλής	Thales
Θάλεια (Μούσα)	Thalia
Θάλλιο	Thallium
Θάνατος (μυθολογία)	Thanatos
Ημέρα των Ευχαριστιών	Thanksgiving
Γκάμπια	The Gambia
Κατηγορία:Γκάμπια	The Gambia
Χάγη	The Hague
The Star-Spangled Banner	The Star-Spangled Banner
Θέατρο	Theatre
Κατηγορία:Θέατρο	Theatre
Θήβη (δορυφόρος)	Thebe (moon)
Θήβα	Thebes
Θήβαι (Αίγυπτος)	Thebes
Ευρυφάεσσα	Theia
Θέμις	Themis
Θεμιστοκλής	Themistocles
Τέοντορ Mόμσεν	Theodor Mommsen
Θεόδωρος Ρούζβελτ	Theodore Roosevelt
Θεοδόσιος Α'	Theodosius I
Κατηγορία:Θεολογία	Theology
Σχετικότητα	Theory of relativity
Θερμοδυναμική	Thermodynamics
Κατηγορία:Θερμοδυναμική	Thermodynamics
Θερμόμετρο	Thermometer
Θησέας	Theseus
Θεσσαλονίκη	Thessaloniki
Θεσσαλία	Thessaly
Θήτα	Theta
Θέτις	Thetis
Δεξαμενή σκέψης	Think tank
Γ' Σταυροφορία	Third Crusade
Χώρες του Τρίτου Κόσμου	Third World
Τριακονταετής Πόλεμος	Thirty Years' War
Θωμάς Ακινάτης	Thomas Aquinas
Τόμας Έντισον	Thomas Edison
Τόμας Χάρντι	Thomas Hardy
Τόμας Χομπς	Thomas Hobbes
Τόμας Τζέφερσον	Thomas Jefferson
Θωρ	Thor
Θόριο	Thorium
Θωθ	Thoth
Θράκη	Thrace
Θουκυδίδης	Thucydides
Θούλιο	Thulium
Θουριγγία	Thuringia
Πέμπτη	Thursday
Θυμάρι	Thyme
Θυμίνη	Thymine
Θυρεοειδής Αδένας	Thyroid
Τίβερης	Tiber
Θιβέτ	Tibet
Κατηγορία:Θιβέτ	Tibet
Παλίρροια	Tide
Γη του Πυρός	Tierra del Fuego
Τίγρης ποταμός	Tigris
Χρόνος	Time
Κατηγορία:Χρόνος	Time
Ζώνη ώρας	Time zone
Ταμερλάνος	Timur
Κασσίτερος	Tin
Τίρανα	Tirana
Τιτάνας	Titan (disambiguation)
Τιτάνας (δορυφόρος)	Titan (moon)
Τιτάνες	Titan (mythology)
Τιτάνιο	Titanium
Τιτσιάνο	Titian
Καπνός (φυτό)	Tobacco
Τόφου	Tofu
Τόγκο	Togo
Κατηγορία:Τόγκο	Togo
Τόκιο	Tokyo
Τολέδο	Toledo
Τομάτα	Tomato
Τόνος (μονάδα μέτρησης)	Ton
Τόνγκα	Tonga
Κατηγορία:Τόνγκα	Tonga
Γλώσσα (ανατομία)	Tongue
Τόνι Μόρρισον	Toni Morrison
Τόνος (μονάδα μέτρησης)	Tonne
Τόνι Μπλερ	Tony Blair
Εργαλείο	Tool
Δόντι	Tooth
Τοπολογία	Topology
Τορά	Torah
Σίφωνας	Tornado
Τορόντο	Toronto
Τορπίλη	Torpedo
Τουλόν	Toulon
Τουλούζη	Toulouse
Γύρος της Γαλλίας	Tour de France
Τουρισμός	Tourism
Πύργος της Βαβέλ	Tower of Babel
Πόλη	Town
Τοξικολογία	Toxicology
Τρακτέρ	Tractor
Τραγωδία	Tragedy
Τραίνο	Train
Τραϊανός	Trajan
Τρανζίστορ	Transistor
Transmission Control Protocol	Transmission Control Protocol
Κατηγορία:Μεταφορές	Transportation
Τραπέζιο	Trapezoid
Συνθήκη των Βερσαλλιών	Treaty of Versailles
Τρίγωνο	Triangle
Τρίγωνον	Triangulum
Τρίγωνον Νότιον	Triangulum Australe
Τριέρη	Trier
Τριγωνομετρική συνάρτηση	Trigonometric function
Τριγωνομετρία	Trigonometry
Τριλοβίτης	Trilobite
Τρινιντάντ (νησί)	Trinidad
Τρινιντάντ και Τομπάγκο	Trinidad and Tobago
Κατηγορία:Τρινιντάντ και Τομπάγκο	Trinidad and Tobago
Αγία Τριάδα	Trinity
Τρίτων (μυθολογία)	Triton (mythology)
Αψίδα θριάμβου	Triumphal arch
Δούρειος Ίππος	Trojan Horse
Τρωικός πόλεμος	Trojan War
Δούρειος Ίππος (υπολογιστές)	Trojan horse (computing)
Τρόλεϊ	Trolleybus
Τρόντχαϊμ	Trondheim
Τροπικός του Αιγόκερω	Tropic of Capricorn
Τροπόσφαιρα	Troposphere
Τροτσκισμός	Trotskyism
Τροία	Troy
Τρομπέτα	Trumpet
Τσάρος	Tsar
Τουαρέγκ	Tuareg
Τούμπα	Tuba
Φυματίωση	Tuberculosis
Τουκάνα	Tucana
Τρίτη	Tuesday
Τουλίπα	Tulip
Τούνδρα	Tundra
Βολφράμιο	Tungsten
Τύνιδα	Tunis
Τυνησία	Tunisia
Κατηγορία:Τυνησία	Tunisia
Αεριοστρόβιλος	Turbine
Τορίνο	Turin
Μηχανή Τούρινγκ	Turing machine
Τουρκία	Turkey
Κατηγορία:Τουρκία	Turkey
Τουρκμενιστάν	Turkmenistan
Κατηγορία:Τουρκμενιστάν	Turkmenistan
Τοσκάνη	Tuscany
Τουβαλού	Tuvalu
Κατηγορία:Τουβαλού	Tuvalu
Τυχό Μπραχέ	Tycho Brahe
Γραφομηχανή	Typewriter
Τυφών (μυθολογία)	Typhon
Τυραννόσαυρος Ρεξ	Tyrannosaurus
Τύρος	Tyre
Τυρρηνικό πέλαγος	Tyrrhenian Sea
U	U
ΟΥΝΕΣΚΟ	UNESCO
Ουγκάντα	Uganda
Κατηγορία:Ουγκάντα	Uganda
Ουκρανία	Ukraine
Κατηγορία:Ουκρανία	Ukraine
Ουλάν Μπατόρ	Ulan Bator
Οδυσσεύς Γκραντ	Ulysses S. Grant
Ομπρέλα	Umbrella
Αρχή της απροσδιοριστίας	Uncertainty principle
Ανεργία	Unemployment
Μονόκερως	Unicorn
ΑΤΙΑ	Unidentified flying object
Uniform Resource Locator	Uniform Resource Locator
Ένωση συνόλων	Union (set theory)
Ηνωμένα Αραβικά Εμιράτα	United Arab Emirates
Κατηγορία:Ηνωμένα Αραβικά Εμιράτα	United Arab Emirates
Ηνωμένο Βασίλειο	United Kingdom
Κατηγορία:Ηνωμένο Βασίλειο	United Kingdom
Οργανισμός Ηνωμένων Εθνών	United Nations
Κατηγορία:Οργανισμός Ηνωμένων Εθνών	United Nations
Ηνωμένες Πολιτείες της Αμερικής	United States
Κατηγορία:Ηνωμένες Πολιτείες	United States
Αμερικανικές Παρθένοι Νήσοι	United States Virgin Islands
Δολάριο ΗΠΑ	United States dollar
Σύμπαν	Universe
Πανεπιστήμιο	University
Unix	Unix
Ununbium	Ununbium
Ununpentium	Ununpentium
Ununtrium	Ununtrium
Ουψάλα	Uppsala
Ύψιλον	Upsilon
Ουρ	Ur
Ουράλια Όρη	Ural Mountains
Ουρανία	Urania
Ουράνιο	Uranium
Ουρανός (πλανήτης)	Uranus
Ουρανός (μυθολογία)	Uranus (mythology)
Μεγάλη Άρκτος	Ursa Major
Μικρά Άρκτος	Ursa Minor
Ουρουγουάη	Uruguay
Κατηγορία:Ουρουγουάη	Uruguay
Γιούτα	Utah
Ωφελιμισμός	Utilitarianism
Ουτοπία	Utopia
Ουτρέχτη (πόλη)	Utrecht (city)
Ουτρέχτη (επαρχία)	Utrecht (province)
Ουζμπεκιστάν	Uzbekistan
Κατηγορία:Ουζμπεκιστάν	Uzbekistan
V	V
Κενό	Vacuum
Βαντούζ	Vaduz
Κόλπος (ανατομία)	Vagina
Βαλένθια	Valencia
Βαλένθια (αποσαφήνιση)	Valencia
Βαλχάλλα	Valhalla
Βαλκυρίες	Valkyrie
Βαλέτα	Valletta
Βανάδιο	Vanadium
Βανκούβερ	Vancouver
Βανδαλισμός	Vandalism
Βανίρ	Vanir
Βανουάτου	Vanuatu
Κατηγορία:Βανουάτου	Vanuatu
Διακύμανση	Variance
Βάρνα (Βουλγαρία)	Varna
Βατικανό	Vatican City
Κατηγορία:Βατικανό	Vatican City
Διάνυσμα	Vector (spatial)
Βέγας	Vega
Χορτοφαγία	Vegetarianism
Φλέβα	Vein
Ιστία	Vela (constellation)
Βενεζουέλα	Venezuela
Κατηγορία:Βενεζουέλα	Venezuela
Βενετία	Venice
Αφροδίτη (πλανήτης)	Venus
Βένους	Venus (mythology)
Σπονδυλωτό	Vertebrate
Βέστα	Vesta (mythology)
Βίκτωρ Ουγκώ	Victor Hugo
Βικτωρία Βρετανικής Κολομβίας	Victoria
Βικτωρία (αποσαφήνιση)	Victoria
Ηλεκτρονικό παιχνίδι	Video game
Βιέννη	Vienna
Κατηγορία:Βιέννη	Vienna
Βιετνάμ	Vietnam
Κατηγορία:Βιετνάμ	Vietnam
Πόλεμος του Βιετνάμ	Vietnam War
Βίκινγκ	Viking
Βίλνιους	Vilnius
Βίνσεντ βαν Γκογκ	Vincent van Gogh
Βιόλα	Viola
Βία	Violence
Βιολί	Violin
Βιργίλιος	Virgil
Παρθένοι Νήσοι	Virgin Islands
Βιρτζίνια Γουλφ	Virginia Woolf
Παρθένος (αστερισμός)	Virgo (constellation)
Εικονική Πραγματικότητα	Virtual reality
Αρετή (φιλοσοφία)	Virtue
Ιός	Virus
Ιξώδες	Viscosity
Βιστούλας	Vistula
Βιταμίνη	Vitamin
Βιττόριο ντε Σίκα	Vittorio De Sica
Βίβιαν Λι	Vivien Leigh
Βλαντιμίρ Λένιν	Vladimir Lenin
Βλαντιμίρ Ναμπούκοφ	Vladimir Nabokov
Βλαντιμίρ Πούτιν	Vladimir Putin
Βλαδιβοστόκ	Vladivostok
Κλητική	Vocative case
Βότκα	Vodka
Ιχθύς Ιπτάμενος	Volans
Ηφαίστειο	Volcano
Ηφαιστειολογία	Volcanology
Βόλγας	Volga River
Βόλγογκραντ	Volgograd
Κατηγορία:Πετοσφαίριση	Volleyball
Βολτ	Volt
Διαφορά δυναμικού	Voltage
Βολταίρος	Voltaire
Όγκος	Volume
Φωνήεν	Vowel
Βούλκαν	Vulcan (mythology)
Λαϊκή Λατινική γλώσσα	Vulgar Latin
Βουλγάτα	Vulgate
Αλώπηξ (αστερισμός)	Vulpecula
Αιδοίο	Vulva
W	W
Νήσος Ουέηκ	Wake Island
Ουαλία	Wales
Κατηγορία:Ουαλία	Wales
Καρυδιά (φυτό)	Walnut
Ουώλτ Ντίσνεϋ	Walt Disney
Ουώλτ Ουίτμαν	Walt Whitman
Βάλτερ Γκρόπιους	Walter Gropius
Γουόλτερ Σκοτ	Walter Scott
Πόλεμος	War
Κατηγορία:Πόλεμος	War
Έγκλημα πολέμου	War crime
Πόλεμος της Ισπανικής Διαδοχής	War of the Spanish Succession
Βαρσοβία	Warsaw
Πλυντήριο ρούχων	Washing machine
Ουάσινγκτον (Περιφέρεια της Κολούμπια)	Washington
Ουάσινγκτον (πολιτεία)	Washington
Ουάσινγκτον (αποσαφήνιση)	Washington (disambiguation)
Βασίλι Καντίνσκι	Wassily Kandinsky
Απορρίμματα	Waste
Νερό	Water
Υδατοσφαίριση	Water polo
Καταρράκτης	Waterfall
Καρπούζι	Watermelon
Βατ (μονάδα μέτρησης)	Watt
Κιλοβατώρα	Watt-hour
Κύμα	Wave
Μήκος κύματος	Wavelength
Ασθενής αλληλεπίδραση	Weak interaction
Όπλο	Weapon
Καιρός	Weather
Web browser	Web browser
Ιστοσελίδα	Web page
Ιστότοπος	Website
Τετάρτη	Wednesday
Εβδομάδα	Week
Άρση βαρών	Weightlifting
Βαϊμάρη	Weimar
Δημοκρατία της Βαϊμάρης	Weimar Republic
Ουέλλινγκτον	Wellington
Βέρνερ φον Μπράουν	Wernher von Braun
Δυτική Όχθη	West Bank
Δυτική Αυστραλία	Western Australia
Δυτική Σαχάρα	Western Sahara
Κατηγορία:Δυτική Σαχάρα	Western Sahara
Ουίσκι	Whisky
Λευκός Οίκος	White House
Λευκός νάνος	White dwarf
Γουάιτχορς	Whitehorse
Δίκτυο ευρείας περιοχής	Wide area network
Βισμπάντεν	Wiesbaden
Ουίλλιαμ Μπλέηκ	William Blake
Ουίλιαμ Γκόλντινγκ	William Golding
Ουίλιαμ Χέρσελ	William Herschel
Γουΐλιαμ Τζέιμς	William James
Ουίλλιαμ ΜακΚίνλεϋ	William McKinley
Ουίλλιαμ Σαίξπηρ	William Shakespeare
Ιτιά	Willow
Βίλλυ Μπραντ	Willy Brandt
Αιολική ενέργεια	Wind power
Ανεμόμυλος	Windmill
Παράθυρο	Window
Κρασί	Wine
Κατηγορία:Κρασί	Wine
Γουίνιπεγκ	Winnipeg
Ουίνστων Τσώρτσιλ	Winston Churchill
Χειμώνας	Winter
Χειμερινοί Ολυμπιακοί Αγώνες	Winter Olympic Games
Κατηγορία:Χειμερινοί Ολυμπιακοί Αγώνες	Winter Olympic Games
Βόλφγκανγκ Αμαντέους Μότσαρτ	Wolfgang Amadeus Mozart
Γυναίκα	Woman
Ξύλο	Wood
Γούντροου Ουίλσον	Woodrow Wilson
Ξύλινα πνευστά της συμφωνικής ορχήστρας	Woodwind instrument
Γούντι Άλεν	Woody Allen
Επεξεργαστής εγγράφου	Word processor
Παγκόσμιος Μετεωρολογικός Οργανισμός	World Meteorological Organization
Παγκόσμιο Κέντρο Εμπορίου	World Trade Center
Παγκόσμιος Οργανισμός Εμπορίου	World Trade Organization
Α΄ Παγκόσμιος Πόλεμος	World War I
Κατηγορία:Α' Παγκόσμιος Πόλεμος	World War I
Β΄ Παγκόσμιος Πόλεμος	World War II
Κατηγορία:Β' Παγκόσμιος Πόλεμος	World War II
Παγκόσμιος Ιστός	World Wide Web
Παγκόσμιος Πόλεμος	World war
Σκουλήκι	Worm
Συστήματα γραφής	Writing system
X	X
Ακτίνες Χ	X-ray
Ξένο	Xenon
Ξενοφάνης	Xenophanes
Ξενοφών	Xenophon
Ξι	Xi
Y	Y
Τετραγράμματο	Yahweh
Πανεπιστήμιο Γέιλ	Yale University
Γιάλτα	Yalta
Γιάσερ Αραφάτ	Yasser Arafat
Έτος	Year
Κατηγορία:Έτη	Years
Κίτρινο	Yellow
Κίτρινη Θάλασσα	Yellow Sea
Υεμένη	Yemen
Κατηγορία:Υεμένη	Yemen
Γιερεβάν	Yerevan
Υγκντράσιλ	Yggdrasil
Γιόγκα	Yoga
Εθνικό πάρκο Γιοσέμιτι	Yosemite National Park
Υττέρβιο	Ytterbium
Ύτριο	Yttrium
Γιουγκοσλαβία	Yugoslavia
Κατηγορία:Γιουγκοσλαβία	Yugoslavia
Γιούκον	Yukon
Γιούρι Γκαγκάριν	Yuri Gagarin
Z	Z
Ζάγκρεμπ	Zagreb
Ζάμπια	Zambia
Κατηγορία:Ζάμπια	Zambia
Ζανζιβάρη	Zanzibar
Σαραγόσα	Zaragoza
Ζέβρα	Zebra
Ζενίθ	Zenith
Ζήνων (αυτοκράτορας)	Zeno (emperor)
Ζήνων ο Κιτιεύς	Zeno of Citium
Ζήνων ο Ελεάτης	Zeno of Elea
Ζήτα	Zeta
Δίας (μυθολογία)	Zeus
Δίας	Zeus (disambiguation)
Ζιμπάμπουε	Zimbabwe
Κατηγορία:Ζιμπάμπουε	Zimbabwe
Ψευδάργυρος	Zinc
Σιωνισμός	Zionism
Ζιρκόνιο	Zirconium
Ζωολογία	Zoology
Κατηγορία:Ζωολογία	Zoology
Ζωροάστρης	Zoroaster
Ζουλού	Zulu
