Ido	English
Zero	0 (number)
1	1
10	10
100	100
1000	1000
101	101
105	105
11	11
110	110
115	115
12	12
120	120
125	125
13	13
130	130
135	135
14	14
140	140
144	144
145	145
15	15
150	150
1530a yari	1530s
155	155
16	16
160	160
165	165
17	17
170	170
1728	1728
175	175
1750a yari	1750s
Kategorio:1750a yari	1750s
1760a yari	1760s
Kategorio:1760a yari	1760s
1770a yari	1770s
Kategorio:1770a yari	1770s
1780a yari	1780s
Kategorio:1780a yari	1780s
1790a yari	1790s
Kategorio:1790a yari	1790s
18	18
180	180
1820a yari	1820s
Kategorio:1820a yari	1820s
1830a yari	1830s
Kategorio:1830a yari	1830s
1840a yari	1840s
Kategorio:1840a yari	1840s
1850a yari	1850s
1860a yari	1860s
Kategorio:1860a yari	1860s
1870a yari	1870s
Kategorio:1870a yari	1870s
1880a yari	1880s
Kategorio:1880a yari	1880s
1890a yari	1890s
Kategorio:1890a yari	1890s
19	19
190	190
1900a yari	1900s
Kategorio:1900a yari	1900s
1920a yari	1920s
Kategorio:1920a yari	1920s
1930a yari	1930s
Kategorio:1930a yari	1930s
1940a yari	1940s
Kategorio:1940a yari	1940s
1950a yari	1950s
Kategorio:1950a yari	1950s
1960a yari	1960s
Kategorio:1960a yari	1960s
1970a yari	1970s
Kategorio:1970a yari	1970s
1980a yari	1980s
Kategorio:1980a yari	1980s
1990a yari	1990s
Kategorio:1990a yari	1990s
2	2
20	20
200	200
21	21
22	22
23	23
24	24
25	25
26	26
27	27
28	28
29	29
3	3
30	30
300	300
31	31
32	32
33	33
34	34
35	35
36	36
37	37
38	38
39	39
4	4
40	40
400	400
41	41
42	42
43	43
44	44
45	45
46	46
47	47
48	48
49	49
5	5
50	50
500	500
51	51
52	52
53	53
54	54
55	55
56	56
57	57
58	58
59	59
6	6
60	60
61	61
62	62
63	63
64	64
65	65
66	66
67	67
68	68
69	69
7	7
70	70
71	71
72	72
73	73
74	74
75	75
76	76
77	77
78	78
79	79
8	8
80	80
81	81
82	82
83	83
84	84
85	85
86	86
87	87
88	88
89	89
9	9
90	90
91	91
92	92
93	93
94	94
95	95
96	96
97	97
98	98
99	99
A	A
ABC	ABC
Orikteropo	Aardvark
Aarhus	Aarhus
Abdomino	Abdomen
Abidjan	Abidjan
Abraham Lincoln	Abraham Lincoln
Abu Dhabi	Abu Dhabi
Abu Dhabi	Abu Dhabi (emirate)
Abuja	Abuja
Acelero	Acceleration
Accra	Accra
Acetat-acido	Acetic acid
Acido	Acid
Aconcagua	Aconcagua
Akustiko	Acoustics
Kategorio:Akustiko	Acoustics
Acre (Brazilia)	Acre (state)
Aktiniumo	Actinium
Aktoro	Actor
Adam Smith	Adam Smith
Addis Ababa	Addis Ababa
Adiciono	Addition
Adolf Eichmann	Adolf Eichmann
Adolf Hitler	Adolf Hitler
Adriatiko	Adriatic Sea
Aeschylus	Aeschylus
Afganistan	Afghanistan
Kategorio:Afganistan	Afghanistan
Afrika	Africa
Kategorio:Afrika	Africa
Agatha Christie	Agatha Christie
Agrokultivo	Agriculture
Kategorio:Agrokultivo	Agriculture
Aeronavo	Aircraft
Akira Kurosawa	Akira Kurosawa
Al Gore	Al Gore
Al-Kaida	Al-Qaeda
Alabama	Alabama
Kategorio:Alabama	Alabama
Alan Turing	Alan Turing
Alaska	Alaska
Kategorio:Alaska	Alaska
Albania	Albania
Kategorio:Albania	Albania
Albany, Nova-York	Albany
Albatroso	Albatross
Albert Abraham Michelson	Albert Abraham Michelson
Albert Camus	Albert Camus
Albert Einstein	Albert Einstein
Albert Schweitzer	Albert Schweitzer
Alberta	Alberta
Kategorio:Alberta	Alberta
Alkemio	Alchemy
Alkoholo	Alcohol
Aldebaran	Aldebaran
Aldous Huxley	Aldous Huxley
Alexandr Soljenicyn	Aleksandr Solzhenitsyn
Alexander Fleming	Alexander Fleming
Alexander Graham Bell	Alexander Graham Bell
Alexander Pope	Alexander Pope
Alexandros la Magna	Alexander the Great
Alexis de Tocqueville	Alexis de Tocqueville
Alfred Dreyfus	Alfred Dreyfus
Alfred Hitchcock	Alfred Hitchcock
Alfred Nobel	Alfred Nobel
Algebro	Algebra
Kategorio:Algebro	Algebra
Aljeria	Algeria
Kategorio:Aljeria	Algeria
Aljer	Algiers
Alkeno	Alkene
Alegorio	Allegory
Allen Ginsberg	Allen Ginsberg
Alergio	Allergy
Aliteraco	Alliteration
Aloyo	Alloy
Alpha Centauri	Alpha Centauri
Alfabeto	Alphabet
Alzacia	Alsace
Alter	Altair
Alternanta fluo	Alternating current
Aluminio	Aluminium
Alvar Aalto	Alvar Aalto
Amazon	Amazon River
Sucino	Amber
Usana interna milito	American Civil War
Usana Samoa	American Samoa
Americio	Americium
Amhara linguo	Amharic
Amin-acido	Amino acid
Amman	Amman
Amoniako	Ammonia
Amfibia	Amphibian
Amplitudo	Amplitude
Amsterdam	Amsterdam
Anagramo	Anagram
Analizala geometrio	Analytic geometry
Anatole France	Anatole France
Kategorio:Anatomio	Anatomy
Anatomio	Anatomy
Ankro	Anchor
Anchorage, Alaska	Anchorage
Kategorio:Antiqueso	Ancient history
Andaluzia	Andalusia
Anders Celsius	Anders Celsius
Andora	Andorra
Kategorio:Andora	Andorra
Andrei Saharov	Andrei Sakharov
Andrew Jackson	Andrew Jackson
Andrew Johnson	Andrew Johnson
Andrew Lloyd Webber	Andrew Lloyd Webber
Andromeda	Andromeda (constellation)
Anestezio	Anesthesia
Angulo	Angle
Angola	Angola
Kategorio:Angola	Angola
Anguila	Anguilla
Animalo	Animal
Edukado	Animal husbandry
Ankara	Ankara
Annapolis, Maryland	Annapolis
Annapurna	Annapurna
Anodo	Anode
Formiko	Ant
Antananarivo	Antananarivo
Antarktika	Antarctica
Antropologio	Anthropology
Kategorio:Antropologio	Anthropology
Antibiotiko	Antibiotic
Antiga e Barbuda	Antigua and Barbuda
Kategorio:Antiga e Barbuda	Antigua and Barbuda
Antimonio	Antimony
Antoine Lavoisier	Antoine Lavoisier
Anton Chehov	Anton Chekhov
Antonio Vivaldi	Antonio Vivaldi
Anuso	Anus
Apia	Apia
Apoptozo	Apoptosis
Aprilo	April
14 di aprilo	April 14
Puglia	Apulia
Aquila	Aquila (constellation)
Aquitania	Aquitaine
Arabia	Arabian Peninsula
Arabiana linguo	Arabic language
Aram Hachaturyan	Aram Khachaturian
Arkeologio	Archaeology
Primtipo	Archetype
Archimede	Archimedes
Archipelago	Archipelago
Arkitekto	Architect
Arkitekturo	Architecture
Kategorio:Arkitekturo	Architecture
Arktika Oceano	Arctic Ocean
Areo	Area
Arjentinia	Argentina
Kategorio:Arjentinia	Argentina
Argono	Argon
Aristoteles	Aristotle
Aritmetiko	Arithmetic
Kategorio:Aritmetiko	Arithmetic
Arizona	Arizona
Kategorio:Arizona	Arizona
Arkansas	Arkansas
Kategorio:Arkansas	Arkansas
Armadilo	Armadillo
Armenia	Armenia
Kategorio:Armenia	Armenia
Armeniana linguo	Armenian language
Armeo	Army
Arnold Schönberg	Arnold Schoenberg
Arseno	Arsenic
Arto	Art
Artrito	Arthritis
Artropodo	Arthropod
Arthur Holly Compton	Arthur Compton
Arthur Conan Doyle	Arthur Conan Doyle
Arthur Miller	Arthur Miller
Arthur Rimbaud	Arthur Rimbaud
Arthur Schopenhauer	Arthur Schopenhauer
Artifical inteligenteso	Artificial intelligence
Category:Kanonaro	Artillery
Artisto	Artist
Kategorio:Arti	Arts
Aruba	Aruba
Kategorio:Aruba	Aruba
Azia	Asia
Kategorio:Azia	Asia
Asmara	Asmara
Astana	Astana
Astatino	Astatine
Asteroido-zono	Asteroid
Astronomiala unajo	Astronomical unit
Astronomio	Astronomy
Kategorio:Astronomio	Astronomy
Kategorio:Astrofiziko	Astrophysics
Athina	Athens
Atlanta, Georgia	Atlanta
Oceano Atlantiko	Atlantic Ocean
Atmosfero	Atmosphere
Atolo	Atoll
Atomo	Atom
Atomala nombro	Atomic number
Auckland	Auckland
Agosto	August
1 di agosto	August 1
15 di agosto	August 15
6 di agosto	August 6
Augusta, Maine	Augusta
Auguste Rodin	Auguste Rodin
Augustinus	Augustine of Hippo
Austin, Texas	Austin
Australia	Australia
Kategorio:Australia	Australia
Australiana dolaro	Australian dollar
Austria	Austria
Kategorio:Austria	Austria
Austria-Hungaria	Austria-Hungary
Autismo	Autism
Arvernia	Auvergne (region)
Avantgarde	Avant-garde
Avignon	Avignon
Hakilo	Axe
Axiomo	Axiom
Azerbaijan	Azerbaijan
Kategorio:Azerbaijan	Azerbaijan
Acori	Azores
B	B
Babuino	Baboon
Babilono	Babylon
Bakterio	Bacteria
Bagdad	Baghdad
Kategorio:Bahama	Bahamas
Bahrain	Bahrain
Kategorio:Bahrain	Bahrain
Baku	Baku
Baleari	Balearic Islands
Baltika Maro	Baltic Sea
Bamako	Bamako
Banano	Banana
Bangkok	Bangkok
Bangladesh	Bangladesh
Kategorio:Bangladesh	Bangladesh
Bangui	Bangui
Banjul	Banjul
Barbados	Barbados
Kategorio:Barbados	Barbados
Barbra Streisand	Barbra Streisand
Barcelona	Barcelona
Bario	Barium
Bazalto	Basalt
Bazo	Base (chemistry)
Basilikata	Basilicata
Korbobalono	Basketball
Kategorio:Korbobalono	Basketball
Basa Normandia	Basse-Normandie
Basseterre	Basseterre
Vespertilio	Bat
Baton Rouge	Baton Rouge
Hastings-batalio	Battle of Hastings
Lepanto-batalio	Battle of Lepanto (1571)
Midway-batalio	Battle of Midway
Trafalgar-navala batalio	Battle of Trafalgar
Verdun-batalio	Battle of Verdun
Somme-batalio	Battle of the Somme
Bavaria	Bavaria
Bayoneto	Bayonet
Urso	Bear
Abelo	Bee
Biro	Beer
Koleoptero	Beetle
Beijing	Beijing
Beirut	Beirut
Bielorusia	Belarus
Kategorio:Bielorusia	Belarus
Belfast	Belfast
Belgia	Belgium
Kategorio:Belgia	Belgium
Belgrade	Belgrade
Belize	Belize
Kategorio:Belize	Belize
Belo Horizonte	Belo Horizonte
Benin	Benin
Kategorio:Benin	Benin
Benito Mussolini	Benito Mussolini
Benjamin Harrison	Benjamin Harrison
Beowulf	Beowulf
Berkelio	Berkelium
Berlin	Berlin
Bermuda	Bermuda
Bern	Berne
Bernhard Riemann	Bernhard Riemann
Bero	Berry
Bertolt Brecht	Bertolt Brecht
Bertrand Russell	Bertrand Russell
Berilio	Beryllium
Betelgeuse	Betelgeuse
Bette Davis	Bette Davis
Beverly Hills	Beverly Hills
Bhutan	Bhutan
Kategorio:Bhutan	Bhutan
Biblo	Bible
Biciklo	Bicycle
Bilo	Bile
Bill Clinton	Bill Clinton
Bill Gates	Bill Gates
Duopla stelo	Binary star
Biokemio	Biochemistry
Kategorio:Biokemio	Biochemistry
Biografio	Biography
Biologio	Biology
Kategorio:Biologio	Biology
Birko	Birch
Ucelo	Bird
Bishkek	Bishkek
Bismarck, Norda-Dakota	Bismarck
Bismuto	Bismuth
Bissau	Bissau
Bivalvo	Bivalvia
Nigra Maro	Black Sea
Nigra truo	Black hole
Pipro nigra	Black pepper
Blaise Pascal	Blaise Pascal
Balaenoptera musculus	Blue Whale
Apro	Boar
Tablo-ludo	Board game
Bob Dylan	Bob Dylan
Bob Marley	Bob Marley
Boise, Idaho	Boise
Bolivia	Bolivia
Kategorio:Bolivia	Bolivia
Bologna	Bologna
Silk-vermo	Bombyx mori
Osto	Bone
Medulo	Bone marrow
Libro	Book
Booleana algebro	Boolean algebra (structure)
Bordeaux	Bordeaux
Boris Pasternak	Boris Pasternak
Borono	Boron
Bosnia e Herzegovina	Bosnia and Herzegovina
Kategorio:Bosnia e Herzegovina	Bosnia and Herzegovina
Boston	Boston
Shablono:Bot	Bot
Botaniko	Botany
Kategorio:Botaniko	Botany
Botswana	Botswana
Kategorio:Botswana	Botswana
Burgundia	Bourgogne
Bouvet Insulo	Bouvet Island
Cerebro	Brain
Bram Stoker	Bram Stoker
Brandenburg	Brandenburg
Bratislava	Bratislava
Brazilia	Brazil
Kategorio:Brazilia	Brazil
Brazzaville	Brazzaville
Mamo	Breast
Bremen (urbo)	Bremen
Bremen (stato)	Bremen (state)
Bretonia	Bretagne
Kategorio:Ponto	Bridges
Bridgetown	Bridgetown
Bristol	Bristol
British Columbia	British Columbia
Virgin-Insuli Britana	British Virgin Islands
Bromo	Bromine
Brunei	Brunei
Kategorio:Brunei	Brunei
Bruxel	Brussels
Bucarest	Bucharest
Budapest	Budapest
Budismo	Buddhism
Buddy Holly	Buddy Holly
Buenos Aires	Buenos Aires
Buffalo, Nova-York	Buffalo
Bujumbura	Bujumbura
Bulgaria	Bulgaria
Kategorio:Bulgaria	Bulgaria
Burdono	Bumblebee
Burkina Faso	Burkina Faso
Kategorio:Burkina Faso	Burkina Faso
Myanmar	Burma
Kategorio:Myanmar	Burma
Kategorio:Burundi	Burundi
Buster Keaton	Buster Keaton
C	C
Turmo nacionala di Kanada	CN Tower
Kadmio	Cadmium
Cesio	Caesium
Kafeino	Caffeine
Kalabria	Calabria
Calais	Calais
Kalcio	Calcium
Kalkulilo	Calculator
Kalkulo	Calculus
Kalendario	Calendar
Kalifornia	California
Kategorio:Kalifornia	California
Kalifornio	Californium
Calvin Coolidge	Calvin Coolidge
Kambodja	Cambodia
Kategorio:Kambodja	Cambodia
Cambridge	Cambridge
Kamelo	Camel
Kamero	Camera
Kamerun	Cameroon
Kategorio:Kamerun	Cameroon
Kampania	Campania
Kanada	Canada
Kategorio:Kanada	Canada
Kanarii	Canary Islands
Canberra	Canberra
Kanabo	Cannabis
Cannes	Cannes
Canterbury	Canterbury
Kondensatoro	Capacitor
Kabo Verda	Cape Verde
Kategorio:Kabo Verda	Cape Verde
Kabo de Bon Espero	Cape of Good Hope
Karakalo	Caracal
Caracas	Caracas
Karato	Carat (mass)
Karbo	Carbon
Karbo dioxido	Carbon dioxide
Lud-kartaro	Card game
Cardiff	Cardiff
Kategorio:Kordio-vaskularo	Cardiovascular system
Category:Karibeano	Caribbean
Karibeano	Caribbean Sea
Karikaturo	Caricature
Carl David Anderson	Carl David Anderson
Karnivoro	Carnivore
Carolus Linnaeus	Carolus Linnaeus
Carson City	Carson City
Kartago	Carthage
Kazablanka	Casablanca
Castries	Castries
Kato	Cat
Katalunia	Catalonia
Katalizo	Catalysis
Katodo	Cathode
Kaukazia	Caucasus
Cayenne	Cayenne
Kaiman-Insuli	Cayman Islands
Cecil Rhodes	Cecil Rhodes
Kategorio:Cielala mekaniko	Celestial mechanics
Cielala sfero	Celestial sphere
Celulo	Cell (biology)
Celulozo	Cellulose
Centrafrika	Central African Republic
Kategorio:Central Afrikana Republiko	Central African Republic
Kategorio:Centr-Amerika	Central America
Centrala nervaro	Central nervous system
Centro (Francia)	Centre
Cerebelo	Cerebellum
Ceres	Ceres (dwarf planet)
Cerio	Cerium
Cesare Borgia	Cesare Borgia
Chad	Chad
Kategorio:Chad	Chad
Chamo	Chamois
Champania Ardeni	Champagne-Ardenne
Tunelo sub la Mancho	Channel Tunnel
Karl la Granda	Charlemagne
Charles Baudelaire	Charles Baudelaire
Charles Darwin	Charles Darwin
Charles Dickens	Charles Dickens
Charles Fourier	Charles Fourier
Charles Lindbergh	Charles Lindbergh
Charles Thomson Rees Wilson	Charles Thomson Rees Wilson
Charles de Gaulle	Charles de Gaulle
Charleston, Westa-Virginia	Charleston
Charlie Chaplin	Charlie Chaplin
Charlie Parker	Charlie Parker
Chechenia	Chechnya
Fromajo	Cheese
Gepardo	Cheetah
Kemia ligo	Chemical bond
Kemiala kompozito	Chemical compound
Kemia elemento	Chemical element
Kruda formulo	Chemical formula
Kemiala reakto	Chemical reaction
Kemio	Chemistry
Kategorio:Kemio	Chemistry
Chemnitz	Chemnitz
Shak-ludo	Chess
Chester Arthur	Chester A. Arthur
Kastano	Chestnut
Cheyenne, Wyoming	Cheyenne
Chicago	Chicago
Hano	Chicken
Parturo	Childbirth
Chili	Chile
Kategorio:Chili	Chile
Chimpanzeo	Chimpanzee
Kategorio:Chinia	China
Chitino	Chitin
Kloro	Chlorine
Chokolado	Chocolate
Christiaan Huygens	Christiaan Huygens
Christian Dior	Christian Dior
Kristanismo	Christianity
Kategorio:Kristanismo	Christianity
Cristoforo Colombo	Christopher Columbus
Kromio	Chromium
Chuck Berry	Chuck Berry
Clark Gable	Clark Gable
Claude Monet	Claude Monet
Clement Attlee	Clement Attlee
Kategorio:Klimato	Climate
Kategorio:Vesto	Clothing
Knidulo	Cnidaria
Karbono	Coal
Kobalto	Cobalt
Kokaino	Cocaine
Kocinelo	Coccinellidae
Kakatuo	Cockatoo
Blato	Cockroach
Kolda milito	Cold War
Koloido	Colloid
Köln	Cologne
Kolumbia	Colombia
Kategorio:Kolumbia	Colombia
Colombo	Colombo
Koloro	Color
Kolor-blindeso	Color blindness
Kolorado	Colorado
Kategorio:Kolorado	Colorado
Columbia, Suda-Karolina	Columbia
Kolombo	Columbidae
Columbus, Ohio	Columbus
Kometo	Comet
Category:Komerco	Commerce
Category:Komuniko	Communication
Komunismo	Communism
Komori	Comoros
Kategorio:Komori	Comoros
CD	Compact Disc
Ordinatro	Computer
Programo	Computer program
Kategorio:Programado	Computer programming
Informatiko	Computer science
Kategorio:Informatiko	Computer science
Category:Informatiko	Computing
Conakry	Conakry
Koncentro	Concentration
Concord, Nova-Hampshire	Concord
Kongo (homonimo)	Congo
Connecticut	Connecticut
Kategorio:Connecticut	Connecticut
Conquistador	Conquistador
Konsonanto	Consonant
Konstantinopolo	Constantinople
Stelaro	Constellation
Konstituco	Constitution (political)
Konsumo	Consumption (economics)
Kontinento	Continent
Kontrato	Contract
Koquarto	Cooking
UTC	Coordinated Universal Time
København	Copenhagen
Kupro	Copper
Kormorano	Cormorant
Kornwal	Cornwall
Korodo	Corrosion
Korsika	Corsica
Kosmala radii	Cosmic ray
Kosmologio	Cosmology
Kosta Rika	Costa Rica
Kategorio:Kosta Rika	Costa Rica
Cotonou	Cotonou
Kotono	Cotton
Koyoto	Coyote
Kankro-nebuloso	Crab Nebula
Gruo	Crane (bird)
Kriketo	Cricket
Grilio	Cricket (insect)
Krimino	Crime
Kroatia	Croatia
Kategorio:Kroatia	Croatia
Krokodilo	Crocodile
Korvo	Crow
Krustaceo	Crustacean
Kristalo	Crystal
Kategorio:Kristalografio	Crystallography
Kuba	Cuba
Kategorio:Kuba	Cuba
Kubismo	Cubism
Kukombro	Cucumber
Kulturo	Culture
Kategorio:Kulturo	Culture
Curitiba	Curitiba
Kuriumo	Curium
Kurvo	Curve
Cyberpunk	Cyberpunk
Biciklado	Cycling
Cilindro	Cylinder (geometry)
Chipro	Cyprus
Kategorio:Chipro	Cyprus
Kirila alfabeto	Cyrillic alphabet
Chekia	Czech Republic
Kategorio:Chekia	Czech Republic
Chekoslovakia	Czechoslovakia
D	D
DVD	DVD
Dadaismo	Dada
Dakar	Dakar
Damascus	Damascus
Daniel Bernoulli	Daniel Bernoulli
Daniel Ortega	Daniel Ortega
Sombra materio	Dark matter
David Livingstone	David Livingstone
Morto	Death
Yardeko	Decade
Decembro	December
31 di decembro	December 31
8 di decembro	December 8
Cervo	Deer
Grado	Degree
Delaware	Delaware
Kategorio:Delaware	Delaware
Demokratio	Democracy
Demokratial Republiko Kongo	Democratic Republic of the Congo
Kategorio:Demokratial Republiko Kongo	Democratic Republic of the Congo
Dania	Denmark
Kategorio:Dania	Denmark
Gabor Dennis	Dennis Gabor
Specifika pezo	Density
Denver	Denver
Derivajo	Derivative
Des Moines, Iowa	Des Moines
Dezerto	Desert
Erasmus de Rotterdam	Desiderius Erasmus
Detroit	Detroit
Dewey decimala klasifiko	Dewey Decimal Classification
Dhaka	Dhaka
Dhaulagiri	Dhaulagiri
Dialekto	Dialect
Dialektiko	Dialectic
Diametro	Diameter
Diana Spenser	Diana
Vorto-libro	Dictionary
Kategorio:Digestiva sistemo	Digestive system
Dimensiono	Dimension
Diodo	Diode
Diftongo	Diphthong
Kategorio:Homonimi	Disambiguation
Morbo	Disease
Disto	Distance
Diviziono	Division (military)
Dizzy Gillespie	Dizzy Gillespie
Kategorio:Djibouti	Djibouti
Dmitri Mendeleev	Dmitri Mendeleev
Dronto	Dodo
Dodoma	Dodoma
Hundo	Dog
Doha	Doha
Delfino	Dolphin
Dominika	Dominica
Kategorio:Dominika	Dominica
Dominikana Republiko	Dominican Republic
Kategorio:Dominikana Republiko	Dominican Republic
Asno	Donkey
Doris Lessing	Doris Lessing
Dover, Delaware	Dover
Dramatiko	Drama
Revo	Dream
Dresden	Dresden
Druidismo	Druid
Dubai	Dubai
Dublin	Dublin
Anado	Duck
Duyongo	Dugong
Duke Ellington	Duke Ellington
Universitato di Duke	Duke University
Dushanbe	Dushanbe
Dwight D. Eisenhower	Dwight D. Eisenhower
Veloceso	Dynamics (physics)
Dislexio	Dyslexia
Disprozio	Dysprosium
Aglo	Eagle
Orelo	Ear
Tero	Earth
Kategorio:Tero	Earth
Ter-tremo	Earthquake
Est-Germania	East Germany
Timor Leste	East Timor
Ekidno	Echidna
Ekliptiko	Ecliptic
Ekologio	Ecology
Kategorio:Ekologio	Ecology
Ekonomiko	Economics
Kategorio:Ekonomiko	Economics
Ekonomiko	Economy
Biocirkumaro	Ecosystem
Equador	Ecuador
Kategorio:Equador	Ecuador
Edgar Allan Poe	Edgar Allan Poe
Edgar Degas	Edgar Degas
Edinburgh	Edinburgh
Edmonton	Edmonton
Edmund Hillary	Edmund Hillary
Eduard Buchner	Eduard Buchner
Edvard Grieg	Edvard Grieg
Edwin Hubble	Edwin Hubble
Anguilo	Eel
Egiptia	Egypt
Kategorio:Egiptia	Egypt
Eiffel Turmo	Eiffel Tower
Einsteinio	Einsteinium
Salvadoria	El Salvador
Kategorio:Salvadoria	El Salvador
Elbe	Elbe
Elektrika mashino	Electric motor
Elektra rezistiero	Electrical resistance
Elektro	Electricity
Kategorio:Elektro	Electricity
Kategorio:Elektrokemio	Electrochemistry
Elektrolizo	Electrolysis
Elektrolito	Electrolyte
Kategorio:Elektromagnetismo	Electromagnetism
Elektrono	Electron
Elektroniko	Electronics
Elemento	Element
Elefanto	Elephant
Elias Canetti	Elias Canetti
Elizabeth Taylor	Elizabeth Taylor
Ella Fitzgerald	Ella Fitzgerald
Elvis Presley	Elvis Presley
Embriono	Embryo
Emilia-Romagna	Emilia-Romagna
Emoco	Emotion
Kategorio:Emoco	Emotion
Emuo	Emu
Emuleso	Emulator
Enciklopedio	Encyclopedia
Kategorio:Endocrinologio	Endocrinology
Energio	Energy
Category:Energio	Energy
Energio	Energy (society)
Injenior-arto	Engineering
Kategorio:Injenior-arto	Engineering
Anglia	England
Kategorio:Anglia	England
Angliana linguo	English language
Enrico Caruso	Enrico Caruso
Enrico Fermi	Enrico Fermi
Kategorio:Mondumo	Entertainment
Enzimo	Enzyme
Epiko	Epic poetry
Epilepsio	Epilepsy
Adrenalino	Epinephrine
Epistemologio	Epistemology
Equaciono	Equation
Equatoro	Equator
Equatorala Guinea	Equatorial Guinea
Kategorio:Equatorala Guinea	Equatorial Guinea
Equinoxo	Equinox
Erbio	Erbium
Erik Axel Karlfeldt	Erik Axel Karlfeldt
Eris	Eris (dwarf planet)
Kategorio:Eritrea	Eritrea
Ernest Hemingway	Ernest Hemingway
Ernest Rutherford	Ernest Rutherford
Esperanto	Esperanto
Category:Esperanto	Esperanto
Espoo	Espoo
Esencala oleo	Essential oil
Kategorio:Estonia	Estonia
Etiopia	Ethiopia
Kategorio:Etiopia	Ethiopia
Eukalipto	Eucalyptus
Euklid	Euclid
Eunuko	Eunuch
Eufemismo	Euphemism
Eurazia	Eurasia
Daxo	Eurasian Badger
Euro	Euro
Europa (satelito)	Europa (moon)
Europa	Europe
Kategorio:Europa	Europe
Europana Komuneso	European Community
Pigo	European Magpie
Europana Uniono	European Union
Europio	Europium
Para-hufajo	Even-toed ungulate
Exponentala	Exponential function
Okulo	Eye
Kategorio:Okulo	Eye
Ezra Pound	Ezra Pound
Francis Scott Fitzgerald	F. Scott Fitzgerald
Vizajo	Face
Faktorialo	Factorial
Falkono	Falcon
Falklandi	Falkland Islands
Daimo	Fallow Deer
Kategorio:Modo	Fashion
Fatah	Fatah
Pavoro	Fear
Februaro	February
12 di februaro	February 12
14 di februaro	February 14
2 di februaro	February 2
22 di februaro	February 22
29 di februaro	February 29
Feko	Feces
Mikronezia	Federated States of Micronesia
Felix Mendelssohn	Felix Mendelssohn
Fernão de Magalhães	Ferdinand Magellan
Ferdinand de Saussure	Ferdinand de Saussure
Dungo	Fertilizer
Febro	Fever
Fidel Castro	Fidel Castro
Feldo (algebro)	Field (mathematics)
Fidji	Fiji
Category:Cinemo	Film
Cinematografisto	Film director
Fingro	Finger
Finlando	Finland
Kategorio:Finlando	Finland
Fairo	Fire
Fisho	Fish
Kategorio:Fishi	Fish
Pesko	Fishing
Category:Pesko	Fishing
Flamingo	Flamingo
Pulco	Flea
Firenze	Florence
Florida	Florida
Kategorio:Florida	Florida
Farino	Flour
Floro	Flower
Fluido	Fluid
Category:Folkloro	Folklore
Nutrivala adicioneso	Food additive
Nutriva kateno	Food chain
Futbalo	Football (soccer)
Forco	Force
Foresto	Forest
Forketo	Fork
Fonteno	Fountain
Fraktalo	Fractal
Francia	France
Kategorio:Francia	France
Francis Bacon	Francis Bacon
Francis Ford Coppola	Francis Ford Coppola
Francis Poulenc	Francis Poulenc
Francisco Franco	Francisco Franco
Francisco José de Goya y Lucientes	Francisco Goya
Francio	Francium
Francia-Prusia milito	Franco-Prussian War
Frank Lloyd Wright	Frank Lloyd Wright
Frankfort, Kentucky	Frankfort
Frankfurt am Main	Frankfurt
Franklin Pierce	Franklin Pierce
Franz Kafka	Franz Kafka
Franz Liszt	Franz Liszt
Fred Astaire	Fred Astaire
Friedrich Barbarossa	Frederick I
Frederick Soddy	Frederick Soddy
Freetown	Freetown
Franca Polinezia	French Polynesia
Kategorio:Franca Polinezia	French Polynesia
Frequeso	Frequency
Fritz Haber	Fritz Haber
Friuli-Venezia Giulia	Friuli-Venezia Giulia
Frukto	Fruit
Kategorio:Frukto	Fruit
Funciono	Function (mathematics)
Category:Chefa kategorii	Fundamental
Category:Fungi	Fungi
Moblo	Furniture
Fyodor Dostoyevski	Fyodor Dostoevsky
Gabon	Gabon
Kategorio:Gabon	Gabon
Gaborone	Gaborone
Gabriel Lippmann	Gabriel Lippmann
Gadolino	Gadolinium
Galaxio	Galaxy
Galisia	Galicia (Spain)
Galileo Galilei	Galileo Galilei
Galio	Gallium
Gamal Abdel Nasser	Gamal Abdel Nasser
Ludo	Game
Ludo-teorio	Game theory
Ganimede	Ganymede (moon)
Gaso	Gas
Digestiva sistemo	Gastrointestinal tract
Gasteropodo	Gastropoda
Ingrano	Gear
Geno	Gene
Genetiko	Genetics
Kategorio:Genetiko	Genetics
Genève (urbo)	Geneva
Geografio	Geography
Kategorio:Geografio	Geography
Kategorio:Geologio	Geology
Geologio	Geology
Geometrio	Geometry
Kategorio:Geometrio	Geometry
Friedrich Hegel	Georg Wilhelm Friedrich Hegel
George Bernard Shaw	George Bernard Shaw
George Boole	George Boole
George Bush	George Bush
George Gershwin	George Gershwin
George Harrison	George Harrison
George Orwell	George Orwell
George Paget Thomson	George Paget Thomson
George Sand	George Sand
George W. Bush	George W. Bush
George Washington	George Washington
Georges Bizet	Georges Bizet
Georges Simenon	Georges Simenon
Georgetown (Guyana)	Georgetown
Georgia (Usa)	Georgia (U.S. state)
Kategorio:Georgia	Georgia (U.S. state)
Georgia (stato)	Georgia (country)
Kategorio:Georgia (stato)	Georgia (country)
Gerald Ford	Gerald Ford
Germaniana linguo	German language
Germanio	Germanium
Germania	Germany
Kategorio:Germania	Germany
Ghana	Ghana
Kategorio:Ghana	Ghana
Pando	Giant Panda
Gibono	Gibbon
Gibraltar	Gibraltar
Giorgio de Chirico	Giorgio de Chirico
Giovanni Boccaccio	Giovanni Boccaccio
Jirafo	Giraffe
Giuseppe Garibaldi	Giuseppe Garibaldi
Giuseppe Verdi	Giuseppe Verdi
Glaciero	Glacier
Glasnost	Glasnost
Vitro	Glass
Artichoko	Globe artichoke
Kapro	Goat
Oro	Gold
Golda Meir	Golda Meir
Golfo	Golf
Kategorio:Golf	Golf
Google	Google
Gorilo	Gorilla
Acipitro	Goshawk
Göteborg	Gothenburg
Kiragro	Gout
Graham Greene	Graham Greene
Gramatiko	Grammar
Kategorio:Gramatiko	Grammar
Vito	Grape
Graveso	Gravitation
Volfo	Gray Wolf
Graz	Graz
Granda china muro	Great Wall of China
Grekia	Greece
Kategorio:Grekia	Greece
Grenlando	Greenland
Kategorio:Grenlando	Greenland
Gregor Mendel	Gregor Mendel
Gregoriana kalendario	Gregorian calendar
Kategorio:Grenada	Grenada
Greta Garbo	Greta Garbo
Kuntara landala produkto	Gross domestic product
Grupo	Group
Grover Cleveland	Grover Cleveland
Grozni	Grozny
Guadelupe	Guadeloupe
Guam	Guam
Kategorio:Guatemala	Guatemala
Guatemala-Urbo	Guatemala City
Guayaquil	Guayaquil
Guernsey	Guernsey
Guglielmo Marconi	Guglielmo Marconi
Guillaume Apollinaire	Guillaume Apollinaire
Gilotino	Guillotine
Guinea	Guinea
Kategorio:Guinea	Guinea
Kobayo	Guinea pig
Guinea Bisau	Guinea-Bissau
Kategorio:Guinea-Bissau	Guinea-Bissau
Gulag	Gulag
Muevo	Gull
Gustav Ludwig Hertz	Gustav Ludwig Hertz
Guy de Maupassant	Guy de Maupassant
Kategorio:Guyana	Guyana
Ginekologio	Gynaecology
Jiroskopo	Gyroscope
H. G. Wells	H. G. Wells
Hafnio	Hafnium
Haifa	Haifa
Haro	Hair
Haiti	Haiti
Kategorio:Haiti	Haiti
Hamas	Hamas
Hamburg	Hamburg
Martelo	Hammer
Hamstro	Hamster
Manuo	Hand
Hanoi	Hanoi
Hans Christian Andersen	Hans Christian Andersen
Hansa-uniono	Hanseatic League
Harare	Harare
Harold Pinter	Harold Pinter
Harrisburg, Pensilvania	Harrisburg
Hartford, Connecticut	Hartford
Odio	Hatred
Alta Normandia	Haute-Normandie
Havana	Havana
Havayi	Hawaii
Kategorio:Havayi	Hawaii
Kapo	Head
Kategorio:Stando	Health
Kordio	Heart
Kaloro	Heat
Heavy metal	Heavy metal music
Judala kalendario	Hebrew calendar
Hector Berlioz	Hector Berlioz
Hedonismo	Hedonism
Heinrich Rudolf Hertz	Heinrich Hertz
Heinrich Himmler	Heinrich Himmler
Helena, Montana	Helena
Helio	Helium
Helmut Schmidt	Helmut Schmidt
Helsinki	Helsinki
Henri Becquerel	Henri Becquerel
Henri Bergson	Henri Bergson
Henri Matisse	Henri Matisse
Henrik Ibsen	Henrik Ibsen
Henry Kissinger	Henry Kissinger
Herbert Hoover	Herbert Hoover
Herbert Marcuse	Herbert Marcuse
Herkulo	Hercules (constellation)
Herezio	Heresy
Hermann Hesse	Hermann Hesse
Herono	Heron
Hertfordshire	Hertfordshire
Hesia	Hesse
Hizbollah	Hezbollah
Hideki Yukawa	Hideki Yukawa
Hieronymus Bosch	Hieronymus Bosch
Himalaya	Himalayas
Hinduismo	Hinduism
Kategorio:Hinduismo	Hinduism
Hipopotamo	Hippopotamus
Histologio	Histology
Historio	History
Kategorio:Historio	History
Ho Chi Minh	Ho Chi Minh
Ho Chi Minh urbo	Ho Chi Minh City
Hollywood	Hollywood
Holmio	Holmium
Regulademo	Homeostasis
Homonimo	Homonym
Honduras	Honduras
Kategorio:Honduras	Honduras
Hong Kong	Hong Kong
Kategorio:Hong Kong	Hong Kong
Honiara	Honiara
Honolulu	Honolulu
Horatius	Horace
Horatio Nelson	Horatio Nelson
Hormono	Hormone
Kavalo	Horse
Hosni Mubarak	Hosni Mubarak
Pasero	House Sparrow
Konstanto di Hubble	Hubble's law
Homo	Human
Kategorio:Humuro	Humor
Humphrey Bogart	Humphrey Bogart
Cent-yara milito	Hundred Years' War
Hungaria	Hungary
Kategorio:Hungaria	Hungary
Hungro	Hunger
Hidrokarbido	Hydrocarbon
Hidrogeno	Hydrogen
Hieno	Hyena
Kategorio:Higieno	Hygiene
Kategorio:Himenoptero	Hymenoptera
Himenoptero	Hymenoptera
Ian Fleming	Ian Fleming
Iberia	Iberian Peninsula
Glacio	Ice
Flotacinta glacimonto	Iceberg
Islando	Iceland
Kategorio:Islando	Iceland
Idaho	Idaho
Kategorio:Idaho	Idaho
Ido	Ido
Igor Stravinsky	Igor Stravinsky
Iliado	Iliad
Illinois	Illinois
Category:Illinois	Illinois
Immanuel Kant	Immanuel Kant
Incesto	Incest
Incheon	Incheon
India	India
Kategorio:India	India
Indiana Oceano	Indian Ocean
Indiana	Indiana
Kategorio:Indiana	Indiana
Indianapolis	Indianapolis
Indio	Indium
Indonezia	Indonesia
Kategorio:Indonezia	Indonesia
Kategorio:Industrio	Industry
Ne egaleso	Inequality
Inerteso	Inertia
Inflamo	Inflammation
Inflacio	Inflation
Influenzo	Influenza
Informo	Information
Informo-teorio	Information theory
Infrereda	Infrared
Ingmar Bergman	Ingmar Bergman
Insekto	Insect
Asekuro	Insurance
Integro	Integer
Interfero	Interference
Unaj-internaciona sistemo	International System of Units
Kategorio:Reto	Internet
Koncentreso-kampeyo	Internment
Intestino	Intestine
Iodo	Iodine
Iono	Ion
Iowa	Iowa
Kategorio:Iowa	Iowa
Iran	Iran
Kategorio:Iran	Iran
Irak	Iraq
Kategorio:Irak	Iraq
Category:Irlando	Ireland
Iridio	Iridium
Fero	Iron
Iron Maiden	Iron Maiden
Ironio	Irony
Isaac Asimov	Isaac Asimov
Isaac Bashevis Singer	Isaac Bashevis Singer
Isaac Newton	Isaac Newton
Isadora Duncan	Isadora Duncan
Islamo	Islam
Kategorio:Islamo	Islam
Islamabad	Islamabad
Islama kalendario	Islamic calendar
Insulo	Island
Man-Insulo	Isle of Man
Kategorio:Man-Insulo	Isle of Man
Insulo di Wight	Isle of Wight
Israel	Israel
Kategorio:Israel	Israel
Istanbul	Istanbul
Italia	Italy
Kategorio:Italia	Italy
Ivan Lendl	Ivan Lendl
Ivan Pavlov	Ivan Pavlov
Jack Kerouac	Jack Kerouac
Jack Lemmon	Jack Lemmon
Chuvo	Jackdaw
Jackson, Mississippi	Jackson
Jackson Pollock	Jackson Pollock
Jacksonville, Florida	Jacksonville
Jacques Derrida	Jacques Derrida
Jacques Offenbach	Jacques Offenbach
Jaguaro	Jaguar
Jakarta	Jakarta
Jamaika	Jamaica
Kategorio:Jamaika	Jamaica
James Garfield	James A. Garfield
James Buchanan	James Buchanan
James Cook	James Cook
James Franck	James Franck
James Joyce	James Joyce
James Knox Polk	James K. Polk
James Madison	James Madison
James Monroe	James Monroe
James Prescott Joule	James Prescott Joule
James Watt	James Watt
Jane Austen	Jane Austen
Jane Fonda	Jane Fonda
Janis Joplin	Janis Joplin
Januaro	January
1 di januaro	January 1
19 di januaro	January 19
20 di januaro	January 20
6 di januaro	January 6
Japonia	Japan
Kategorio:Japonia	Japan
Java (insulo)	Java
Dominique Ingres	Jean Auguste Dominique Ingres
Jean Cocteau	Jean Cocteau
Jean Piaget	Jean Piaget
Jean Racine	Jean Racine
Jean Sibelius	Jean Sibelius
Jean de La Fontaine	Jean de La Fontaine
Jean-Jacques Rousseau	Jean-Jacques Rousseau
Jean-Paul Sartre	Jean-Paul Sartre
Jeddah	Jeddah
Jefferson City, Missouri	Jefferson City
Meduzo	Jellyfish
Jersey	Jersey
Jerusalem	Jerusalem
Turboreagilo	Jet engine
Jimi Hendrix	Jimi Hendrix
Jimmy Carter	Jimmy Carter
Johann Sebastian Bach	Johann Sebastian Bach
Goethe	Johann Wolfgang von Goethe
Johannes Brahms	Johannes Brahms
Johannes Diderik van der Waals	Johannes Diderik van der Waals
Johannes Kepler	Johannes Kepler
John Adams	John Adams
John Cage	John Cage
John Galsworthy	John Galsworthy
John Lennon	John Lennon
John Maynard Keynes	John Maynard Keynes
John Quincy Adams	John Quincy Adams
John Steinbeck	John Steinbeck
John Stuart Mill	John Stuart Mill
John Tyler	John Tyler
John Wayne	John Wayne
John von Neumann	John von Neumann
Jonathan Swift	Jonathan Swift
Jordania	Jordan
Kategorio:Jordania	Jordan
Jorge Luis Borges	Jorge Luis Borges
Joseph Conrad	Joseph Conrad
Joseph Goebbels	Joseph Goebbels
Joseph Haydn	Joseph Haydn
Louis Joseph Gay-Lussac	Joseph Louis Gay-Lussac
Joseph McCarthy	Joseph McCarthy
Joseph Alois Schumpeter	Joseph Schumpeter
Yosif Stalin	Joseph Stalin
Judaismo	Judaism
Kategorio:Judaismo	Judaism
Judy Garland	Judy Garland
Jules Verne	Jules Verne
Juliana kalendario	Julian calendar
Julius Cezaro	Julius Caesar
Julio	July
1 di julio	July 1
4 di julio	July 4
Junio	June
14 di junio	June 14
21 di junio	June 21
23 di junio	June 23
24 di junio	June 24
29 di junio	June 29
3 di junio	June 3
Juneau	Juneau
Jupitero	Jupiter
Kabul	Kabul
Kampala	Kampala
Kanguruo	Kangaroo
Kansas	Kansas
Kategorio:Kansas	Kansas
Kansas City, Missouri	Kansas City
Karachi	Karachi
Karaoke	Karaoke
Karen Blixen	Karen Blixen
Karl Jaspers	Karl Jaspers
Karl Marx	Karl Marx
Karl Popper	Karl Popper
Katharine Hepburn	Katharine Hepburn
Katmandu	Kathmandu
Katowice	Katowice
Kazakstan	Kazakhstan
Kentucky	Kentucky
Kategorio:Kentucky	Kentucky
Kenia	Kenya
Kategorio:Kenia	Kenya
Khabarovsk	Khabarovsk
Kharkiv	Kharkiv
Khartoum	Khartoum
Kyiv	Kiev
Kigali	Kigali
Kingston	Kingston
Kingstown	Kingstown
Kinshasa	Kinshasa
Kiribati	Kiribati
Kategorio:Kiribati	Kiribati
Kirkuk	Kirkuk
Kaito	Kite
Kultelo	Knife
Knut Hamsun	Knut Hamsun
Koalo	Koala
Kalkuta	Kolkata
Konrad Adenauer	Konrad Adenauer
Korea	Korea
Kategorio:Korea	Korea
Kosovo	Kosovo
Kremlin	Kremlin
Kriptono	Krypton
Kuala Lumpur	Kuala Lumpur
Kuwait	Kuwait
Kategorio:Kuwait	Kuwait
Kuwait-Urbo	Kuwait City
Kirgizistan	Kyrgyzstan
Kategorio:Kirgizistan	Kyrgyzstan
La Paz	La Paz
La Plata	La Plata
Lagos	Lagos
Lago	Lake
Baikal	Lake Baikal
Balaton	Lake Balaton
Léman	Lake Geneva
Lago Michigan	Lake Michigan
Lampredo	Lamprey
Linguo	Language
Lansing, Michigan	Lansing
Lantano	Lanthanum
Laos	Laos
Kategorio:Laos	Laos
Larvo	Larva
Laringo	Larynx
Las Vegas	Las Vegas
Latina alfabeto	Latin alphabet
Latitudo	Latitude
Latvia	Latvia
Kategorio:Latvia	Latvia
Rido	Laughter
Lausanne	Lausanne
Yuro	Law
Kategorio:Yuro	Law
Lazio	Lazio
Le Corbusier	Le Corbusier
Plombo	Lead
Folio	Leaf
Ligo dil Nacioni	League of Nations
Aprentiseso	Learning
Libano	Lebanon
Kategorio:Libano	Lebanon
Leeds	Leeds
Leiden	Leiden
Leipzig	Leipzig
Leono (stelaro)	Leo (constellation)
Lev Trocki	Leon Trotsky
Leonardo da Vinci	Leonardo da Vinci
Leonhard Euler	Leonhard Euler
Leonid Brejnev	Leonid Brezhnev
Lesoto	Lesotho
Kategorio:Lesoto	Lesotho
Levero	Lever
Lewis Carroll	Lewis Carroll
Lexikologio	Lexicology
Lhotse	Lhotse
Liberia	Liberia
Kategorio:Liberia	Liberia
Libreville	Libreville
Libia	Libya
Kategorio:Libia	Libya
Liechtenstein	Liechtenstein
Kategorio:Liechtenstein	Liechtenstein
Lumo	Light
Lumyaro	Light-year
Fulmino	Lightning
Liguria	Liguria
Lille	Lille
Lilongwe	Lilongwe
Lima	Lima
Limito	Limit (mathematics)
Limousin	Limousin (region)
Lincoln, Nebraska	Lincoln
Lincoln	Lincoln
Lincolnshire	Lincolnshire
Lineo	Line (mathematics)
Linguistiko	Linguistics
Kategorio:Linguistiko	Linguistics
Linus Pauling	Linus Pauling
Leono (mamifero)	Lion
Liquoro	Liqueur
Liquido	Liquid
Lisboa	Lisbon
Lise Meitner	Lise Meitner
Literaturo	Literature
Kategorio:Literaturo	Literature
Litio	Lithium
Lituania	Lithuania
Kategorio:Lituania	Lithuania
Huo	Little Owl
Ljubljana	Ljubljana
Lamao (mamifero)	Llama
Logaritmo	Logarithm
Logiko	Logic
Kategorio:Logiko	Logic
Lombardia	Lombardy
London	London
Long Island	Long Island
Patro nia	Lord's Prayer
Lotringia	Lorraine (region)
Los Angeles	Los Angeles
Louis Armstrong	Louis Armstrong
Louis Braille	Louis Braille
Louis Pasteur	Louis Pasteur
Louisiana	Louisiana
Kategorio:Louisiana	Louisiana
Louisville, Kentucky	Louisville
Infra-Saxonia	Lower Saxony
Luanda	Luanda
Luciano Pavarotti	Luciano Pavarotti
Ludwig Wittgenstein	Ludwig Wittgenstein
Ludwig van Beethoven	Ludwig van Beethoven
Luigi Pirandello	Luigi Pirandello
Pulmono	Lung
Lusaka	Lusaka
Lutecio	Lutetium
Luxemburgia	Luxembourg
Kategorio:Luxemburgia	Luxembourg
Luxemburg	Luxembourg (city)
Lyon	Lyon
Makau	Macau
Mach	Mach number
Mashino	Machine
Madagaskar	Madagascar
Kategorio:Madagaskar	Madagascar
Madeira	Madeira
Madison, Wisconsin	Madison
Madrid	Madrid
Magiala quadrato	Magic square
Magnezio	Magnesium
Mahatma Gandhi	Mahatma Gandhi
Maine	Maine
Kategorio:Maine	Maine
Maizo	Maize
Makalu	Makalu
Malabo	Malabo
Kategorio:Malawi	Malawi
Malaizia	Malaysia
Maldivi	Maldives
Kategorio:Maldivi	Maldives
Mali	Mali
Kategorio:Mali	Mali
Malta	Malta
Kategorio:Malta	Malta
Maltana linguo	Maltese language
Mamifero	Mammal
Mamuto	Mammoth
Managua	Managua
Al Manamah	Manama
Lamantino	Manatee
Manchester	Manchester
Mandjuria	Manchuria
Mangano	Manganese
Manila	Manila
Manitoba	Manitoba
Manuel de Falla	Manuel de Falla
Mao Zedong	Mao Zedong
Maputo	Maputo
Marmoro	Marble
Marcel Duchamp	Marcel Duchamp
Marcel Proust	Marcel Proust
Marto	March
17 di marto	March 17
19 di marto	March 19
2 di marto	March 2
25 di marto	March 25
Marche	Marche
Marco Polo	Marco Polo
Margaret Mead	Margaret Mead
Margaret Thatcher	Margaret Thatcher
Marie-Antoinette	Marie Antoinette
Marie Curie	Marie Curie
Marilyn Monroe	Marilyn Monroe
Mario Vargas Llosa	Mario Vargas Llosa
Mark Twain	Mark Twain
Merkatago	Marketing
Marlene Dietrich	Marlene Dietrich
Markezo de Sade	Marquis de Sade
Mariajo	Marriage
Marseille	Marseille
Marshall Insuli	Marshall Islands
Martin Heidegger	Martin Heidegger
Martin Luther	Martin Luther
Martin Luther King	Martin Luther King
Martin Scorsese	Martin Scorsese
Martin Van Buren	Martin Van Buren
Martinik	Martinique
Mary Shelley	Mary Shelley
Maryland	Maryland
Kategorio:Maryland	Maryland
Maseru	Maseru
Maso	Mass
Massachusetts	Massachusetts
Kategorio:Massachusetts	Massachusetts
Mata Hari	Mata Hari
Alumeto	Match
Matematiko	Mathematics
Kategorio:Matematiko	Mathematics
Materio	Matter
Maurice Ravel	Maurice Ravel
Mauritania	Mauritania
Kategorio:Mauritania	Mauritania
Mauris	Mauritius
Kategorio:Maurico	Mauritius
Max Born	Max Born
Max Ernst	Max Ernst
Max Planck	Max Planck
Max Weber	Max Weber
Mayo	May
1 di mayo	May 1
24 di mayo	May 24
Efemero	Mayfly
Urbestro	Mayor
Mbabane	Mbabane
Kategorio:Metrologio	Measurement
Kategorio:Mekanikala injenioruro	Mechanical engineering
Kategorio:Mekaniko	Mechanics
Mekaniko	Mechanics
Medikamento	Medication
Medicino	Medicine
Kategorio:Medicino	Medicine
Mediteraneo	Mediterranean Sea
Mel Gibson	Mel Gibson
Merkurio	Mercury (element)
Merkuro	Mercury (planet)
Meskalino	Mescaline
Metabolio	Metabolism
Kategorio:Metalifo	Metallurgy
Metaforo	Metaphor
Metafiziko	Metaphysics
Kategorio:Metafiziko	Metaphysics
Kategorio:Meteorologio	Meteorology
Meteorologio	Meteorology
Metonimio	Metonymy
Mexikia	Mexico
Kategorio:Mexikia	Mexico
México	Mexico City
Michelangelo	Michelangelo
Michigan	Michigan
Kategorio:Michigan	Michigan
Mick Jagger	Mick Jagger
Kategorio:Mikrobiologio	Microbiology
Mez-epoko	Middle Ages
Migreno	Migraine
Miguel de Cervantes	Miguel de Cervantes
Mike Tyson	Mike Tyson
Mihail Bakunin	Mikhail Bakunin
Mihail Gorbachov	Mikhail Gorbachev
Milano	Milan
Miles Davis	Miles Davis
Category:Militala	Military
Lakto	Milk
Lakto-voyo	Milky Way
Millard Fillmore	Millard Fillmore
Miriapodo	Millipede
Kategorio:Mineralogio	Mineralogy
Minneapolis, Minnesota	Minneapolis
Minnesota	Minnesota
Kategorio:Minnesota	Minnesota
Minsk	Minsk
Kategorio:Mississippi	Mississippi
Missouri	Missouri
Category:Missouri	Missouri
Mogadishu	Mogadishu
Moldo	Mold
Moldova	Moldova
Kategorio:Moldova	Moldova
Molekulo	Molecule
Molise	Molise
Molusko	Mollusca
Molibdeno	Molybdenum
Monako	Monaco
Kategorio:Monako	Monaco
Pekunio	Money
Mongolia	Mongolia
Kategorio:Mongolia	Mongolia
Mangusto	Mongoose
Monomero	Monomer
Ozo	Monosaccharide
Monrovia	Monrovia
Musono	Monsoon
Monto Blanka	Mont Blanc
Montana	Montana
Kategorio:Montana	Montana
Montenegro	Montenegro
Kategorio:Montenegro	Montenegro
Montevideo	Montevideo
Montgomery, Alabama	Montgomery
Monato	Month
Montpelier, Vermont	Montpelier
Montréal	Montreal
Montserrat	Montserrat
Luno	Moon
Alko	Moose
Moravia	Moravia
Maroko	Morocco
Kategorio:Maroko	Morocco
Morfemo	Morpheme
Morfologio	Morphology
Moskva	Moscow
Kategorio:Moskva	Moscow
Moskito	Mosquito
Dio di matro	Mother's Day
Athos	Mount Athos
Monto Everest	Mount Everest
Muso	Mouse
Informatik-apuntilo	Mouse (computing)
Mozambik	Mozambique
Kategorio:Mozambik	Mozambique
Muhamad	Muhammad
Mumio	Mummy
München	Munich
Murmansk	Murmansk
Muscat	Muscat
Muskulo	Muscle
Muzeo	Museum
Muziko	Music
Kategorio:Muziko	Music
Mustelido	Mustelidae
Category:Myanmar	Myanmar
Kategorio:Mikologio	Mycology
Kategorio:Mitologio	Mythology
N'Djamena	N'Djamena
NATO	NATO
Nagasaki	Nagasaki
Unglo	Nail (anatomy)
Nairobi	Nairobi
Namibia	Namibia
Kategorio:Namibia	Namibia
Nanga Parbat	Nanga Parbat
Nantes	Nantes
Napalm	Napalm
Napoli	Naples
Nashville, Tennessee	Nashville
Nassau	Nassau
Nathaniel Hawthorne	Nathaniel Hawthorne
Naturala cienci	Natural science
Naturo	Nature
Kategorio:Naturo	Nature
Nauru	Nauru
Kategorio:Nauru	Nauru
Nebraska	Nebraska
Kategorio:Nebraska	Nebraska
Nebuloso	Nebula
Nelson Mandela	Nelson Mandela
Nematodo	Nematode
Neodimio	Neodymium
Neologismo	Neologism
Neono	Neon
Nepal	Nepal
Kategorio:Nepal	Nepal
Neptuno	Neptune
Neptunio	Neptunium
Nervaro	Nervous system
Kategorio:Nervaro	Nervous system
Nederlando	Netherlands
Kategorio:Nederlando	Netherlands
Nederlandana Antili	Netherlands Antilles
Neurono	Neuron
Neutrono	Neutron
Nevada	Nevada
Kategorio:Nevada	Nevada
New Brunswick	New Brunswick
Nova-Kaledonia	New Caledonia
Nova-Delhi	New Delhi
Nova-Hampshire	New Hampshire
Kategorio:Nova-Hampshire	New Hampshire
Nova-Jersey	New Jersey
Kategorio:Nova-Jersey	New Jersey
Nova-Mexikia	New Mexico
Kategorio:Nova-Mexikia	New Mexico
Nov-Orleans	New Orleans
Nova-York (stato)	New York
Kategorio:Nova-York	New York
New York	New York City
Nova-Zelando	New Zealand
Newfoundland e Labrador	Newfoundland and Labrador
Newport	Newport
Niamey	Niamey
Nikaragua	Nicaragua
Nikelo	Nickel
Nicolas Poussin	Nicolas Poussin
Nikolaus Kopernikus	Nicolaus Copernicus
Nikosia	Nicosia
Niels Bohr	Niels Bohr
Nijer	Niger
Kategorio:Nijer	Niger
Nigeria	Nigeria
Kategorio:Nigeria	Nigeria
Nokto	Night
Naktigalo	Nightingale
Nikita Hrushchev	Nikita Khrushchev
Niobio	Niobium
Nitro	Nitrogen
S/2005 P 2	Nix (moon)
Noam Chomsky	Noam Chomsky
Nobel-premio	Nobel Prize
Kategorio:Nobel-premio	Nobel Prize
Norman Mailer	Norman Mailer
Normandia	Normandy
Category:Nord-Amerika	North America
Norda-Karolina	North Carolina
Kategorio:Norda-Karolina	North Carolina
Norda-Dakota	North Dakota
Kategorio:Norda-Dakota	North Dakota
Nord-Korea	North Korea
Kategorio:Nord-Korea	North Korea
Norda Maro	North Sea
Nord-Irlando	Northern Ireland
Norvegia	Norway
Kategorio:Norvegia	Norway
Nazo	Nose
Nostradamus	Nostradamus
Noto	Note
Nouakchott	Nouakchott
Nova Scotia	Nova Scotia
Novaya Zemlya	Novaya Zemlya
Novembro	November
1 di novembro	November 1
11 di novembro	November 11
2 di novembro	November 2
5 di novembro	November 5
Novial	Novial
Novosibirsk	Novosibirsk
Atom-bombo	Nuclear weapon
Nukleo	Nucleon
Nombro	Number
Kategorio:Nombro	Numbers
Nunavut	Nunavut
Nürnberg	Nuremberg
Objektema programado	Object-oriented programming
Hoboyo	Oboe
Oceano	Ocean
Oceania	Oceania
Kategorio:Oceania	Oceania
Kategorio:Oceanografio	Oceanography
Oktobro	October
12 di oktobro	October 12
24 di oktobro	October 24
Odessa	Odessa
Ohio	Ohio
Kategorio:Ohio	Ohio
Oleo	Oil
Oleo	Oil (disambiguation)
Oklahoma	Oklahoma
Kategorio:Oklahoma	Oklahoma
Oklahoma City, Oklahoma	Oklahoma City
Oktoberfest	Oktoberfest
Olympia, Washington	Olympia
Omaha, Nebraska	Omaha
Oman	Oman
Ontario	Ontario
Kategorio:Ontario	Ontario
Ontologio	Ontology
Optiko	Optics
Kategorio:Optiko	Optics
Orangutano	Orangutan
Orbito	Orbit
Oregon	Oregon
Kategorio:Oregon	Oregon
Organo	Organ (anatomy)
Orgeno	Organ (music)
Karbo-kemio	Organic chemistry
Kategorio:Organika kemio	Organic chemistry
Origamio	Origami
Orion	Orion (constellation)
Orson Welles	Orson Welles
Osaka	Osaka
Osama bin Laden	Osama bin Laden
Oscar Wilde	Oscar Wilde
Ocilo	Oscillation
Oslo	Oslo
Osmio	Osmium
Mar-aglo	Osprey
Strucho	Ostrich
Ottawa	Ottawa
Otto Hahn	Otto Hahn
Otto von Bismarck	Otto von Bismarck
Otomana Imperio	Ottoman Empire
Kategorio:Otomana Imperio	Ottoman Empire
Strigo	Owl
Oxford	Oxford
Oxo	Oxygen
Oximoro	Oxymoron
PH	PH
Pablo Neruda	Pablo Neruda
Pablo Picasso	Pablo Picasso
Oceano Pacifiko	Pacific Ocean
Kategorio:Pikto	Painting
Pakistan	Pakistan
Kategorio:Pakistan	Pakistan
Versailles-palaco	Palace of Versailles
Palau	Palau
Kategorio:Palau	Palau
Paleontologio	Paleontology
Palermo	Palermo
Palestina	Palestine
Paladio	Palladium
Panama	Panama
Kategorio:Panama	Panama
Panama-kanalo	Panama Canal
Panama-Urbo	Panama City
Pantero	Panthera
Papua Nov-Guinea	Papua New Guinea
Kategorio:Papua-Nova-Guinea	Papua New Guinea
Paradigmo	Paradigm
Paradoxo	Paradox
Paraguay	Paraguay
Kategorio:Paraguay	Paraguay
Paralaxo	Parallax
Paramaribo	Paramaribo
Paris	Paris
Kategorio:Paris	Paris
Pareso	Parity (mathematics)
Parodio	Parody
Parseko	Parsec
Kategorio:Paseroformi	Passeriformes
Patrick White	Patrick White
Paul Gauguin	Paul Gauguin
Paul Johann Ludwig von Heyse	Paul Johann Ludwig von Heyse
Paul Klee	Paul Klee
Paul McCartney	Paul McCartney
Paul Verlaine	Paul Verlaine
Paul von Hindenburg	Paul von Hindenburg
Lando di Loire	Pays de la Loire
Pavono	Peafowl
Pinguino	Penguin
Penicilino	Penicillin
Peninsulo	Peninsula
Pensilvania	Pennsylvania
Kategorio:Pensilvania	Pennsylvania
Kategorio:Personalajo	People
Chinia	People's Republic of China
Percy Bysshe Shelley	Percy Bysshe Shelley
Perestroika	Perestroika
Periodala tabelo dil elementaro	Periodic table
Pernambuco	Pernambuco
Persiana Gulfo	Persian Gulf
Peru	Peru
Kategorio:Peru	Peru
Petrolo	Petroleum
Faraono di Egiptia	Pharaoh
Fenotipo	Phenotype
Filipini	Philippines
Filologio	Philology
Filozofio	Philosophy
Kategorio:Filozofio	Philosophy
Phnom Penh	Phnom Penh
Fobos	Phobos (moon)
Phoenix, Arizona	Phoenix
Fonemo	Phoneme
Fonetiko	Phonetics
Kategorio:Fonetiko	Phonetics
Fonologio	Phonology
Fosfo	Phosphorus
Fotografo	Photography
Kategorio:Fotografio	Photography
Kategorio:Fizikala kemio	Physical chemistry
Fiziko	Physics
Kategorio:Fiziko	Physics
Fiziologio	Physiology
Kategorio:Fiziologio	Physiology
Pikardia	Picardie
Piemont	Piedmont
Pierre, Suda-Dakota	Pierre
Pierre Curie	Pierre Curie
Pierre de Fermat	Pierre de Fermat
Piet Mondrian	Piet Mondrian
Pieter Zeeman	Pieter Zeeman
Korsaro	Piracy
Pisa	Pisa
Plano	Plane (mathematics)
Planeto	Planet
Planto	Plant
Platino	Platinum
Platon	Plato
Ornitorinko	Platypus
Pleyado	Pleiades (star cluster)
Plutono	Pluto
Plutonio	Plutonium
Plymouth, Anglia	Plymouth
Poezio	Poetry
Poitiers	Poitiers
Poitou Charentes	Poitou-Charentes
Polonia	Poland
Kategorio:Polonia	Poland
Policistaro	Police
Poliomielito	Poliomyelitis
Kategorio:Politicala cienco	Political science
Politiko	Politics
Kategorio:Politiko	Politics
Polo (sporto)	Polo
Polonio	Polonium
Poligono	Polygon
Poliedro	Polyhedron
Polimero	Polymer
Papo	Pope
Porcelano	Porcelain
Port Louis	Port Louis
Port Moresby	Port Moresby
Port Vila	Port Vila
Port-of-Spain	Port of Spain
Port-au-Prince	Port-au-Prince
Portland, Oregon	Portland
Portland	Portland
Porto	Porto
Portugal	Portugal
Kategorio:Portugal	Portugal
Kalio	Potassium
Praha	Prague
Praia	Praia
Prazeodimio	Praseodymium
Prezidanto di Usa	President of the United States
Preso	Pressure
Pretoria	Pretoria
Preco	Price
Kategorio:Primati	Primates
Prima ministro	Prime minister
Prince Edward Island	Prince Edward Island
Probableso	Probability
Category:Probableso	Probability theory
Projeto	Project
Prolog	Prolog
Prometio	Promethium
Propagado	Propaganda
Protaktinio	Protactinium
Proteino	Protein
Protono	Proton
Providence, Rhode Island	Providence
Prusia	Prussia
Pseudonimo	Pseudonym
Psikologio	Psychology
Kategorio:Psikologio	Psychology
Porto-Riko	Puerto Rico
Kategorio:Porto-Riko	Puerto Rico
Pulsaro	Pulsar
Pompo	Pump
Puntizo	Punctuation
Pyongyang	Pyongyang
Piramido	Pyramid
Pirenei	Pyrenees
Pitagoro	Pythagoras
Katar	Qatar
Quadratala equaciono	Quadratic equation
Quadrilatero	Quadrilateral
Quebec	Quebec
Kategorio:Quebec	Quebec
Kechuana linguo	Quechua
Queensland	Queensland
Quito	Quito
Rabat	Rabat
Rabindranath Tagore	Rabindranath Tagore
Rachel Carson	Rachel Carson
Kategorio:Radio	Radio
Radiumo	Radium
Radono	Radon
Pluvo	Rain
Raleigh, Norda-Karolina	Raleigh
Ralph Waldo Emerson	Ralph Waldo Emerson
Violaco	Rape
Rato	Rat
Recife (Pernambuco)	Recife
Rekurso	Recursion
Foxo	Red Fox
Reda Maro	Red Sea
Redesko	Redshift
Redesko	Redshift (disambiguation)
Rentiro	Reindeer
Korespondado o relato	Relation (mathematics)
Religio	Religion
Kategorio:Religii	Religion
Rembrandt van Rijn	Rembrandt
Reptero	Reptile
Republiko	Republic
Taiwan	Republic of China
Irlando	Republic of Ireland
Kategorio:Irlando	Republic of Ireland
Republiko Kongo	Republic of the Congo
Kategorio:Republiko Kongo	Republic of the Congo
Respirala sistemo	Respiratory system
Retino	Retina
Renio	Rhenium
Retoriko	Rhetoric
Kategorio:Retoriko	Rhetoric
Rinocero	Rhinoceros
Rhode Island	Rhode Island
Kategorio:Rhode Island	Rhode Island
Rodio	Rhodium
Rizo	Rice
Richard Nixon	Richard Nixon
Richmond, Virginia	Richmond
Riga	Riga
Rigel	Rigel
Ringo Starr	Ringo Starr
Rio de Janeiro (urbo)	Rio de Janeiro
Rio de Janeiro (stato)	Rio de Janeiro (state)
Riad	Riyadh
Robert Andrews Millikan	Robert Andrews Millikan
Robert Hooke	Robert Hooke
Robert Oppenheimer	Robert Oppenheimer
Robert Redford	Robert Redford
Roboto	Robot
Roko, Papero, Cizo	Rock
Rock	Rock music
Rodero	Rodent
Kapreolo	Roe Deer
Romana kalendario	Roman calendar
Rumania	Romania
Kategorio:Rumania	Romania
Roma	Rome
Ronald Reagan	Ronald Reagan
Frugilego	Rook (bird)
Radiko (botaniko)	Root
Rosa Parks	Rosa Parks
Roseau	Roseau
Rostock	Rostock
Rotterdam	Rotterdam
Dop-remilo	Rowing (sport)
Rubidio	Rubidium
Rudyard Kipling	Rudyard Kipling
Rusia	Russia
Kategorio:Rusia	Russia
Rutenio	Ruthenium
Rutherford Hayes	Rutherford B. Hayes
Ruanda	Rwanda
Kategorio:Ruanda	Rwanda
Sacramento, Kalifornia	Sacramento
Saddam Hussein	Saddam Hussein
Sahara	Sahara
St Kitts-Nevis	Saint Kitts and Nevis
Kategorio:St Kitts-Nevis	Saint Kitts and Nevis
St Lucia	Saint Lucia
Kategorio:St Lucia	Saint Lucia
Saint Paul, Minnesota	Saint Paul
St Peterburg	Saint Petersburg
Kategorio:St Peterburg	Saint Petersburg
St Vincent e Grenadini	Saint Vincent and the Grenadines
Kategorio:St Vincent e Grenadini	Saint Vincent and the Grenadines
Salem, Oregon	Salem
Salivo	Saliva
Manjebla salo	Salt
Salt Lake City	Salt Lake City
Salvador (Bahia)	Salvador
Salzburg	Salzburg
Samario	Samarium
Samoa	Samoa
Kategorio:Samoa	Samoa
Samuel Beckett	Samuel Beckett
Samurai	Samurai
San Francisco	San Francisco
San Juan	San Juan
San Marino	San Marino
Kategorio:San Marino	San Marino
San Marino (urbo)	San Marino
San Salvador	San Salvador
Sandro Botticelli	Sandro Botticelli
Sanskrita linguo	Sanskrit
Santa Fe, Nova-Mexikia	Santa Fe
Santiago (Chili)	Santiago
Santiago	Santiago
Santiago de Cuba	Santiago de Cuba
Santo Domingo	Santo Domingo
Santos (Sao Paulo)	Santos (Săo Paulo)
Sapporo	Sapporo
Sarajevo	Sarajevo
Sardino	Sardine
Sardinia	Sardinia
Saskatchewan	Saskatchewan
Satanismo	Satanism
Saturno	Saturn
Saudia Arabia	Saudi Arabia
Kategorio:Saudia Arabia	Saudi Arabia
Saul Bellow	Saul Bellow
Savano	Savanna
Saxonia	Saxony
Skandinavia	Scandinavia
Skandio	Scandium
Skizofrenio	Schizophrenia
Cienco	Science
Kategorio:Cienci	Science
Ciencala fiktivajo	Science fiction
Ciencala metodo	Scientific method
Cientologio	Scientology
Skorpiono	Scorpion
Skotia	Scotland
Skrubo	Screw
Skulto	Sculpture
Kategorio:Skulto	Sculpture
Maro	Sea
Mar-lutro	Sea Otter
Aktinio	Sea anemone
Holoturio	Sea cucumber
Ekino	Sea urchin
Hipokampo	Seahorse
Seattle	Seattle
Category:Sekureso	Security
Selenio	Selenium
Semantiko	Semantics
Kategorio:Semantiko	Semantics
Senegal	Senegal
Kategorio:Senegal	Senegal
Seoul	Seoul
Septembro	September
11 di septembro	September 11
Atenti ye 11 di septembro 2001	September 11
17 di septembro	September 17
29 di septembro	September 29
Sequo	Sequence
Serbia	Serbia
Kategorio:Serbia	Serbia
Serbia e Montenegro	Serbia and Montenegro
Kategorio:Serbia e Montenegro	Serbia and Montenegro
Sergei Rachmaninoff	Sergei Rachmaninoff
Ensemblo	Set
Ensemblo-teorio	Set theory
Kategorio:Ensemblo-teorio	Set theory
Sep-yara milito	Seven Years' War
Sevilla	Seville
Seycheli	Seychelles
Kategorio:Seycheli	Seychelles
Shanghai	Shanghai
Sharko	Shark
Shildo	Shield
Navo	Ship
Shiva	Shiva
Kreveto	Shrimp
Siberia	Siberia
Sicilia	Sicily
Sierra Leone	Sierra Leone
Kategorio:Sierra Leone	Sierra Leone
Sigmund Freud	Sigmund Freud
Sigrid Undset	Sigrid Undset
Siliko	Silicon
Silko	Silk
Arjento	Silver
Simone de Beauvoir	Simone de Beauvoir
Sinai	Sinai Peninsula
Sinclair Lewis	Sinclair Lewis
Singapur	Singapore
Sidanta Bovo	Sitting Bull
Skopje	Skopje
Slovakia	Slovakia
Kategorio:Slovakia	Slovakia
Slovenia	Slovenia
Kategorio:Slovenia	Slovenia
Smolensk	Smolensk
Nivo	Snow
Category:Socio	Society
Sociologio	Sociology
Category:Sociologio	Sociology
Natro	Sodium
Sofiya	Sofia
Sunala sistemo	Solar System
Kategorio:Sunala sistemo	Solar System
Sunala vento	Solar wind
Solomon-Insuli	Solomon Islands
Solstico	Solstice
Dissolvuro	Solution
Somalia	Somalia
Kategorio:Somalia	Somalia
Kansono	Song
Anmo	Soul
Sono	Sound
Kategorio:Sud-Afrika	South Africa
Kategorio:Sud-Amerika	South America
Suda-Karolina	South Carolina
Kategorio:Suda-Karolina	South Carolina
Suda-Dakota	South Dakota
Sud-Korea	South Korea
Kategorio:Sud-Korea	South Korea
Suda-Vietnam	South Vietnam
Soviet-Uniono	Soviet Union
Kategorio:Soviet-Uniono	Soviet Union
Spaco	Space
Hispania	Spain
Kategorio:Hispania	Spain
Hispaniana interna milito	Spanish Civil War
Sparta	Sparta
Rapideso	Speed
Spencer Tracy	Spencer Tracy
Kashaloto	Sperm Whale
Spermatozoido	Spermatozoon
Sfinxo	Sphinx
Araneo	Spider
Sponjo	Sponge
Sporto	Sport
Spree	Spree
Springfield, Illinois	Springfield
Quadrato	Square (geometry)
Skurelo	Squirrel
Sri Lanka	Sri Lanka
Kategorio:Sri Lanka	Sri Lanka
Saint Louis, Missouri	St. Louis
Stanley Kubrick	Stanley Kubrick
Stelo	Star
Amilo	Starch
Asterio	Starfish
Stato	State
Statistiko	Statistics
Kategorio:Statistiko	Statistics
Vaporomashino	Steam engine
Stephen Hawking	Stephen Hawking
Stepi	Steppe
Stockholm	Stockholm
Stomako	Stomach
Petr-epoko	Stone Age
Cikonio	Stork
Stretajo	Strait
Kategorio:Stretaji	Straits
Vaskulala cerebrala stroko	Stroke
Stroncio	Strontium
Stuttgart	Stuttgart
Sudan	Sudan
Kategorio:Sudan	Sudan
Sudoku	Sudoku
Suez-kanalo	Suez Canal
Sukro	Sugar
Suharto	Suharto
Sukarno	Sukarno
Sulfo	Sulfur
Sumatra	Sumatra
Suno	Sun
Sun Yatsen	Sun Yat-sen
Kirurgio	Surgeon
Kirurgio	Surgery
Surinam	Suriname
Kategorio:Surinam	Suriname
Surrey	Surrey
Susan Sontag	Susan Sontag
Suva	Suva
Hirundo	Swallow
Cigno	Swan
Swazilando	Swaziland
Kategorio:Swazilando	Swaziland
Suedia	Sweden
Kategorio:Suedia	Sweden
Suisia	Switzerland
Kategorio:Suisia	Switzerland
Sydney	Sydney
Silabo	Syllable
Simptomo	Symptom
Sinonimo	Synonym
Sintaxo	Syntax
Sifiliso	Syphilis
Siria	Syria
Kategorio:Siria	Syria
Sistemo	System
T. S. Eliot	T. S. Eliot
Tablo	Table (furniture)
Tahiti	Tahiti
Taipei	Taipei
Kategorio:Taiwan	Taiwan
Tajikistan	Tajikistan
Kategorio:Tadjikistan	Tajikistan
Tallahassee, Florida	Tallahassee
Tallinn	Tallinn
Tampa, Florida	Tampa
Tampere	Tampere
Tantalo	Tantalum
Tanzania	Tanzania
Kategorio:Tanzania	Tanzania
Tapiro	Tapir
Tashkent	Tashkent
Tasmania	Tasmania
Tauro	Taurus (constellation)
Imposto	Tax
Kategorio:Taxado	Taxation
Tbilisi	Tbilisi
Teo	Tea
Kategorio:Teo	Tea
Teknecio	Technetium
Teknologio	Technology
Category:Teknologio	Technology
Tegucigalpa	Tegucigalpa
Tehran	Tehran
Tel Aviv	Tel Aviv
Televiziono	Television
Kategorio:Televiziono	Television
Telurio	Tellurium
Temperaturo	Temperature
Tennessee	Tennessee
Kategorio:Tennessee	Tennessee
Teniso	Tennis
Category:Teniso	Tennis
Terbio	Terbium
Termito	Termite
Terorismo	Terrorism
Testikulo	Testicle
Texas	Texas
Kategorio:Texas	Texas
Tailando	Thailand
Kategorio:Tailando	Thailand
Talio	Thallium
Gambia	The Gambia
Kategorio:Gambia	The Gambia
Theodor Mommsen	Theodor Mommsen
Theodore Roosevelt	Theodore Roosevelt
Teologio	Theology
Kategorio:Teologio	Theology
Teoremo	Theorem
Teorio	Theory
Category:Termodinamiko	Thermodynamics
Thomas Alva Edison	Thomas Edison
Thomas Hobbes	Thomas Hobbes
Thomas Jefferson	Thomas Jefferson
Thomas Malthus	Thomas Malthus
Thomas Mann	Thomas Mann
Torio	Thorium
Tulio	Thulium
Polexo	Thumb
Tigro	Tiger
Tempo	Time
Category:Tempo	Time
Stano	Tin
Tirane	Tirana
Paruo	Tit (bird)
Titano	Titan (moon)
Titanio	Titanium
Tocantins (stato)	Tocantins (state)
Togo	Togo
Kategorio:Togo	Togo
Tokyo	Tokyo
Tom Hanks	Tom Hanks
Tonga	Tonga
Kategorio:Tonga	Tonga
Tony Blair	Tony Blair
Utensilo	Tool
Topeka, Kansas	Topeka
Topologio	Topology
Kategorio:Topologio	Topology
Toronto	Toronto
Momento	Torque
Toro	Torus
Toulouse	Toulouse
Tour de France	Tour de France
Turismo	Tourism
Urbo	Town
Staciono	Train station
Kategorio:Transporto e cirkulo	Transportation
Transilvania	Transylvania
Versailles-kontrakto (1919)	Treaty of Versailles
Arboro	Tree
Trenton, Nova-Jersey	Trenton
Triangulo	Triangle
Enfluanto	Tributary
Trier	Trier
Trigonometriala funciono	Trigonometric function
Trinidad e Tobago	Trinidad and Tobago
Kategorio:Trinidad e Tobago	Trinidad and Tobago
Tripoli	Tripoli
Triton	Triton (moon)
Tropiko di Kankro	Tropic of Cancer
Trygve Lie	Trygve Lie
Trufio	Tuber (genus)
Tuberkulozo	Tuberculosis
Tundra	Tundra
Wolframo	Tungsten
Tunis	Tunis
Tunizia	Tunisia
Kategorio:Tunizia	Tunisia
Turkia	Turkey
Kategorio:Turkia	Turkey
Turkmenistan	Turkmenistan
Kategorio:Turkmenistan	Turkmenistan
Toskania	Tuscany
Tuvalu	Tuvalu
Kategorio:Tuvalu	Tuvalu
Uganda	Uganda
Kategorio:Uganda	Uganda
Ukrainia	Ukraine
Kategorio:Ukrainia	Ukraine
Ulan Bator	Ulan Bator
Ultreviolea	Ultraviolet
Ulysses S. Grant	Ulysses S. Grant
Umbria	Umbria
Unionita Araba Emirati	United Arab Emirates
Kategorio:Unionita Araba Emirati	United Arab Emirates
Unionita Rejio	United Kingdom
Kategorio:Unionita Rejio	United Kingdom
Unioninta Nacioni	United Nations
Kategorio:UN	United Nations
Usa	United States
Kategorio:Usa	United States
Virgin-Insuli Usana	United States Virgin Islands
Dolaro di USA	United States dollar
Universo	Universe
Universitato	University
Uppsala	Uppsala
Uranio	Uranium
Urano	Uranus
Uruguay	Uruguay
Kategorio:Uruguay	Uruguay
Utah	Utah
Kategorio:Utah	Utah
Uzbekistan	Uzbekistan
Kategorio:Uzbekistan	Uzbekistan
Vaduz	Vaduz
Valletta	Valletta
Vanadio	Vanadium
Vancouver	Vancouver
Insulo Vancouver	Vancouver Island
Vanuatu	Vanuatu
Kategorio:Vanuatu	Vanuatu
Vatikano	Vatican City
Kategorio:Vatikano	Vatican City
Vektoro	Vector (spatial)
Veneto	Veneto
Venezuela	Venezuela
Kategorio:Venezuela	Venezuela
Venizia	Venice
Venero	Venus
Vermont	Vermont
Kategorio:Vermont	Vermont
Victor Hugo	Victor Hugo
Victoria, British Columbia	Victoria
Victoria	Victoria
Wien	Vienna
Vientiane	Vientiane
Vietnam	Vietnam
Kategorio:Vietnam	Vietnam
Vietnam-milito	Vietnam War
Kategorio:Vietnam-milito	Vietnam War
Vikingo	Viking
Vilnius	Vilnius
Vincent van Gogh	Vincent van Gogh
Virginia	Virginia
Kategorio:Virginia	Virginia
Vivien Leigh	Vivien Leigh
Vladimir Lenin	Vladimir Lenin
Vladimir Nabokov	Vladimir Nabokov
Vladimir Putin	Vladimir Putin
Vladivostok	Vladivostok
Volkano	Volcano
Volga	Volga River
Voltaire	Voltaire
Vokalo	Vowel
Vulvo	Vulva
Wals	Wales
Walt Disney	Walt Disney
Walt Whitman	Walt Whitman
Category:Militi	War
Warszawa	Warsaw
Washington DC	Washington
Washington (stato)	Washington
Washington	Washington (disambiguation)
Aquo	Water
Kategorio:Aquo	Water
Vaxo	Wax
Pezo	Weight
Wellington	Wellington
West-Germania	West Germany
Westa-Virginia	West Virginia
Kategorio:Westa-Virginia	West Virginia
Baleno	Whale
Frumento	Wheat
Roto	Wheel
Wiskio	Whisky
Leukocito	White blood cell
Wiesbaden	Wiesbaden
Wilhelm Ostwald	Wilhelm Ostwald
William Butler Yeats	William Butler Yeats
William Ewart Gladstone	William Gladstone
William Golding	William Golding
William Henry Harrison	William Henry Harrison
William Howard Taft	William Howard Taft
Wilhelm 2ma	William II
William McKinley	William McKinley
William Shakespeare	William Shakespeare
Willy Brandt	Willy Brandt
Windhoek	Windhoek
Vino	Wine
Category:Vino	Wine
Winston Churchill	Winston Churchill
Wisconsin	Wisconsin
Kategorio:Wisconsin	Wisconsin
Wolfgang Amadeus Mozart	Wolfgang Amadeus Mozart
Wolfgang Pauli	Wolfgang Pauli
Muliero	Woman
Woodrow Wilson	Woodrow Wilson
Vorto	Word
Mondo	World
Mondala Organizeso pri Komerco	World Trade Organization
Unesma Mondo-milito	World War I
Kategorio:Unesma mondo-milito	World War I
Duesma mondo-milito	World War II
Kategorio:Duesma mondo-milito	World War II
Mondo-milito	World war
Wyoming	Wyoming
Kategorio:Wyoming	Wyoming
Xenono	Xenon
Yako	Yak
Rangoon	Yangon
Yaser Arafat	Yasser Arafat
Yaro	Year
Yemen	Yemen
Kategorio:Yemen	Yemen
Yoko Ono	Yoko Ono
Yiterbio	Ytterbium
Yitrio	Yttrium
Yugoslavia	Yugoslavia
Kategorio:Yugoslavia	Yugoslavia
Zachary Taylor	Zachary Taylor
Zagreb	Zagreb
Zambezi	Zambezi
Zambia	Zambia
Kategorio:Zambia	Zambia
Zanzibar	Zanzibar
Zebro	Zebra
Zimbabwe	Zimbabwe
Kategorio:Zimbabwe	Zimbabwe
Zinko	Zinc
Zirkonio	Zirconium
Zodiako	Zodiac
Zoologio	Zoology
Kategorio:Zoologio	Zoology
