Serbian	English
0 (број)	0 (number)
1	1
1 (број)	1 (number)
10	10
100	100
1000	1000
101	101
105	105
11	11
110	110
115	115
12	12
120	120
125	125
13	13
130	130
135	135
14	14
140	140
144	144
145	145
15	15
150	150
155	155
16	16
160	160
165	165
17	17
170	170
1728	1728
175	175
Категорија:1750-е	1750s
Категорија:1760-е	1760s
Категорија:1770-е	1770s
Категорија:1780-е	1780s
Категорија:1790-е	1790s
18	18
180	180
Категорија:1820-е	1820s
Категорија:1830-е	1830s
Категорија:1840-е	1840s
Категорија:1860-е	1860s
Категорија:1870-е	1870s
Категорија:1880-е	1880s
1890е	1890s
Категорија:1890-е	1890s
19	19
190	190
1900е	1900s
Категорија:1900-е	1900s
1920е	1920s
Категорија:1920-е	1920s
1930е	1930s
Категорија:1930-е	1930s
1940е	1940s
Категорија:1940-е	1940s
1950е	1950s
Категорија:1950-е	1950s
1960е	1960s
Категорија:1960-е	1960s
1970е	1970s
Категорија:1970-е	1970s
1980е	1980s
Категорија:1980-е	1980s
1990е	1990s
Категорија:1990-е	1990s
2	2
2 (број)	2 (number)
20	20
200	200
21	21
22	22
23	23
23 (број)	23 (number)
24	24
25	25
26	26
27	27
28	28
29	29
3	3
3 (број)	3 (number)
30	30
300	300
31	31
32	32
33	33
34	34
35	35
36	36
37	37
38	38
39	39
4	4
4 (број)	4 (number)
40	40
400	400
41	41
42	42
43	43
44	44
45	45
46	46
47	47
48	48
49	49
5	5
5 (број)	5 (number)
50	50
500	500
51	51
52	52
53	53
54	54
55	55
56	56
57	57
58	58
59	59
6	6
6 (број)	6 (number)
60	60
61	61
62	62
63	63
64	64
65	65
66	66
67	67
68	68
69	69
7	7
7 (број)	7 (number)
70	70
71	71
72	72
73	73
74	74
75	75
76	76
77	77
78	78
79	79
8	8
8 (број)	8 (number)
80	80
81	81
82	82
83	83
84	84
85	85
86	86
87	87
88	88
89	89
9	9
9 (број)	9 (number)
90	90
91	91
92	92
93	93
94	94
95	95
96	96
97	97
98	98
99	99
A (слово латинице)	A
А (ћириличко)	A (Cyrillic)
Сида	AIDS
АТП	ATP
ФК АЗ Алкмар	AZ (football club)
Ахен	Aachen
Орхус	Aarhus
Арон	Aaron
Абакус (рачунање)	Abacus
Абадан	Abadan
Ава	Abbot
Абревијатор	Abbreviation
Абел Тасман	Abel Tasman
Абелова група	Abelian group
Абердин	Aberdeen
Абиџан	Abidjan
Абхазија	Abkhazia
Аболиционизам	Abolitionism
Побачај	Abortion
Аврам	Abraham
Абрахам Линколн	Abraham Lincoln
Апсинт	Absinthe
Апсолутна звездана величина	Absolute magnitude
Апсолутна вредност	Absolute value
Апсолутна нула	Absolute zero
Апсолутизам	Absolutism (European history)
Апстрактна уметност	Abstract art
Апстрактни експресионизам	Abstract expressionism
Апстракција	Abstraction
Абуџа	Abuja
Акација	Acacia
Награда Америчке филмске академије	Academy Award
Акапулко	Acapulco
Убрзање	Acceleration
Акра	Accra
Акузатив	Accusative case
Сирћетна киселина	Acetic acid
Ацетилхолин	Acetylcholine
Ацетилен	Acetylene
Хајдучка трава	Achillea millefolium
Ахил	Achilles
Киселина	Acid
Кисела киша	Acid rain
Акне	Acne vulgaris
Аконкагва	Aconcagua
Жир	Acorn
Акустика	Acoustics
Категорија:Акустика	Acoustics
Акри	Acre (state)
Акропољ	Acropolis
Актиноиди	Actinide
Актинијум	Actinium
Глумац	Actor
Дела апостолска	Acts of the Apostles
Ad hominem	Ad hominem
Ada (програмски језик)	Ada (programming language)
Адам Смит	Adam Smith
Адана	Adana
Баобаб	Adansonia
Зависност	Addiction
Адис Абеба	Addis Ababa
Сабирање	Addition
Аделејд	Adelaide
Аден	Aden
Аденин	Adenine
Аденозин трифосфат	Adenosine triphosphate
Адијабатски систем	Adiabatic process
Придеви	Adjective
Адолесценција	Adolescence
Адолф Ајхман	Adolf Eichmann
Адолф Хитлер	Adolf Hitler
Адонис	Adonis
Усвојење	Adoption
Јадранско море	Adriatic Sea
Одрасли	Adult
Прилози	Adverb
Егејско море	Aegean Sea
Енеја	Aeneas
Енеида	Aeneid
Еол	Aeolus
Аеродинамика	Aerodynamics
Аеросоли	Aerosol
Есхил	Aeschylus
Езоп	Aesop
Естетика	Aesthetics
Авганистан	Afghanistan
Категорија:Авганистан	Afghanistan
Африка	Africa
Категорија:Африка	Africa
Afroamerikanci	African American
Африканс	Afrikaans
Агамемнон	Agamemnon
Агар	Agar
Ахат	Agate
Агата Кристи	Agatha Christie
Агресија (људско понашање)	Aggression
Кичмењаци без вилица	Agnatha
Агностицизам	Agnosticism
Агора	Agora
Агорафобија	Agoraphobia
Агра	Agra
Пољопривреда	Agriculture
Категорија:Пољопривреда	Agriculture
Аикидо	Aikido
Ен (Рона-Алпи)	Ain
Ратно ваздухопловство	Air force
Ербас	Airbus
Ваздухоплов	Aircraft
Категорија:Авиони	Aircraft
Носач авиона	Aircraft carrier
Авио-компанија	Airline
Аеродром	Airport
Ајакс	Ajax
Акхенатон	Akhenaten
Акира Куросава	Akira Kurosawa
Ал Капоне	Al Capone
Ал Гор	Al Gore
Ал-Каида	Al-Qaeda
Алабама	Alabama
Алан Тјуринг	Alan Turing
Аланин	Alanine
Аљаска	Alaska
Категорија:Аљаска	Alaska
Албанија	Albania
Категорија:Албанија	Albania
Олбани	Albany
Албедо	Albedo
Алберт Абрахам Мајкелсон	Albert Abraham Michelson
Албер Ками	Albert Camus
Алберт Ајнштајн	Albert Einstein
Алберт Шпер	Albert Speer
Алберта	Alberta
Албинизам	Albinism
Албит	Albite
Албум	Album
Албукерки	Albuquerque
Алхемија	Alchemy
Категорија:Алхемија	Alchemy
Алкохол	Alcohol
Алкохолно пиће	Alcoholic beverage
Алкохолизам	Alcoholism
Алдехид	Aldehyde
Јова	Alder
Олдус Хаксли	Aldous Huxley
Алек Гинис	Alec Guinness
Александар Солжењицин	Aleksandr Solzhenitsyn
Aleutska ostrva	Aleutian Islands
Александар Флеминг	Alexander Fleming
Александар Грејам Бел	Alexander Graham Bell
Александар Сергејевич Пушкин	Alexander Pushkin
Александар Велики	Alexander the Great
Александар Дима Отац	Alexandre Dumas
Александрија	Alexandria
Алексис де Токвил	Alexis de Tocqueville
Алфред Драјфус	Alfred Dreyfus
Алфред Хичкок	Alfred Hitchcock
Алфред Нобел	Alfred Nobel
Алфред Норт Вајтхед	Alfred North Whitehead
Alfred Veliki	Alfred the Great
Алге	Algae
Алгебра	Algebra
Категорија:Алгебра	Algebra
Алгебарски број	Algebraic number
Алжир	Algeria
Категорија:Алжир	Algeria
Алжир (град)	Algiers
Алгоритам	Algorithm
Алија	Ali
Алкални метали	Alkali metal
Алкалоид	Alkaloid
Алкан	Alkane
Алкен	Alkene
Алкин	Alkyne
Алах	Allah
Алегорија	Allegory
Алел	Allele
Алергија	Allergy
Алосаур	Allosaurus
Легура	Alloy
Алмати	Almaty
Бадем	Almond
Алоје	Aloe
Алфа	Alpha (letter)
Алфа Кентаури	Alpha Centauri
Алфабет	Alphabet
Алпи	Alps
Категорија:Алпи	Alps
Алзас	Alsace
Олтарски простор у хришћанској цркви	Altar
Алтај (планина)	Altay Mountains
Наизменична струја	Alternating current
Категорија:Алтернативна медицина	Alternative medicine
Алтернативна медицина	Alternative medicine
Алтруизам	Altruism
Алуминијум	Aluminium
Алуминијум оксид	Aluminium oxide
Алвар Алто	Alvar Aalto
Алцхајмерова болест	Alzheimer's disease
Зелена пупавка	Amanita phalloides
Амазон	Amazon River
Ћилибар	Amber
Амброзије Милански	Ambrose
Амелија Ерхарт	Amelia Earhart
Амерички грађански рат	American Civil War
Амерички рат за независност	American Revolutionary War
Америчка Самоа	American Samoa
ASCII	American Standard Code for Information Interchange
Амерички фудбал	American football
Категорија:Амерички фудбал	American football
Америцијум	Americium
Америго Веспучи	Amerigo Vespucci
Аметист	Amethyst
Аминокиселина	Amino acid
Амиш	Amish
Аман	Amman
Амонијак	Ammonia
Амнезија	Amnesia
Амнестија	Amnesty
Ампер	Ampere
Амфетамин	Amphetamine
Водоземци	Amphibian
Амфитеатар	Amphitheatre
Амфора	Amphora
Амстердам	Amsterdam
Категорија:Амстердам	Amsterdam
Амур	Amur
Анабаптисти	Anabaptist
Анахајм	Anaheim
Анални секс	Anal sex
Аналитичка геометрија	Analytic geometry
Анархизам	Anarchism
Категорија:Анархизам	Anarchism
Анархија	Anarchy
Anatol Frans	Anatole France
Категорија:Анатомија	Anatomy
Анатомија	Anatomy
Анаксагора	Anaxagoras
Анаксимандар	Anaximander
Енкориџ	Anchorage
Старогрчки језик	Ancient Greek
Андалузија	Andalusia
Андаманско море	Andaman Sea
Андерс Целзијус	Anders Celsius
Анди	Andes
Андра Прадеш	Andhra Pradesh
Андора	Andorra
Категорија:Андора	Andorra
Андреј Тарковски	Andrei Tarkovsky
Ендру Џексон	Andrew Jackson
Ендру Џонсон	Andrew Johnson
Андроид	Android
Андромеда	Andromeda
Сазвежђе Андромеда	Andromeda (constellation)
Андромеда (галаксија)	Andromeda Galaxy
Енди Ворхол	Andy Warhol
Анемија	Anemia
Анестезиологија	Anesthesia
Ангара	Angara River
Анђео	Angel
Угао	Angle
Англиканизам	Anglicanism
Ангола	Angola
Категорија:Ангола	Angola
Ангвила	Anguilla
Момент импулса	Angular momentum
Угаона брзина	Angular velocity
Боеције	Anicius Manlius Severinus Boethius
Животиње	Animal
Сточарство	Animal husbandry
Анимација	Animation
Аниме	Anime
Категорија:Аниме	Anime
Анимизам	Animism
Анис	Anise
Анкара	Ankara
Ана Болен	Anne Boleyn
Чланковити црви	Annelid
Благовести	Annunciation
Анода	Anode
Мрав	Ant
Антиохија	Antakya
Анталија	Antalya
Тананариво	Antananarivo
Антарктик	Antarctica
Категорија:Антарктик	Antarctica
Антена	Antenna (radio)
Ентони Хопкинс	Anthony Hopkins
Антропологија	Anthropology
Категорија:Антропологија	Anthropology
Антибиотик	Antibiotic
Антитело	Antibody
Антихрист	Antichrist
Антиген	Antigen
Антигона	Antigone
Антигва и Барбуда	Antigua and Barbuda
Категорија:Антигва и Барбуда	Antigua and Barbuda
Антиматерија	Antimatter
Антимон	Antimony
Антисемитизам	Antisemitism
Категорија:Антисемитизам	Antisemitism
Антофагаста	Antofagasta
Антоан Лавоазје	Antoine Lavoisier
Антон Брукнер	Anton Bruckner
Антон Павлович Чехов	Anton Chekhov
Антонио Страдивари	Antonio Stradivari
Антонио Вивалди	Antonio Vivaldi
Антверпен	Antwerp
Анубис	Anubis
Аорта	Aorta
Апачи	Apache
Апатит	Apatite
Афазија	Aphasia
Афоризам	Aphorism
Афродита	Aphrodite
Апија	Apia
Аполон	Apollo
Пројекат Аполо	Apollo program
Апоптоза	Apoptosis
Апалачи	Appalachian Mountains
Јабука	Apple
Кајсија	Apricot
Април	April
14. април	April 14
Апсида	Apse
Апулија	Apulia
Царска вода	Aqua regia
Аквамарин	Aquamarine
Аквадукт	Aqueduct
Аквитанија	Aquitaine
Арапи	Arab
Арапска лига	Arab League
Арабијско полуострво	Arabian Peninsula
Арапско море	Arabian Sea
Арапски језик	Arabic language
Araceae	Araceae
Арахнида	Arachnid
Арафурско море	Arafura Sea
Арагон	Aragon
Аралско језеро	Aral Sea
Префектура Аркадија	Arcadia
Археологија	Archaeology
Категорија:Археологија	Archaeology
Арханђел	Archangel
Архиепископ	Archbishop
Архетип	Archetype
Архимед	Archimedes
Архипелаг	Archipelago
Архитекта	Architect
Архитектура	Architecture
Категорија:Архитектура	Architecture
Северни ледени океан	Arctic Ocean
Поларна лисица	Arctic fox
Ардени (департман)	Ardennes (department)
Ар (јединица)	Are
Palme	Arecaceae
Ареј	Ares
Аргентина	Argentina
Категорија:Аргентина	Argentina
Аргон	Argon
Аријанство	Arianism
Аристократија	Aristocracy
Аристофан	Aristophanes
Аристотел	Aristotle
Аритметика	Arithmetic
Категорија:Аритметика	Arithmetic
Арије	Arius
Аризона	Arizona
Ковчег Завета	Ark of the Covenant
Арканзас	Arkansas
Арл (град)	Arles
Јерменија	Armenia
Категорија:Јерменија	Armenia
Јерменски језик	Armenian language
Арнем	Arnhem
Река Арно	Arno River
Арнолд Шенберг	Arnold Schoenberg
Аркебуза	Arquebus
Арас	Arras
Арсен	Arsenic
Уметност	Art
Арт деко	Art Deco
Арт Нуво	Art Nouveau
Категорија:Историја уметности	Art history
Историја уметности	Art history
Артемида	Artemis
Пелен	Artemisia absinthium
Гихт	Arthritis
Зглавкари	Arthropod
Артур Комптон	Arthur Compton
Артур Конан Дојл	Arthur Conan Doyle
Артур Рембо	Arthur Rimbaud
Артур Шопенхауер	Arthur Schopenhauer
Артур Велсли, војвода од Велингтона	Arthur Wellesley
Вјештачка интелигенција	Artificial intelligence
Артиљерија	Artillery
Артуро Тосканини	Arturo Toscanini
Аруба	Aruba
Категорија:Аруба	Aruba
Азбест	Asbestos
Асклепије	Asclepius
Асурбанипал	Ashurbanipal
Азија	Asia
Категорија:Азија	Asia
Асмара	Asmara
Аспирин	Aspirin
Асам	Assam
Atentat	Assassination
Асемблер	Assembly language
АСЕАН	Association of Southeast Asian Nations
Асирско царство	Assyria
Категорија:Асирско царство	Assyria
Астана	Astana
Астат	Astatine
Астероид	Asteroid
Појас астероида	Asteroid belt
Астма	Asthma
Астрахан	Astrakhan
Астробиологија	Astrobiology
Астролаб	Astrolabe
Астрологија	Astrology
Категорија:Астрологија	Astrology
Астрометрија	Astrometry
Астроном	Astronomer
Астрономска јединица	Astronomical unit
Астрономија	Astronomy
Категорија:Астрономија	Astronomy
Портал:Астрономија	Astronomy
Астрофизика	Astrophysics
Категорија:Астрофизика	Astrophysics
Асимптота	Asymptote
Атакама	Atacama Desert
Атина (митологија)	Athena
Атина	Athens
Категорија:Атлетика	Athletics
Атлетика	Athletics (track and field)
Атланта	Atlanta
Атлантски океан	Atlantic Ocean
Атлантида	Atlantis
Атлас	Atlas (disambiguation)
Atlas (mesec)	Atlas (moon)
Атлас (митологија)	Atlas (mythology)
Атмосферски притисак	Atmospheric pressure
Атол	Atoll
Атом	Atom
Атомски сат	Atomic clock
Релативна атомска маса	Atomic mass
Јединица атомске масе	Atomic mass unit
Атомски број	Atomic number
Категорија:Атомска физика	Atomic physics
Атропин	Atropine
Периферија Атика	Attica
Атила	Attila the Hun
Окланд	Auckland
Аукција	Auction
Август	August
1. август	August 1
15. август	August 15
6. август	August 6
August Strindberg	August Strindberg
Огист Конт	Auguste Comte
Огист Роден	Auguste Rodin
Свети Августин	Augustine of Hippo
Октавијан Август	Augustus
Поларна светлост	Aurora (astronomy)
Остин	Austin
Аустралазија	Australasia
Аустралија	Australia
Категорија:Аустралија	Australia
Аустралијски долар	Australian dollar
Аустралопитекус	Australopithecus
Аустрија	Austria
Категорија:Аустрија	Austria
Аустро-Угарска	Austria-Hungary
Писац	Author
Ауторитет	Authority
Аутобиографија	Autobiography
Аутомобил	Automobile
Аутономни нервни систем	Autonomic nervous system
Аутотрофи	Autotroph
Јесен	Autumn
Оверња	Auvergne (region)
Снежна лавина	Avalanche
Авангарда	Avant-garde
Аватар	Avatar
Ибн Рушд	Averroes
Авеста	Avesta
Категорија:Ваздухопловство	Aviation
Ибн Сина	Avicenna
Авињон	Avignon
Авокадо	Avocado
Авогадров закон	Avogadro's law
Секира	Axe
Аксиома	Axiom
Ајатолах	Ayatollah
Азербејџан	Azerbaijan
Категорија:Азербејџан	Azerbaijan
Азимут	Azimuth
Азорска острва	Azores
Астеци	Aztec
Азурит	Azurite
B (слово латинице)	B
Бејсик	BASIC
Вавилон	Babylon
Tavla	Backgammon
Бактерија	Bacteria
Категорија:Бактерије	Bacteria
Бадминтон	Badminton
Бафинов залив	Baffin Bay
Бафинова земља	Baffin Island
Багдад	Baghdad
Категорија:Бахами	Bahamas
Бахреин	Bahrain
Категорија:Бахреин	Bahrain
Доња Калифорнија	Baja California
Баклава	Baklava
Баку	Baku
Балалајка	Balalaika
Балдер	Baldr
Балеарска острва	Balearic Islands
Стара планина	Balkan Mountains
Балкански ратови	Balkan Wars
Балкан	Balkans
Балет	Ballet
Категорија:Балет	Ballet
Балистичка ракета	Ballistic missile
Балтичко море	Baltic Sea
Балтимор	Baltimore
Бамако	Bamako
Бамбус	Bamboo
Банана	Banana
Бангалор	Bangalore
Бангкок	Bangkok
Бангладеш	Bangladesh
Категорија:Бангладеш	Bangladesh
Банги	Bangui
Банџул	Banjul
Банка	Bank
Категорија:Банке	Banks
Крштење	Baptism
Баптисти	Baptist
Барбадос	Barbados
Категорија:Барбадос	Barbados
Варвари	Barbarian
Барбра Страјсенд	Barbra Streisand
Барселона	Barcelona
Категорија:Барселона	Barcelona
Баренцово море	Barents Sea
Бари	Bari
Баријум	Barium
Јечам	Barley
Kukuvija	Barn Owl
Барометар	Barometer
Барок	Baroque
Баранкиља	Barranquilla
Барел	Barrel (unit)
Базалт	Basalt
База (хемија)	Base (chemistry)
Бејзбол	Baseball
Базел	Basel
Баш	Bash
Босиљак	Basil
Василије Велики	Basil of Caesarea
Базилика	Basilica
Базиликата	Basilicata
Василиск	Basiliscus
Базилиск	Basilisk
Кошарка	Basketball
Категорија:Кошарка	Basketball
Бас гитара	Bass guitar
Доња Нормандија	Basse-Normandie
Бастер	Basseterre
Фагот	Bassoon
Слепи мишеви	Bat
Бат (Сомерсет)	Bath
Бетмен	Batman
Батон Руж	Baton Rouge
Батаљон	Battalion
Батерија	Battery (electricity)
Битка код Аустерлица	Battle of Austerlitz
Битка за Британију	Battle of Britain
Битка код Хејстингса	Battle of Hastings
Битка код Лепанта	Battle of Lepanto (1571)
Маратонска битка	Battle of Marathon
Битка код Мидвеја	Battle of Midway
Термопилска битка	Battle of Thermopylae
Битка код Трафалгара	Battle of Trafalgar
Верденска битка	Battle of Verdun
Битка код Ватерлоа	Battle of Waterloo
Арденска битка	Battle of the Bulge
Битка на Соми	Battle of the Somme
Бојни брод	Battleship
Баухаус	Bauhaus
Боксит	Bauxite
Баварска	Bavaria
Категорија:Баварска	Bavaria
Ловор	Bay Laurel
Бенгалски залив	Bay of Bengal
Бискајски залив	Bay of Biscay
Бајер АГ	Bayer
Бајон	Bayonne
Plaža	Beach
Медвед	Bear
Бофортово море	Beaufort Sea
Бофорова скала	Beaufort scale
Би-бап	Bebop
Бекерел	Becquerel
Кревет	Bed
Беда Поштовани	Bede
Пчела	Bee
Буква	Beech
Категорија:Пчеларство	Beekeeping
Пиво	Beer
Тврдокрилци	Beetle
Бихевиоризам	Behaviorism
Пекинг	Beijing
Бејрут	Beirut
Белорусија	Belarus
Категорија:Белорусија	Belarus
Белфаст	Belfast
Белгија	Belgium
Категорија:Белгија	Belgium
Београд	Belgrade
Велизар	Belisarius
Белизе	Belize
Категорија:Белизе	Belize
Звоно	Bell (instrument)
Белерофонт	Bellerophon
Бело Хоризонте	Belo Horizonte
Белуга	Beluga
Бенелукс	Benelux
Бенин	Benin
Категорија:Бенин	Benin
Бенито Мусолини	Benito Mussolini
Едвард Бенџамин Бритн	Benjamin Britten
Бенџамин Дизраели	Benjamin Disraeli
Бенџамин Френклин	Benjamin Franklin
Бени Гудман	Benny Goodman
Беовулф	Beowulf
Берген	Bergen
Берингово море	Bering Sea
Берингов мореуз	Bering Strait
Берклијум	Berkelium
Берлин	Berlin
Категорија:Берлин	Berlin
Бермуди	Bermuda
Категорија:Бермуди	Bermuda
Бермудски троугао	Bermuda Triangle
Берн	Berne
Bernhard Riman	Bernhard Riemann
Бертолт Брехт	Bertolt Brecht
Бертранд Расел	Bertrand Russell
Берил	Beryl
Берилијум	Beryllium
Бетелгез	Betelgeuse
Бети Дејвис	Bette Davis
Бег	Bey
Бутан	Bhutan
Категорија:Бутан	Bhutan
Библија	Bible
Категорија:Библија	Bible
Библиографија	Bibliography
Бицикл	Bicycle
Велики прасак	Big Bang
Бихар	Bihar
Бикини	Bikini
Жуч	Bile
Бил Клинтон	Bill Clinton
Бил Гејтс	Bill Gates
Били Вајлдер	Billy Wilder
Dvojne i višestruke zvezde	Binary star
Биохемија	Biochemistry
Категорија:Биохемија	Biochemistry
Биолошка разноврсност	Biodiversity
Биогеографија	Biogeography
Биографија	Biography
Портал:Биографија	Biography
Биолошко ратовање	Biological warfare
Биологија	Biology
Категорија:Биологија	Biology
Портал:Биологија	Biology
Биометрија	Biometrics
Биофизика	Biophysics
Биопсија	Biopsy
Биосфера	Biosphere
Биотехнологија	Biotechnology
Витамин Х	Biotin
Манично-депресивна психоза	Bipolar disorder
Бреза	Birch
Птице	Bird
Бермингам (Алабама)	Birmingham
Контрола рађања	Birth control
Бисексуалност	Bisexuality
Бишкек	Bishkek
Епископ	Bishop
Ловац (шах)	Bishop (chess)
Бизмут	Bismuth
Бисао	Bissau
Бит (рачунарство)	Bit
Шкољке	Bivalvia
Црно	Black
Црна смрт	Black Death
Шварцвалд	Black Forest
Црно море	Black Sea
Црна рода	Black Stork
Црна рупа	Black hole
Бибер	Black pepper
Блез Паскал	Blaise Pascal
Блицкриг	Blitzkrieg
Блог	Blog
Крв	Blood
Крвна плазма	Blood plasma
Крвни притисак	Blood pressure
Крвне групе	Blood type
Крвни судови	Blood vessel
Плава боја	Blue
Плави кит	Blue Whale
Bluz	Blues
Divlja svinja	Boar
Игре на табли	Board game
Чамац	Boat
Боб Дилан	Bob Dylan
Боб Марли	Bob Marley
Роберт Фишер	Bobby Fischer
Боб	Bobsleigh
Бодисатва	Bodhisattva
Индекс телесне масе	Body mass index
Чешка (Бохемија)	Bohemia
Боријум	Bohrium
Тачка кључања	Boiling point
Боливија	Bolivia
Категорија:Боливија	Bolivia
Болоња	Bologna
Болцано	Bolzano
Обвезница	Bond (finance)
Кост	Bone
Коштана срж	Bone marrow
Бон	Bonn
Бонсаи	Bonsai
Књига	Book
Четврта књига Мојсијева	Book of Numbers
Булова алгебра	Boolean algebra (structure)
Бордо	Bordeaux
Борис Годунов	Boris Godunov
Борис Пастернак	Boris Pasternak
Борис Спаски	Boris Spassky
Борнео	Borneo
Бор (хемијски елемент)	Boron
Босна и Херцеговина	Bosnia and Herzegovina
Категорија:Босна и Херцеговина	Bosnia and Herzegovina
Бозони	Boson
Босфор	Bosporus
Бостон	Boston
Бостонска чајанка	Boston Tea Party
Ботаничка башта	Botanical garden
Ботаника	Botany
Категорија:Ботаника	Botany
Боцвана	Botswana
Категорија:Боцвана	Botswana
Кљунасти делфин	Bottlenose Dolphin
Бургоња	Bourgogne
Буве (острво)	Bouvet Island
Ратни лук (оружје)	Bow (weapon)
Категорија:Боксери	Boxers
Бокс	Boxing
Категорија:Бокс	Boxing
Бојл-Мариотов закон	Boyle's law
Брага	Braga
Брахма	Brahma
Брајева азбука	Braille
Мозак	Brain
Мозгалице	Brainstorming
Абрахам Стокер	Bram Stoker
Бранденбург	Brandenburg
Вињак	Brandy
Месинг	Brass
Братислава	Bratislava
Брауншвајг	Braunschweig
Бразил	Brazil
Категорија:Бразил	Brazil
Бразавил	Brazzaville
Хлеб	Bread
Бремен	Bremen
Бремен (покрајина)	Bremen (state)
Бремерхафен	Bremerhaven
Бреша	Brescia
Брест (град)	Brest
Брест (вишезначна одредница)	Brest
Бретања	Bretagne
Опека	Brick
Мост	Bridge
Категорија:Мостови	Bridges
Бриџтаун	Bridgetown
Брајтон	Brighton
Бриндизи	Brindisi
Бризбејн	Brisbane
Бристол	Bristol
Британска Колумбија	British Columbia
Британска империја	British Empire
Британска острва	British Isles
Британска Девичанска острва	British Virgin Islands
Брно	Brno
Бродвеј	Broadway (New York City)
Броколи	Broccoli
Бром	Bromine
Бронза	Bronze
Бронзано доба	Bronze Age
Бруклин	Brooklyn
Бруклински мост	Brooklyn Bridge
Мрки медвед	Brown Bear
Брауново кретање	Brownian motion
Брус Ли	Bruce Lee
Бриж	Bruges
Брунеј	Brunei
Категорија:Брунеј	Brunei
Брисел	Brussels
Куга	Bubonic plague
Букурешт	Bucharest
Бакингемска палата	Buckingham Palace
Бакминстер Фулер	Buckminster Fuller
Будимпешта	Budapest
Буда	Buddha
Будизам	Buddhism
Категорија:Будизам	Buddhism
Бади Холи	Buddy Holly
Буенос Ајрес	Buenos Aires
Бафало (Њујорк)	Buffalo
Грађевина	Building
Буџумбура	Bujumbura
Бугарска	Bulgaria
Категорија:Бугарска	Bulgaria
Бумбар	Bumblebee
Архимедов закон	Buoyancy
Бирократија	Bureaucracy
Буркина Фасо	Burkina Faso
Категорија:Буркина Фасо	Burkina Faso
Мјанмар	Burma
Категорија:Мијанмар	Burma
Бурса	Bursa
Категорија:Бурунди	Burundi
Аутобус	Bus
Магистрала (рачунарство)	Bus (computing)
Бастер Китон	Buster Keaton
Бутан (једињење)	Butane
Лептир	Butterfly
Бидгошч	Bydgoszcz
Бајт	Byte
Категорија:Византијско царство	Byzantine Empire
C (слово латинице)	C
C (програмски језик)	C (programming language)
Какаовац	Cacao
Кактус	Cactus
Кадмијум	Cadmium
Кадмо	Cadmus
Цезијум	Caesium
Кофеин	Caffeine
Каиро	Cairo
Калабрија	Calabria
Кале	Calais
Калцијум	Calcium
Калцијум карбонат	Calcium carbonate
Калкулатор	Calculator
Калкулус	Calculus
Калдера	Caldera
Календар	Calendar
Калифорнија	California
Категорија:Калифорнија	California
Калифорнијум	Californium
Калигула	Caligula
Калиф	Caliph
Kaligrafija	Calligraphy
Калиопа	Calliope
Калисто	Callisto (moon)
Калиста	Callisto (mythology)
Калорија	Calorie
Калвадос	Calvados
Голгота	Calvary
Калвин Кулиџ	Calvin Coolidge
Калвинизам	Calvinism
Калипсо	Calypso (mythology)
Камбоџа	Cambodia
Категорија:Камбоџа	Cambodia
Кембриџ	Cambridge
Кембриџ (вишезначна одредница)	Cambridge (disambiguation)
Камила	Camel
Камерун	Cameroon
Категорија:Камерун	Cameroon
Кампанија	Campania
Канада	Canada
Категорија:Канада	Canada
Канадски долар	Canadian dollar
Канарска острва	Canary Islands
Канбера	Canberra
Рак (болест)	Cancer
Кандела	Candela
Свећа	Candle
Конопља	Cannabis
Уживалачка употреба конопље	Cannabis (drug)
Кан (Азурна обала)	Cannes
Канибализам	Cannibalism
Кенон	Canon (company)
Кнут Велики	Canute the Great
Капацитивност	Capacitance
Кондензатор	Capacitor
Кејптаун	Cape Town
Зеленортска Острва	Cape Verde
Категорија:Зеленортска острва	Cape Verde
Рт добре наде	Cape of Good Hope
Главни град	Capital
Смртна казна	Capital punishment
Капитализам	Capitalism
Кападокија	Cappadocia
Каракал	Caracal
Каракас	Caracas
Угљени хидрати	Carbohydrate
Угљеник	Carbon
Угљен-диоксид	Carbon dioxide
Карбон (период)	Carboniferous
Карбоксилна киселина	Carboxylic acid
Кардиф	Cardiff
Кардинал	Cardinal (Catholicism)
Арман Жан ди Плеси де Ришеље	Cardinal Richelieu
Кардиологија	Cardiology
Категорија:Кардиологија	Cardiology
Кариби	Caribbean
Категорија:Кариби	Caribbean
Карикатура	Caricature
Карл Дејвид Андерсон	Carl David Anderson
Карл Густав Јунг	Carl Jung
Карл Луис	Carl Lewis
Карл Марија фон Вебер	Carl Maria von Weber
Карл Орф	Carl Orff
Звери	Carnivora
Месождери	Carnivore
Биљке месождерке	Carnivorous plant
Каролинзи	Carolingian dynasty
Карл фон Лине	Carolus Linnaeus
Карпати	Carpathian Mountains
Шаргарепа	Carrot
Картахена	Cartagena
Декартов координатни систем	Cartesian coordinate system
Картагина	Carthage
Картографија	Cartography
Категорија:Картографија	Cartography
Кери Грант	Cary Grant
Казабланка	Casablanca
Каспијско језеро	Caspian Sea
Касандра (митологија)	Cassandra
Ливено гвожђе	Cast iron
Каста	Caste
Кастиља	Castile (historical region)
Замак	Castle
Рокада (шах)	Castling
Кастри	Castries
Мачка	Cat
Каталонија	Catalonia
Категорија:Каталонија	Catalonia
Катализатор	Catalysis
Катаракта	Cataract
Катари	Catharism
Катедрала	Cathedral
Катарина Пар	Catherine Parr
Каталина од Арагона	Catherine of Aragon
Катода	Cathode
Католичанство	Catholicism
Krava	Cattle
Кавказ	Caucasus
Категорија:Кавказ	Caucasus
Карфиол	Cauliflower
Узрочност	Causality
Konjica	Cavalry
Пећина	Cave
Кајена	Cayenne
Кајманска острва	Cayman Islands
Сесил Роудс	Cecil Rhodes
Кедар	Cedar
Целер	Celery
Небеска сфера	Celestial sphere
Целибат	Celibacy
Ћелија (биологија)	Cell (biology)
Ћелијска мембрана	Cell membrane
Једро	Cell nucleus
Ћелијски зид	Cell wall
Виолончело	Cello
Целулоза	Cellulose
Целзијус (јединица)	Celsius
Цемент	Cement
Гробље	Cemetery
Кенозоик	Cenozoic
Попис становништва	Census
Кентаур	Centaur
Центиметар	Centimetre
Средња Африка	Central Africa
Централноафричка Република	Central African Republic
Категорија:Централноафричка Република	Central African Republic
Средња Америка	Central America
ЦИА	Central Intelligence Agency
Централна банка	Central bank
Централни нервни систем	Central nervous system
Процесор	Central processing unit
Центар (регион)	Centre
Центриола	Centriole
Век	Century
Главоношци	Cephalopod
Кербер	Cerberus
Житарице	Cereal
Мали мозак	Cerebellum
Церера (патуљаста планета)	Ceres (dwarf planet)
Церијум	Cerium
Ћезаре Борџија	Cesare Borgia
Пантљичара	Cestoda
Китови	Cetacea
Чад	Chad
Категорија:Чад	Chad
Столица	Chair
Калцедон	Chalcedony
Шампања-Ардени	Champagne-Ardenne
Хаос	Chaos (mythology)
Карло Велики	Charlemagne
Шарлроа	Charleroi
Шарл Бодлер	Charles Baudelaire
Чарлс Дарвин	Charles Darwin
Чарлс Дикенс	Charles Dickens
Чарлс Линдберг	Charles Lindbergh
Чарлс Сандерс Перс	Charles Peirce
Шарл де Гол	Charles de Gaulle
Карло Ћелави	Charles the Bald
Чарли Чаплин	Charlie Chaplin
Чарли Паркер	Charlie Parker
Шарлот	Charlotte
Чари	Charmed
Харон	Charon (moon)
Харон (митологија)	Charon (mythology)
Шартр	Chartres
Шовинизам	Chauvinism
Че Гевара	Che Guevara
Чеченија	Chechnya
Категорија:Чеченија	Chechnya
Сир	Cheese
Гепард	Cheetah
Чељабинск	Chelyabinsk
Хемијска веза	Chemical bond
Хемијско једињење	Chemical compound
Хемијски елемент	Chemical element
Hemijsko inženjerstvo	Chemical engineering
Хемијска реакција	Chemical reaction
Хемијско оружје	Chemical warfare
Хемија	Chemistry
Категорија:Хемија	Chemistry
Портал:Хемија	Chemistry
Кемниц	Chemnitz
Хемотерапија	Chemotherapy
Ченај	Chennai
Чек	Cheque
Černobilj	Chernobyl
Шах	Chess
Категорија:Шах	Chess
Честер А. Артур	Chester A. Arthur
Питоми кестен	Chestnut
Чанг Кај Шек	Chiang Kai-shek
Чикаго	Chicago
Кокошка	Chicken
Леблебија	Chickpea
Чивава	Chihuahua
Порођај	Childbirth
Чиле	Chile
Категорија:Чиле	Chile
Химера	Chimera (mythology)
Категорија:Кина	China
Кина (регион)	China
Хиос	Chios
Хирон	Chiron
Хитин	Chitin
Хлор	Chlorine
Хлорофил	Chlorophyll
Хлоропласт	Chloroplast
Чоколада	Chocolate
Хор	Choir
Колера	Cholera
Холестерол	Cholesterol
Рушљорибе	Chondrichthyes
Чунгћинг	Chongqing
Акорд	Chord (music)
Хордати	Chordate
Кристијан Хајгенс	Christiaan Huygens
Кристијан Диор	Christian Dior
Хришћанство	Christianity
Категорија:Хришћанство	Christianity
Божић	Christmas
Кристифор Колумбо	Christopher Columbus
Хроматин	Chromatin
Хроматографија	Chromatography
Хром	Chromium
Хромозом	Chromosome
Чукотско море	Chukchi Sea
Англиканска црква	Church of England
Цицерон	Cicero
Цигарета	Cigarette
Цимет	Cinnamon
Кирка	Circe
Круг	Circle
Крвни систем	Circulatory system
Цироза јетре	Cirrhosis
Кребсов циклус	Citric acid cycle
Цитрус	Citrus
Грађански рат	Civil war
Цивилизација	Civilization
Кларинет	Clarinet
Кларк Гејбл	Clark Gable
Класична музика	Classical music
Категорија:Класична музика	Classical music
Клод Моне	Claude Monet
Klod Elvud Šenon	Claude Shannon
Клаудије	Claudius
Глина	Clay
Кључ (музика)	Clef
Клемент Атли	Clement Attlee
Клеопатра	Cleopatra (disambiguation)
Клер	Clergy
Кливланд	Cleveland
Клима	Climate
Категорија:Клима	Climate
Климатологија	Climatology
Категорија:Климатологија	Climatology
Klinička depresija	Clinical depression
Клио	Clio
Клиторис	Clitoris
Сат (предмет)	Clock
Клонирање	Cloning
Категорија:Одећа	Clothing
Одећа	Clothing
Облак	Cloud
Хлодовех	Clovis I
Жарњаци	Cnidaria
Грб	Coat of arms
Кобалт	Cobalt
Кокаин	Cocaine
Бубамара	Coccinellidae
Бубашвабе	Cockroach
Коктел	Cocktail
Кокосова палма	Coconut
Кокосова острва	Cocos (Keeling) Islands
Кафа (биљка)	Coffea
Кафа	Coffee
Категорија:Кафа	Coffee
Когнитивна психологија	Cognitive psychology
Когнитивна наука	Cognitive science
Колхида	Colchis
Хладни рат	Cold War
Категорија:Хладни рат	Cold War
Колин Пауел	Colin Powell
Колаж	Collage
Колаген	Collagen
Колоид	Colloid
Келн	Cologne
Колумбија	Colombia
Категорија:Колумбија	Colombia
Коломбо	Colombo
Боја	Color
Далтонизам	Color blindness
Колорадо (држава)	Colorado
Колорадо (река)	Colorado River
Колосеум	Colosseum
Колос са Родоса	Colossus of Rhodes
Голуб	Columbidae
Коламбус	Columbus
Кома	Coma
Комедија	Comedy
Јан Амос Коменски	Comenius
Комета	Comet
Заједница независних држава	Commonwealth of Independent States
Комонвелт	Commonwealth of Nations
Категорија:Комуникације	Communication
Комуникација	Communication
Комунизам	Communism
Категорија:Комунизам	Communism
Комори	Comoros
Категорија:Комори	Comoros
Компакт диск	Compact Disc
Чета	Company (military unit)
Компас	Compass
Шестар	Compass (drafting)
Компајлер	Compiler
Комплексан број	Complex number
Композитор	Composer
Računarska lingvistika	Computational linguistics
Рачунар	Computer
Монитор	Computer display
Хардвер	Computer hardware
Категорија:Хардвер	Computer hardware
Računarska mreža	Computer network
Категорија:Информатика	Computer science
Рачунарски вирус	Computer virus
Категорија:Информатика	Computing
Конакри	Conakry
Бетон	Concrete
Диригент	Conducting
Купа (геометрија)	Cone (geometry)
Конфедеративне Америчке Државе	Confederate States of America
Конфедерација	Confederation
Исповест	Confession
Конфликт	Conflict
Конфучијанство	Confucianism
Конфучије	Confucius
Конго	Congo
Конго (река)	Congo River
Конектикат	Connecticut
Везивно ткиво	Connective tissue
Конкистадор	Conquistador
Консензус	Consensus
Конзервативизам	Conservatism
Константин Велики	Constantine I
Устав	Constitution (political)
Римски конзул	Consul
Континент	Continent
Померање континената	Continental drift
Континентална полица	Continental shelf
Кување	Cooking
UTC	Coordinated Universal Time
Копенхаген	Copenhagen
Бакар	Copper
Autorsko pravo	Copyright
Енглески рог	Cor anglais
Корално море	Coral Sea
Коринт (град)	Corinth
Кориолисов ефекат	Coriolis effect
Корпорација	Corporation
Корозија	Corrosion
Корзика	Corsica
Корунд	Corundum
Космологија	Cosmology
Категорија:Космологија	Cosmology
Костарика	Costa Rica
Категорија:Костарика	Costa Rica
Котону	Cotonou
Памук	Cotton
Кулон (јединица)	Coulomb
Кулонов закон	Coulomb's law
Четврти васељенски сабор	Council of Chalcedon
Трећи васељенски сабор	Council of Ephesus
Кантри музика	Country music
Суд	Court
Ковентри	Coventry
Којот	Coyote
Рак (маглина)	Crab Nebula
Kreacionizam	Creationism
Креда (периода)	Cretaceous
Крит	Crete
Крикет	Cricket
Крим	Crimea
Кримски рат	Crimean War
Криминологија	Criminology
Хрватска	Croatia
Категорија:Хрватска	Croatia
Крокодил	Crocodilia
Крон	Cronus
Крст	Cross
Самострел	Crossbow
Крстарица	Cruiser
Земљина кора	Crust (geology)
Ракови	Crustacean
Криптографија	Cryptography
Категорија:Криптографија	Cryptography
Кристал	Crystal
Категорија:Кристалографија	Crystallography
Реброноше	Ctenophore
Куба	Cuba
Категорија:Куба	Cuba
Коцка	Cube
Кубни метар	Cubic metre
Кубизам	Cubism
Краставац	Cucumber
Култура	Culture
Категорија:Култура	Culture
Куритиба	Curitiba
Киријум	Curium
Карлинг	Curling
Категорија:Новац	Currency
Крива	Curve
Куско	Cusco
Цијанид	Cyanide
Модрозелене бактерије	Cyanobacteria
Кибела	Cybele
Кибернетика	Cybernetics
Sajberpank	Cyberpunk
Бициклизам	Cycling
Категорија:Бициклизам	Cycling
Циклон	Cyclone
Киклопи	Cyclops
Ваљак (геометрија)	Cylinder (geometry)
Cyperaceae	Cyperaceae
Шарани	Cyprinid
Кипар	Cyprus
Категорија:Кипар	Cyprus
Ћирилица	Cyrillic alphabet
Кир Велики	Cyrus the Great
Цистична фиброза	Cystic fibrosis
Цитоплазма	Cytoplasm
Цитозин	Cytosine
Цитоскелет	Cytoskeleton
Чешка Република	Czech Republic
Категорија:Чешка Република	Czech Republic
Чехословачка	Czechoslovakia
Категорија:Чехословачка	Czechoslovakia
D (слово латинице)	D
ДДТ	DDT
ДНК	DNA
DOS (оперативни систем)	DOS
DVD	DVD
Јазавичар	Dachshund
Дадаизам	Dada
Нож	Dagger
Дагеротипија	Daguerreotype
Дакар	Dakar
Далас	Dallas
Далмација	Dalmatia
Дамаск	Damascus
Плес	Dance
Маслачак	Dandelion
Данијел Бернули	Daniel Bernoulli
Данијел Дефо	Daniel Defoe
Данска круна	Danish krone
Данте Алигијери	Dante Alighieri
Дунав	Danube
Дафне	Daphne
Дар ес Салам	Dar es Salaam
Дарданели	Dardanelles
Дарфур	Darfur
Тамна материја	Dark matter
Дармштатијум	Darmstadtium
Дарвин (Северна територија)	Darwin
Дарвин	Darwin
Податак	Data
Структура података	Data structure
База података	Database
Датула	Date Palm
Датив	Dative case
Краљ Давид	David
Давид Хилберт	David Hilbert
Дејвид Хјум	David Hume
Дејвид Ливингстон	David Livingstone
Давид Рикардо	David Ricardo
Дејвис куп	Davis Cup
Дан	Day
Категорија:Дани	Days
Де факто	De facto
Ђакон	Deacon
Мртво море	Dead Sea
Велебиље	Deadly nightshade
Смрт	Death
Категорија:Смрт	Death
Десетлеће	Decade
Децембар	December
31. децембар	December 31
8. децембар	December 8
Декадни систем	Decimal
Деције Трајан	Decius (emperor)
Дедукција	Deductive reasoning
Дефиниција	Definition
Дефлација	Deflation
Лучни степен	Degree (angle)
Деимос	Deimos (moon)
Деизам	Deism
Делавер	Delaware
Делфт	Delft
Del (kompanija)	Dell
Делфи	Delphi
Потоп	Deluge (mythology)
Демагогија	Demagogy
Деменција	Dementia
Деметра	Demeter
Демократија	Democracy
Демократска странка (САД)	Democratic Party (United States)
Демократска Република Конго	Democratic Republic of the Congo
Категорија:Демократска Република Конго	Democratic Republic of the Congo
Демокрит	Democritus
Демографија	Demography
Категорија:Демографија	Demography
Демон	Demon
Денга грозница	Dengue fever
Дени Дидро	Denis Diderot
Данска	Denmark
Категорија:Данска	Denmark
Густина	Density
Каријес	Dental caries
Категорија:Стоматологија	Dentistry
Стоматологија	Dentistry
Денвер	Denver
Извод	Derivative
Пустиња	Desert
Категорија:Пустиње	Deserts
Еразмо Ротердамски	Desiderius Erasmus
Дизајн	Design
Категорија:Дизајн	Design
Разарач	Destroyer
Детерминанта	Determinant
Детерминизам	Determinism
Детроит	Detroit
Деутеријум	Deuterium
Пета књига Мојсијева	Deuteronomy
Дечја психоанализа	Developmental psychology
Драјвер	Device driver
Дака	Dhaka
Дарма	Dharma
Шећерна болест	Diabetes mellitus
Дијалект	Dialect
Пречник	Diameter
Дијамант	Diamond
Принцеза Дајана од Велса	Diana
Дијана	Diana (mythology)
Дијареја	Diarrhea
Дијаспора	Diaspora
Силикатне алге	Diatom
Дикотиледоне биљке	Dicotyledon
Диктатура	Dictatorship
Дијего Ривера	Diego Rivera
Дизел гориво	Diesel
Диференцијална једначина	Differential equation
Дифузија	Diffusion
Варење	Digestion
Дигитална фотографија	Digital photography
ДСЛ	Digital subscriber line
Дижон	Dijon
Мирођија	Dill
Димензија	Dimension
Диносауруси	Dinosaur
Бискупија	Diocese
Диоклецијан	Diocletian
Диода	Diode
Дионис	Dionysus
Дифтерија	Diphtheria
Диплодокус	Diplodocus
Diplomatija	Diplomacy
Категорија:Дипломатија	Diplomacy
Једносмерна струја	Direct current
Категорија:Вишезначна одредница	Disambiguation
Диџеј	Disc jockey
Дискриминација	Discrimination
Болест	Disease
Дестилација	Distillation
Дељење	Division (mathematics)
Развод	Divorce
Дизи Гилеспи	Dizzy Gillespie
Категорија:Џибути	Djibouti
Џибути (град)	Djibouti (city)
Дмитриј Мендељејев	Dmitri Mendeleev
Дмитриј Дмитријевич Шостакович	Dmitri Shostakovich
Дњепар	Dnieper River
Дњепропетровск	Dnipropetrovsk
Доберман (раса паса)	Doberman Pinscher
Додекаедар	Dodecahedron
Додома	Dodoma
Пас	Dog
Догма	Dogma
Доха	Doha
Долмен	Dolmen
Доломит	Dolomite
Delfin	Dolphin
Интернет домен	Domain name
Купола	Dome
Доминика	Dominica
Категорија:Доминика	Dominica
Доминикански ред	Dominican Order
Доминиканска Република	Dominican Republic
Категорија:Доминиканска Република	Dominican Republic
Домицијан	Domitian
Дон Кихот	Don Quixote
Дон	Don River (Russia)
Паја Патак	Donald Duck
Донатело	Donatello
Донато Браманте	Donato Bramante
Доњецк	Donetsk
Магарац	Donkey
Допамин	Dopamine
Доплеров ефекат	Doppler effect
Дорски ред	Doric order
Дорис Лесинг	Doris Lessing
Дортмунд	Dortmund
Контрабас	Double bass
Даглас Макартур	Douglas MacArthur
Даунов синдром	Down syndrome
Дракула	Dracula
Драма	Drama
Сан	Dream
Дрезден	Dresden
Једногрба камила	Dromedary
Суша	Drought
Наркоманија	Drug addiction
Друиди	Druid
Бубањ (музички инструмент)	Drum
Дуализам	Dualism
Дуализам	Dualism (philosophy of mind)
Дубаи	Dubai
Даблин	Dublin
Дубнијум	Dubnium
Дубровник	Dubrovnik
Дванаестопалачно црево	Duodenum
Душанбе	Dushanbe
Дастин Хофман	Dustin Hoffman
Категорија:Холанђани	Dutch people
Двајт Д. Ајзенхауер	Dwight D. Eisenhower
Динамика (физика)	Dynamics (physics)
Dinamit	Dynamite
Дислексија	Dyslexia
Диспрозијум	Dysprosium
Дистопија	Dystopia
E (слово латинице)	E
Број е	E (mathematical constant)
Електронска пошта	E-mail
Ернст Теодор Вилхелм Хофман	E. T. A. Hoffmann
ЕТА	ETA
Орао	Eagle
Уво	Ear
Земља	Earth
Категорија:Земља	Earth
Науке о Земљи	Earth science
Земљотрес	Earthquake
Исток	East
Источна Африка	East Africa
Источнокинеско море	East China Sea
Источна Немачка	East Germany
Источни Тимор	East Timor
Категорија:Источни Тимор	East Timor
Васкрс	Easter
Православље	Eastern Orthodox Church
Ексцентрицитет	Eccentricity (mathematics)
Књига проповедникова	Ecclesiastes
Ехидна	Echidna (mythology)
Бодљокошци	Echinoderm
Помрачење	Eclipse
Еклиптика	Ecliptic
Екологија	Ecology
Категорија:Екологија	Ecology
Економија	Economics
Категорија:Економија	Economics
Економија	Economy
Екосистем	Ecosystem
Еквадор	Ecuador
Категорија:Еквадор	Ecuador
Васељенски сабори	Ecumenical council
Едгар Алан По	Edgar Allan Poe
Edgar Dega	Edgar Degas
Единбург	Edinburgh
Едмунд Халеј	Edmond Halley
Едмонтон	Edmonton
Едмунд Берк	Edmund Burke
Едмунд Хилари	Edmund Hillary
Едмунд Хусерл	Edmund Husserl
Едуард Бухнер	Eduard Buchner
Образовање	Education
Категорија:Образовање	Education
Едвард Григ	Edvard Grieg
Едвард Мунк	Edvard Munch
Едвард Џенер	Edward Jenner
Едвард Телер	Edward Teller
Едвард Исповедник	Edward the Confessor
Јаје	Egg (biology)
Плави патлиџан	Eggplant
Египат	Egypt
Категорија:Египат	Egypt
Египтологија	Egyptology
Ајфелова кула	Eiffel Tower
Ајндховен	Eindhoven
Ајнштајнијум	Einsteinium
Родриго Дијаз де Вивар	El Cid
Ел Греко	El Greco
Ел Пасо	El Paso
Салвадор	El Salvador
Лаба (река)	Elbe
Еленор Рузвелт	Eleanor Roosevelt
Наелектрисање	Electric charge
Електрична струја	Electric current
Електрично поље	Electric field
Електрична гитара	Electric guitar
Категорија:Електротехника	Electrical engineering
Електротехника	Electrical engineering
Електрични отпор	Electrical resistance
Електрицитет	Electricity
Категорија:Електрохемија	Electrochemistry
Електролиза	Electrolysis
Електролит	Electrolyte
Електромагнетно зрачење	Electromagnetic radiation
Електромагнетизам	Electromagnetism
Категорија:Електромагнетизам	Electromagnetism
Електрон	Electron
Електронегативност	Electronegativity
Електроника	Electronics
Категорија:Електроника	Electronics
Елегија	Elegy
Илија	Elijah
Елизабет Тејлор	Elizabeth Taylor
Елипса	Ellipse
Елвис Пресли	Elvis Presley
Ембрион	Embryo
Ембриологија	Embryology
Смарагд	Emerald
Емилија-Ромања	Emilia-Romagna
Емилијано Запата	Emiliano Zapata
Емили Дикинсон	Emily Dickinson
Ема Голдман	Emma Goldman
Осећање	Emotion
Категорија:Емоције	Emotion
Емпатија	Empathy
Емпедокле	Empedocles
Царски пингвин	Emperor Penguin
Емпајер стејт билдинг	Empire State Building
Емпиризам	Empiricism
Емулатор	Emulator
Емулзија	Emulsion
Енциклопедија	Encyclopedia
Ендокрини систем	Endocrine system
Ендокринологија	Endocrinology
Категорија:Ендокринологија	Endocrinology
Енергија	Energy
Енергија	Energy (society)
Мотор	Engine
Инжењер	Engineer
Инжењеринг	Engineering
Енглеска	England
Категорија:Енглеска	England
Ламанш	English Channel
Енглески грађански рат	English Civil War
Енглески језик	English language
Категорија:Енглески језик	English language
Категорија:Енглези	English people
Енглези	English people
Енрико Ферми	Enrico Fermi
Категорија:Забава	Entertainment
Ентропија	Entropy
Окружење	Environment
Ензим	Enzyme
Еон (геологија)	Eon (geology)
Еос	Eos
Ефес	Ephesus
Епика	Epic poetry
Епиктет	Epictetus
Епикур	Epicurus
Епидемија	Epidemic
Епидемиологија	Epidemiology
Епилепсија	Epilepsy
Адреналин	Epinephrine
Богојављење	Epiphany (Christian)
Периферија Епир	Epirus (periphery)
Епистемологија	Epistemology
Посланица Галатима	Epistle to the Galatians
Посланица Римљанима	Epistle to the Romans
Епителско ткиво	Epithelium
Једначина	Equation
Екватор	Equator
Екваторијална Гвинеја	Equatorial Guinea
Категорија:Екваторијална Гвинеја	Equatorial Guinea
Коњи	Equidae
Erasure	Erasure
Ерато	Erato
Ератостен	Eratosthenes
Ербијум	Erbium
Ереб	Erebus
Импотенција	Erectile dysfunction
Ерекција	Erection
Сазвежђе Еридан	Eridanus (constellation)
Ерик Карлфелт	Erik Axel Karlfeldt
Ерик Сати	Erik Satie
Ерида (патуљаста планета)	Eris (dwarf planet)
Ерида (митологија)	Eris (mythology)
Категорија:Еритреја	Eritrea
Ернест Хемингвеј	Ernest Hemingway
Ернест Радерфорд	Ernest Rutherford
Ерос	Eros (mythology)
Еротика	Erotica
Ервин Ромел	Erwin Rommel
Есхатологија	Eschatology
Ешерихија коли	Escherichia coli
Исфахан	Esfahan
Једњак	Esophagus
Есперанто	Esperanto
Категорија:Есперанто	Esperanto
Шпијунажа	Espionage
Еспо	Espoo
Есеј	Essay
Есен	Essen
Етерично уље	Essential oil
Есекс	Essex
Estar	Ester
Категорија:Естонија	Estonia
Етан	Ethane
Етар (хемија)	Ether
Етика	Ethics
Категорија:Етика	Ethics
Етиопија	Ethiopia
Категорија:Етиопија	Ethiopia
Етничка група	Ethnic group
Етнографија	Ethnography
Категорија:Етнологија	Ethnology
Етимологија	Etymology
Еукалиптус	Eucalyptus
Евхаристија	Eucharist
Еуклид	Euclid
Еукариоте	Eukaryote
Евнух	Eunuch
Еуфемизам	Euphemism
Еуфрат	Euphrates
Евроазија	Eurasia
Јазавац	Eurasian Badger
Еурипид	Euripides
Евро	Euro
Европа (сателит)	Europa (moon)
Европа	Europe
Категорија:Европа	Europe
Европска централна банка	European Central Bank
Европска унија	European Union
Категорија:Европска унија	European Union
Еуропијум	Europium
Јевсевије Цезарејски	Eusebius of Caesarea
Еутерпа	Euterpe
Еутаназија	Euthanasia
Ева Браун	Eva Braun
Еволуција (биологија)	Evolution
Девизни курс	Exchange rate
Изопштење	Excommunication
Извршна власт	Executive (government)
Егзибиционизам	Exhibitionism
Egzistencijalizam	Existentialism
Друга књига Мојсијева	Exodus
Очекивана вредност	Expected value
Експеримент	Experiment
Експлозија	Explosion
Експоненцијална функција	Exponential function
Експресионизам	Expressionism
Око	Eye
F (слово латинице)	F
Fabaceae	Fabaceae
Басна	Fable
Шаблон:Чињеница	Fact
Факторијел	Factorial
Фаренхајт (јединица)	Fahrenheit
Поштена употреба	Fair use
Бајка	Fairy tale
Фокландска острва	Falkland Islands
Логичка грешка	Fallacy
Јајоводи	Fallopian tube
Фалун Гонг	Falun Gong
Фантастика	Fantasy
Далеки Исток	Far East
Фарад	Farad
Категорија:Фарска Острва	Faroe Islands
Фашизам	Fascism
Категорија:Мода	Fashion
Мода	Fashion
Брза храна	Fast food
Пост	Fasting
Фовизам	Fauvism
Факс машина	Fax
Страх	Fear
Фебруар	February
12. фебруар	February 12
14. фебруар	February 14
2. фебруар	February 2
22. фебруар	February 22
29. фебруар	February 29
Измет	Feces
Federalni istražni biro	Federal Bureau of Investigation
Савезне резерве САД	Federal Reserve System
Федералне Државе Микронезије	Federated States of Micronesia
Федерико Фелини	Federico Fellini
Fedora Core	Fedora (Linux distribution)
Фидбек	Feedback
Феликс Менделсон	Felix Mendelssohn
Феминизам	Feminism
Категорија:Феминизам	Feminism
Мачевање	Fencing
Фенг Шуи	Feng shui
Фердинанд II, цар Светог римског царства	Ferdinand II
Фернандо Магелан	Ferdinand Magellan
Фердинанд де Сосир	Ferdinand de Saussure
Ферментација	Fermentation (biochemistry)
Ферментација	Fermentation (food)
Фермијум	Fermium
Папрати	Fern
Ферара	Ferrara
Оплођење	Fertilisation
Фетус	Fetus
Феудализам	Feudalism
Фијат	Fiat
Фибоначијев низ	Fibonacci number
Категорија:Фикција	Fiction
Измишљени лик	Fictional character
Фидел Кастро	Fidel Castro
Поље (математика)	Field (mathematics)
Хокеј на трави	Field hockey
Уметничко клизање	Figure skating
Фиџи	Fiji
Категорија:Фиџи	Fiji
FTP	File Transfer Protocol
Датотечни систем	File system
Филипо Брунелески	Filippo Brunelleschi
Категорија:Филм	Film
Филм	Film
Портал:Film	Film
Категорија:Финансије	Finance
Отисак прста	Fingerprint
Финска	Finland
Категорија:Финска	Finland
Јела	Fir
Ватра	Fire
Ватрогасац	Firefighter
Заштитни зид	Firewall (networking)
Фирмвер	Firmware
Други Васељенски Сабор	First Council of Constantinople
Први васељенски сабор	First Council of Nicaea
Први крсташки рат	First Crusade
Прва посланица Коринћанима	First Epistle to the Corinthians
Рибе	Fish
Категорија:Рибе	Fish
Фјорд	Fjord
Застава	Flag
Бич (биологија)	Flagellum
Фламинго	Flamingo
Фландрија	Flanders
Флеш меморија	Flash memory
Пљоснати црви	Flatworm
Фламански језик	Flemish (linguistics)
Бистабилно коло	Flip-flop (electronics)
Поплава	Flood
Дискета	Floppy disk
Фиренца	Florence
Флоренс Најтингејл	Florence Nightingale
Флорида	Florida
Брашно	Flour
Цвет	Flower
Скривеносеменице	Flowering plant
Флуид	Fluid
Флаута	Flute
Магла	Fog
Folna kiselina	Folic acid
Фао	Food and Agriculture Organization
Стопа (јединица)	Foot (unit of length)
Фудбал	Football (soccer)
Категорија:Фудбал	Football (soccer)
Категорија:Фудбал по државама	Football (soccer) by country
Категорија:Фудбалски клубови	Football (soccer) clubs
Категорија:Фудбалски тренери	Football (soccer) managers
Категорија:Фудбалери	Football (soccer) players
Категорија:Фудбалски стадиони	Football (soccer) venues
Забрањени град	Forbidden City
Сила	Force
Шума	Forest
Друштвено уређење	Form of government
Форт Ворт	Fort Worth
Тврђава	Fortification
Фортран	Fortran
Фосил	Fossil
Фосилна горива	Fossil fuel
Фонтана	Fountain
Четврти крсташки рат	Fourth Crusade
Лисица	Fox
Фрактал	Fractal
Француска	France
Категорија:Француска	France
Франсис Бејкон	Francis Bacon
Френсис Дрејк	Francis Drake
Франсис Форд Копола	Francis Ford Coppola
Фрањо Асишки	Francis of Assisi
Фрањевци	Franciscan
Франсиско Франко	Francisco Franco
Франсиско Гоја	Francisco Goya
Франсиско Пизаро	Francisco Pizarro
Францијум	Francium
Француско-пруски рат	Franco-Prussian War
Френк Лојд Рајт	Frank Lloyd Wright
Френк Синатра	Frank Sinatra
Франкфурт на Мајни	Frankfurt
Франкфурт на Одри	Frankfurt (Oder)
Франкфурт	Frankfurt (disambiguation)
Франс Халс	Frans Hals
Франц Кафка	Franz Kafka
Франц Лист	Franz Liszt
Франц Шуберт	Franz Schubert
Фред Астер	Fred Astaire
Фридрих Барбароса	Frederick I
Фридрих II, цар Светог римског царства	Frederick II
Фредерик Сангер	Frederick Sanger
Фредерик Соди	Frederick Soddy
Frederikton	Fredericton
Слободна воља	Free will
Слобода	Freedom (philosophy)
Слободно зидарство	Freemasonry
Фритаун	Freetown
Француска Полинезија	French Polynesia
Категорија:Француска Полинезија	French Polynesia
Француска револуција	French Revolution
Француски франак	French franc
Категорија:Французи	French people
Фреквенција	Frequency
Фреска	Fresco
Фрезно	Fresno
Фреја	Freyja
Фрејр	Freyr
Петак	Friday
Фритјоф Нансен	Fridtjof Nansen
Фридрих Енгелс	Friedrich Engels
Фриц Хабер	Fritz Haber
Фурланија-Јулијска крајина	Friuli-Venezia Giulia
Жаба	Frog
Фруктоза	Fructose
Плод	Fruit
Категорија:Воће	Fruit
Фукинг (Аустрија)	Fucking
Gorive ćelije	Fuel cell
Функција (математика)	Function (mathematics)
Категорија:Основне категорије	Fundamental
Фундаментализам	Fundamentalism
Категорија:Гљиве	Fungi
Гљиве	Fungus
Фанк	Funk
Будућност	Future
Футуризам	Futurism (art)
Расплинута логика	Fuzzy logic
Фјодор Михајлович Достојевски	Fyodor Dostoevsky
G (слово латинице)	G
Гимп	GIMP
Гном	GNOME
ГНУ	GNU
Габон	Gabon
Категорија:Габон	Gabon
Габороне	Gaborone
Арханђел Гаврило	Gabriel
Гадолинијум	Gadolinium
Гаетано Доницети	Gaetano Donizetti
Геја	Gaia (mythology)
Галатија	Galatia
Галаксија	Galaxy
Галенит	Galena
Galicija (provincija)	Galicia (Central Europe)
Галиција	Galicia (Spain)
Галилеја	Galilee
Галилео Галилеј	Galileo Galilei
Галија (брод)	Galley
Галијум	Gallium
Гамал Абдел Насер	Gamal Abdel Nasser
Игра	Game
Теорија игара	Game theory
Гама	Gamma
Гама зрачење	Gamma ray
Ганимед (сателит)	Ganymede (moon)
Гарфилд	Garfield
Бели лук	Garlic
Гас	Gas
Гасовити џин	Gas giant
Систем органа за варење	Gastrointestinal tract
Пужеви	Gastropoda
Галија (провинција)	Gaul
Сидарта Гаутама	Gautama Buddha
Геј	Gay
Газа	Gaza
Појас Газе	Gaza Strip
Геб	Geb
Драго камење	Gemstone
Ген	Gene
Категорија:Генеалогија	Genealogy
Генерал	General Officer
Општа теорија релативности	General relativity
Прва књига Мојсијева	Genesis
Генетски код	Genetic code
Генетички инжењеринг	Genetic engineering
Генетика	Genetics
Категорија:Генетика	Genetics
Женева	Geneva
Џин (ислам)	Genie
Генитив	Genitive case
Ђенова	Genoa
Геноцид	Genocide
Категорија:Геноцид	Genocide
Геном	Genome
Генотип	Genotype
Род (биологија)	Genus
Геохемија	Geochemistry
Геодезија	Geodesy
Категорија:Геодезија	Geodesy
Географија	Geography
Категорија:Географија	Geography
Портал:Географија	Geography
Категорија:Геологија	Geology
Геологија	Geology
Геометрија	Geometry
Категорија:Геометрија	Geometry
Геоморфологија	Geomorphology
Категорија:Геоморфологија	Geomorphology
Геофизика	Geophysics
Категорија:Геофизика	Geophysics
Геополитика	Geopolitics
Георг Вилхелм Фридрих Хегел	Georg Wilhelm Friedrich Hegel
Џорџ Беркли	George Berkeley
Џорџ Бернард Шо	George Bernard Shaw
Џорџ Бул	George Boole
Џорџ Буш	George Bush
Георг Фридрих Хендл	George Frideric Handel
Џорџ Гершвин	George Gershwin
Џорџ Харисон	George Harrison
Џорџ Лукас	George Lucas
Џорџ Маршал (генерал)	George Marshall
Џорџ Орвел	George Orwell
Џорџ Паџет Томсон	George Paget Thomson
Жорж Санд	George Sand
Џорџ Стивенсон	George Stephenson
Џорџ В. Буш	George W. Bush
Џорџ Вашингтон	George Washington
Жорж Бизе	Georges Bizet
Жорж Брак	Georges Braque
Жорж Клемансо	Georges Clemenceau
Џорџтаун	Georgetown
Џорџија	Georgia (U.S. state)
Грузија	Georgia (country)
Категорија:Грузија	Georgia (country)
Џералд Форд	Gerald Ford
Немачки овчар	German Shepherd Dog
Немачки језик	German language
Категорија:Немачки језик	German language
Германијум	Germanium
Немачка	Germany
Категорија:Немачка	Germany
Гестапо	Gestapo
Гејзир	Geyser
Гана	Ghana
Категорија:Гана	Ghana
Гент	Ghent
Гето	Ghetto
Ђакомо Пучини	Giacomo Puccini
Џиновска панда	Giant Panda
Гибралтар	Gibraltar
Категорија:Гибралтар	Gibraltar
Гигабајт	Gigabyte
Гилгамеш	Gilgamesh
Ђумбир	Ginger
Гинко	Ginkgo
Ђордано Бруно	Giordano Bruno
Ђорђо Вазари	Giorgio Vasari
Đorđo de Kiriko	Giorgio de Chirico
Ђото ди Бондоне	Giotto di Bondone
Ђовани Бокачо	Giovanni Boccaccio
Жирафа	Giraffe
Ђироламо Савонарола	Girolamo Savonarola
Жиронда	Gironde
Ђузепе Гарибалди	Giuseppe Garibaldi
Ђузепе Верди	Giuseppe Verdi
Ледник	Glacier
Гладијатор	Gladiator
Жлезда	Gland
Глазгов	Glasgow
Стакло	Glass
Наочаре	Glasses
Ваздухопловна једрилица	Glider
Globalni pozicioni sistem	Global Positioning System
Глобално загревање	Global warming
Глобализација	Globalization
Глукагон	Glucagon
Глукоза	Glucose
Глуон	Gluon
Глицин	Glycine
Гликоген	Glycogen
Гликолиза	Glycolysis
Гнајс	Gneiss
Гностицизам	Gnosticism
Го	Go (board game)
Гоа	Goa
Голман	Goalkeeper
Коза	Goat
Гоби	Gobi Desert
Бог	God
Голанска висораван	Golan Heights
Злато	Gold
Голда Меир	Golda Meir
Златна хорда	Golden Horde
Златни ретривер	Golden Retriever
Голф	Golf
Категорија:Голф	Golf
Голџијев апарат	Golgi apparatus
Гугл	Google
Категорија:Гугл	Google
Гугол	Googol
Горгоне	Gorgon
Гориле	Gorilla
Јеванђеље	Gospel
Јеванђеље по Луки	Gospel of Luke
Гетеборг	Gothenburg
Готхолд Ефраим Лесинг	Gotthold Ephraim Lessing
Готлиб Дајмлер	Gottlieb Daimler
Гихт	Gout
Влада	Government
Грејс Кели	Grace Kelly
Grafiti	Graffiti
Граматика	Grammar
Категорија:Граматика	Grammar
Гранада	Granada
Гренд слем	Grand Slam (tennis)
Велемајстор	Grandmaster (chess)
Гранит	Granite
Грожђе	Grape
Грејпфрут	Grapefruit
Категорија:Графички дизајн	Graphic design
Графички дизајн	Graphic design
Графит	Graphite
Гравитација	Gravitation
Гравитациона константа	Gravitational constant
Греј (јединица)	Gray (unit)
Вук	Gray Wolf
Грац	Graz
Велики корални гребен	Great Barrier Reef
Велика Британија	Great Britain
Велика криза	Great Depression
Велика језера	Great Lakes
Велика раселинска долина	Great Rift Valley
Кинески зид	Great Wall of China
Велики Антили	Greater Antilles
Највећи заједнички делилац	Greatest common divisor
Грчка	Greece
Категорија:Грчка	Greece
Грчко писмо	Greek alphabet
Грчка ватра	Greek fire
Грчка митологија	Greek mythology
Категорија:Грчка митологија	Greek mythology
Зелена боја	Green
Стаклена башта	Greenhouse
Efekat staklene bašte	Greenhouse effect
Гренланд	Greenland
Категорија:Гренланд	Greenland
Гренландско море	Greenland Sea
Гринпис	Greenpeace
Грегор Мендел	Gregor Mendel
Грегоријански календар	Gregorian calendar
Категорија:Гренада	Grenada
Гренобл	Grenoble
Грета Гарбо	Greta Garbo
Грифон	Griffin
Белоглави суп	Griffon Vulture
Бруто домаћи производ	Gross domestic product
Група	Group
Група (математика)	Group (mathematics)
Теорија група	Group theory
Грозни	Grozny
Гвадалахара (Мексико)	Guadalajara
Гваделуп	Guadeloupe
Гуам	Guam
Гуангџоу	Guangzhou
Гуанин	Guanine
Категорија:Гватемала	Guatemala
Гватемала (град)	Guatemala City
Гвајакил	Guayaquil
Гернзи	Guernsey
Гуљелмо Маркони	Guglielmo Marconi
Еснаф	Guild
Гијом Аполинер	Guillaume Apollinaire
Гиљотина	Guillotine
Гвинеја	Guinea
Категорија:Гвинеја	Guinea
Морско прасе	Guinea pig
Гвинеја Бисао	Guinea-Bissau
Категорија:Гвинеја Бисао	Guinea-Bissau
Гитара	Guitar
Гуџарат	Gujarat
Голфска струја	Gulf Stream
Заливски рат	Gulf War
Аденски залив	Gulf of Aden
Акабски залив	Gulf of Aqaba
Ботнички залив	Gulf of Bothnia
Фински залив	Gulf of Finland
Гвинејски залив	Gulf of Guinea
Мексички залив	Gulf of Mexico
Омански залив	Gulf of Oman
Тајландски залив	Gulf of Thailand
Барут	Gunpowder
Густав Климт	Gustav Klimt
Густав Лудвиг Херц	Gustav Ludwig Hertz
Густав Малер	Gustav Mahler
Гистав Курбе	Gustave Courbet
Гистав Флобер	Gustave Flaubert
Ги де Мопасан	Guy de Maupassant
Категорија:Гвајана	Guyana
Гимнастика	Gymnastics
Гипс	Gypsum
H (слово латинице)	H
Херберт Џорџ Велс	H. G. Wells
ХИВ	HIV
HTML	HTML
Ареал	Habitat
Хакер	Hacker
Хад	Hades
Хадријан	Hadrian
Хадријанов зид	Hadrian's Wall
Хемофилија	Haemophilia
Хафнијум	Hafnium
Аја Софија	Hagia Sophia
Хаифа	Haifa
Град (падавина)	Hail
Коса	Hair
Хаити	Haiti
Категорија:Хаити	Haiti
Hadžiluk	Hajj
Хелебарда	Halberd
Време полураспада	Half-life
Ноћ вештица	Halloween
Халуцинација	Hallucination
Халогени елементи	Halogen
Хамас	Hamas
Хамлет	Hamlet
Чекић	Hammer
Хамураби	Hammurabi
Хрчак	Hamster
Висећи вртови из Вавилона	Hanging Gardens of Babylon
Хана Арент	Hannah Arendt
Ханибал	Hannibal
Ханој	Hanoi
Хановер	Hanover
Ханс Кристијан Андерсен	Hans Christian Andersen
Ханза	Hanseatic League
Ханука	Hanukkah
Срећа	Happiness
Хараре	Harare
Тврдина	Hardness
Усна хармоника	Harmonica
Харолд Пинтер	Harold Pinter
Харфа	Harp
Чембало	Harpsichord
Херијет Елизабет Бичер Стоу	Harriet Beecher Stowe
Харијет Табман	Harriet Tubman
Хасијум	Hassium
Мржња	Hatred
Горња Нормандија	Haute-Normandie
Хавана	Havana
Хаваји	Hawaii
Глава	Head
Šef države	Head of state
Здравље	Health
Категорија:Здравље	Health
Срце	Heart
Топлотни мотор	Heat engine
Рај	Heaven
Категорија:Хеви метал	Heavy metal
Хеви метал	Heavy metal music
Тешка вода	Heavy water
Хеба	Hebe (mythology)
Хебрејско писмо	Hebrew alphabet
Јеврејски календар	Hebrew calendar
Хебриди	Hebrides
Хеката	Hecate
Хектар	Hectare
Хектор	Hector
Хектор Берлиоз	Hector Berlioz
Јеж	Hedgehog
Хедонизам	Hedonism
Хајнрих Рудолф Херц	Heinrich Hertz
Хајнрих Химлер	Heinrich Himmler
Хајнрих Шлиман	Heinrich Schliemann
Хел	Hel (being)
Лепа Јелена	Helen
Хелен Келер	Helen Keller
Хеликоптер	Helicopter
Хелијум	Helium
Пакао	Hell
Хелмут Шмит	Helmut Schmidt
Хелсинки	Helsinki
Категорија:Хематологија	Hematology
Хемоглобин	Hemoglobin
Хемороиди	Hemorrhoid
Анри Бекерел	Henri Becquerel
Анри Бергсон	Henri Bergson
Анри Матис	Henri Matisse
Henrik Ibzen	Henrik Ibsen
Хенри	Henry (unit)
Хенри Кевендиш	Henry Cavendish
Хенри Фонда	Henry Fonda
Хенри Форд	Henry Ford
Хенри Кисинџер	Henry Kissinger
Хенри Милер	Henry Miller
Хенри Мур	Henry Moore
Хепатитис	Hepatitis
Хефест	Hephaestus
Хера	Hera
Херакле	Heracles
Хераклит	Heraclitus
Хералдика	Heraldry
Категорија:Хералдика	Heraldry
Херат	Herat
Херберт Маркузе	Herbert Marcuse
Херберт Спенсер	Herbert Spencer
Херакле	Hercules
Јерес	Heresy
Херман Мелвил	Herman Melville
Херман Хесе	Hermann Hesse
Херман Минковски	Hermann Minkowski
Хермафродит	Hermaphrodite
Хермес	Hermes
Херон	Hero of Alexandria
Херодот	Herodotus
Хероин	Heroin
Херц	Hertz
Хесиод	Hesiod
Хеспериде	Hesperides
Хесен	Hesse
Хестија	Hestia
Хетеросексуалност	Heterosexuality
Хексадецимални систем	Hexadecimal
Шестоугао	Hexagon
Хезболах	Hezbollah
Hibernacija	Hibernation
Хидеки Јукава	Hideki Yukawa
Хијеронимус Бош	Hieronymus Bosch
Хималаји	Himalayas
Хиндукуш	Hindu Kush
Хиндуизам	Hinduism
Категорија:Хиндуизам	Hinduism
Хипарх са Родоса	Hipparchus
Hipici	Hippie
Хипократ са Коса	Hippocrates
Хипократова заклетва	Hippocratic Oath
Нилски коњ	Hippopotamus
Хирохито	Hirohito
Хирошима	Hiroshima
Хистологија	Histology
Категорија:Хистологија	Histology
Хистони	Histone
Историја	History
Категорија:Историја	History
Портал:Историја	History
Хо Ши Мин	Ho Chi Minh
Хобарт	Hobart
Хоби	Hobby
Холивуд	Hollywood
Холмијум	Holmium
Свето-римско царство	Holy Roman Empire
Категорија:Свето римско царство	Holy Roman Empire
Свети Дух	Holy Spirit
Хомер	Homer
Хомо еректус	Homo erectus
Хомофобија	Homophobia
Хомосексуалност	Homosexuality
Хондурас	Honduras
Категорија:Хондурас	Honduras
Мед	Honey
Хонгконг	Hong Kong
Категорија:Хонг Конг	Hong Kong
Хонолулу	Honolulu
Хорације	Horace
Хорејшио Нелсон	Horatio Nelson
Хоризонт (астрономија)	Horizon
Хормони	Hormone
Хорна	Horn (instrument)
Рог Африке	Horn of Africa
Хороскоп	Horoscope
Домаћи коњ	Horse
Хотел	Hotel
Сат	Hour
Пешчани сат	Hourglass
Доктор Хаус (серија)	House (TV series)
Домаћи врабац	House Sparrow
Хјустон	Houston
Ховеркрафт	Hovercraft
Hablov zakon	Hubble's law
Хадсонов залив	Hudson Bay
Хадсон (река)	Hudson River
Иго Капет	Hugh Capet
Hugo Grocije	Hugo Grotius
Хугеноти	Huguenot
Човек	Human
Хуманизам	Humanism
Категорија:Хуманистичке науке	Humanities
Колибри	Hummingbird
Категорија:Хумор	Humor
Хумор	Humour
Хамфри Богарт	Humphrey Bogart
Стогодишњи рат	Hundred Years' War
Мађарска	Hungary
Категорија:Мађарска	Hungary
Лов	Hunting
Хуту	Hutu
Хибрид	Hybrid
Хајдерабад	Hyderabad
Угљоводоник	Hydrocarbon
Хлороводонична киселина	Hydrochloric acid
Хидроелектрана	Hydroelectricity
Водоник	Hydrogen
Водонична веза	Hydrogen bond
Хидрологија	Hydrology
Категорија:Хидрологија	Hydrology
Хидролиза	Hydrolysis
Хидросфера	Hydrosphere
Хидроксид	Hydroxide
Хијена	Hyena
Категорија:Хигијена	Hygiene
Химен	Hymen
Opnokrilci	Hymenoptera
Хипербола	Hyperbola
Хипертензија	Hypertension
Хипертекст	Hypertext
HTTP	Hypertext Transfer Protocol
Хипнос	Hypnos
Хипноза	Hypnosis
Хипотеза	Hypothesis
I (слово латинице)	I
Ијан Флеминг	Ian Fleming
Јапет (митологија)	Iapetus (mythology)
Пиринејско полуострво	Iberian Peninsula
Ибупрофен	Ibuprofen
Лед	Ice
Ледено доба	Ice age
Сладолед	Ice cream
Hokej na ledu	Ice hockey
Исланд	Iceland
Категорија:Исланд	Iceland
Икона	Icon
Иконоборство	Iconoclasm
Ајдахо	Idaho
Идеални гас	Ideal gas
Идеализам	Idealism
Неутрал	Identity element
Јединична матрица	Identity matrix
Ideologija	Ideology
Идо	Ido
Игнасио де Лојола	Ignatius of Loyola
Магматске стене	Igneous rock
Игор Стравински	Igor Stravinsky
Илијада	Iliad
Илиноис	Illinois
Скенер	Image scanner
Имам	Imam
Имануел Кант	Immanuel Kant
Имунски систем	Immune system
Имунологија	Immunology
Категорија:Имунологија	Immunology
Империјализам	Imperialism
Импресионизам	Impressionism
Инцест	Incest
Инч	Inch
Независност	Independence
Индија	India
Категорија:Индија	India
Индијски океан	Indian Ocean
Категорија:Индијски океан	Indian Ocean
Индијана	Indiana
Индијанаполис	Indianapolis
Индира Ганди	Indira Gandhi
Индијум	Indium
Indokina	Indochina
Индонезија	Indonesia
Категорија:Индонезија	Indonesia
Опроштај грехова	Indulgence
Инд	Indus River
Индустријска револуција	Industrial Revolution
Индустрија	Industry
Категорија:Индустрија	Industry
Инерција	Inertia
Pešadija	Infantry
Инфинитив	Infinitive
Бесконачност	Infinity
Запаљење	Inflammation
Инфлација	Inflation
Грип	Influenza
Информација	Information
Инфрацрвена светлост	Infrared
Ингмар Бергман	Ingmar Bergman
Ингрид Бергман	Ingrid Bergman
Унутрашња Монголија	Inner Mongolia
Иновација	Innovation
Инсбрук	Innsbruck
Неорганска хемија	Inorganic chemistry
Инквизиција	Inquisition
Инсекти	Insect
Инсектициди	Insecticide
Бубоједи	Insectivora
Институција	Institution
Инсулин	Insulin
Цео број	Integer
Интеграл	Integral
Интегрисано коло	Integrated circuit
Коефицијент интелигенције	Intelligence quotient
Интерконтинентална балистичка ракета	Intercontinental ballistic missile
Камата	Interest
Интерференција	Interference
Узвици	Interjection
Интерлингва	Interlingua
Организација међународног цивилног ваздухопловства	International Civil Aviation Organization
Међународни суд правде	International Court of Justice
Међународни монетарни фонд	International Monetary Fund
СИ	International System of Units
Категорија:Међународно право	International law
Међународна организација	International organization
Интернет	Internet
Категорија:Интернет	Internet
Интернет експлорер	Internet Explorer
Концентрациони логор	Internment
Интерпретатор	Interpreter (computing)
Интервал (музика)	Interval (music)
Intranet	Intranet
Бескичмењаци	Invertebrate
Ио	Io (moon)
Ио (митологија)	Io (mythology)
Јод	Iodine
Јон	Ion
Јонско море	Ionian Sea
Јонска веза	Ionic bond
Јоносфера	Ionosphere
Ајова	Iowa
Иран	Iran
Категорија:Иран	Iran
Ирачко-ирански рат	Iran-Iraq War
Ирак	Iraq
Категорија:Ирак	Iraq
Ирска	Ireland
Иринеј Лионски	Irenaeus
Иридијум	Iridium
Ирско море	Irish Sea
Категорија:Ирци	Irish people
Гвожђе (хемијски елемент)	Iron
Гвоздено доба	Iron Age
Гвоздена завеса	Iron Curtain
Ајрон мејден	Iron Maiden
Иронија	Irony
Ирационалан број	Irrational number
Иредентизам	Irredentism
Иртиш	Irtysh River
Исак	Isaac
Исак Асимов	Isaac Asimov
Исак Башевис Сингер	Isaac Bashevis Singer
Исак Њутн	Isaac Newton
Изадора Данкан	Isadora Duncan
Изида	Isis
Ислам	Islam
Категорија:Ислам	Islam
Исламабад	Islamabad
Исламски календар	Islamic calendar
Острво	Island
Острво Ман	Isle of Man
Категорија:Острво Ман	Isle of Man
Изомер (хемијски)	Isomer
Исороку Јамамото	Isoroku Yamamoto
Изотоп	Isotope
Израел	Israel
Категорија:Израел	Israel
Истанбул	Istanbul
Земљоуз	Isthmus
Италија	Italy
Категорија:Италија	Italy
Итака	Ithaca
Иван Петрович Павлов	Ivan Pavlov
Иван Сергејевич Тургењев	Ivan Turgenev
J (слово латинице)	J
Џером Дејвид Селинџер	J. D. Salinger
Џејмс Метју Бари	J. M. Barrie
Џек Лемон	Jack Lemmon
Џек Лондон	Jack London
Џек Трбосек	Jack the Ripper
Џексон Полок	Jackson Pollock
Џексонвил	Jacksonville
Жак Картије	Jacques Cartier
Жак Дерида	Jacques Derrida
Жак Офенбах	Jacques Offenbach
Јагуар	Jaguar
Ђаинизам	Jainism
Џакарта	Jakarta
Јамајка	Jamaica
Категорија:Јамајка	Jamaica
Јаков Заведејев	James
Џејмс Бонд	James Bond
Џејмс Клерк Максвел	James Clerk Maxwell
Џејмс Кук	James Cook
Џемс Џојс	James Joyce
Џејмс Нокс Полк	James K. Polk
Џејмс Медисон	James Madison
Џејмс Монро	James Monroe
Džejms Nejsmit	James Naismith
Џејмс Ват	James Watt
Јан Хус	Jan Hus
Јан ван Ајк	Jan van Eyck
Џејн Остин	Jane Austen
Џејн Фонда	Jane Fonda
Џејн Симор	Jane Seymour
Џенис Џоплин	Janis Joplin
Јањичари	Janissary
Јануар	January
1. јануар	January 1
19. јануар	January 19
20. јануар	January 20
6. јануар	January 6
Јанус	Janus (mythology)
Јапан	Japan
Категорија:Јапан	Japan
Јасон	Jason
Јава	Java
Јава (вишезначна одредница)	Java (disambiguation)
Јава (програмски језик)	Java (programming language)
Џавахарлал Нехру	Jawaharlal Nehru
Џез	Jazz
Категорија:Џез	Jazz
Жан Огист Доминик Енгр	Jean Auguste Dominique Ingres
Жан Кокто	Jean Cocteau
Жан Пијаже	Jean Piaget
Жан Расин	Jean Racine
Јан Сибелијус	Jean Sibelius
Жан де Лафонтен	Jean de La Fontaine
Жан Жак Русо	Jean-Jacques Rousseau
Жан-Пол Сартр	Jean-Paul Sartre
Џида	Jeddah
Џеферсон Дејвис	Jefferson Davis
Јеховини сведоци	Jehovah's Witnesses
Сцифомедузе	Jellyfish
Јена	Jena
Џереми Бентам	Jeremy Bentham
Херез де ла Фронтера	Jerez de la Frontera
Јероним Стридонски	Jerome
Џерси	Jersey
Јерусалим	Jerusalem
Категорија:Јерусалим	Jerusalem
Исус Христос	Jesus
Јевреји	Jew
Drombulje	Jew's harp
Џихад	Jihad
Џими Хендрикс	Jimi Hendrix
Џими Картер	Jimmy Carter
Јованка Орлеанка	Joan of Arc
Јохан Бернули	Johann Bernoulli
Јохан Себастијан Бах	Johann Sebastian Bach
Јохан Волфганг Гете	Johann Wolfgang von Goethe
Јоханес Брамс	Johannes Brahms
Јохан Гутенберг	Johannes Gutenberg
Јохан Кеплер	Johannes Kepler
Јоханесбург	Johannesburg
Џон Адамс	John Adams
Џон Бардин	John Bardeen
Жан Калвин	John Calvin
Јован Златоусти	John Chrysostom
Џон Далтон	John Dalton
Џон Ленон	John Lennon
Џон Лок	John Locke
Џон Мајнард Кејнз	John Maynard Keynes
Џон Непер	John Napier
Џон Квинси Адамс	John Quincy Adams
Џон Раскин	John Ruskin
Џон Стајнбек	John Steinbeck
Džon Stjuart Mil	John Stuart Mill
Џон Вејн	John Wayne
Џон Виклиф	John Wycliffe
Свети Јован Крститељ	John the Baptist
Џон фон Нојман	John von Neumann
Зглоб	Joint
Џонатан Свифт	Jonathan Swift
Јордан	Jordan
Категорија:Јордан	Jordan
Река Јордан	Jordan River
Хорхе Луис Борхес	Jorge Luis Borges
Џозеф Конрад	Joseph Conrad
Јозеф Гебелс	Joseph Goebbels
Јозеф Хајдн	Joseph Haydn
Жозеф Луј Геј-Лисак	Joseph Louis Gay-Lussac
Џозеф Пулицер	Joseph Pulitzer
Јозеф Шумпетер	Joseph Schumpeter
Јосиф Стаљин	Joseph Stalin
Јосиф Флавије	Josephus
Џул	Joule
Категорија:Новинарство	Journalism
Новинарство	Journalism
Новинар	Journalist
Јовијан	Jovian
Џојстик	Joystick
Јудаизам	Judaism
Категорија:Јудаизам	Judaism
Јудеја	Judea
Џудо	Judo
Џуди Гарланд	Judy Garland
Џијуџицу	Jujutsu
Жил Верн	Jules Verne
Јулијански календар	Julian calendar
Јулијан Отпадник	Julian the Apostate
Гај Јулије Цезар	Julius Caesar
Јул	July
1. јул	July 1
4. јул	July 4
Јун	June
14. јун	June 14
21. јун	June 21
23. јун	June 23
24. јун	June 24
29. јун	June 29
3. јун	June 3
Јупитер (планета)	Jupiter
Категорија:Јупитер	Jupiter
Јупитер (вишезначна одредница)	Jupiter (disambiguation)
Јупитер (митологија)	Jupiter (mythology)
Јура	Jurassic
Јустинијан I	Justinian I
Јитланд	Jutland
K (слово латинице)	K
К2	K2
КГБ	KGB
Каба	Kaaba
Кабул	Kabul
Калахари	Kalahari Desert
Полуострво Камчатка	Kamchatka Peninsula
Камиказе	Kamikaze
Кампала	Kampala
Кандахар	Kandahar
Кенгур	Kangaroo
Канзас	Kansas
Канзас Сити	Kansas City
Карско море	Kara Sea
Карачи	Karachi
Карате	Karate
Карл Барт	Karl Barth
Karl Jaspers	Karl Jaspers
Карл Маркс	Karl Marx
Карма	Karma
Карнатака	Karnataka
Катрин Хепберн	Katharine Hepburn
Катманду	Kathmandu
Катовице	Katowice
Каунас	Kaunas
Казахстан	Kazakhstan
Категорија:Казахстан	Kazakhstan
Казањ	Kazan
Казимир Маљевич	Kazimir Malevich
Келвин (јединица)	Kelvin
Кентаки	Kentucky
Кенија	Kenya
Категорија:Кенија	Kenya
Jezgro operativnog sistema	Kernel (computer science)
Кетон	Ketone
Тастатура	Keyboard (computing)
Клавијатуре	Keyboard instrument
Хабаровск	Khabarovsk
Кан (титула)	Khan
Харков	Kharkiv
Картум	Khartoum
Црвени Кмери	Khmer Rouge
Keops	Khufu
Бубрег	Kidney
Кијев	Kiev
Кигали	Kigali
Килобајт	Kilobyte
Килограм	Kilogram
Километар	Kilometre
Кинетичка енергија	Kinetic energy
Краљ (шах)	King (chess)
Kralj Artur	King Arthur
Kralj Lir (drama)	King Lear
Кингстон (Јамајка)	Kingston
Киншаса	Kinshasa
Кирибати (држава)	Kiribati
Киркук	Kirkuk
Кнесет	Knesset
Витез	Knight
Скакач (шах)	Knight (chess)
Кносос	Knossos
Чвор (брзина)	Knot (speed)
Знање	Knowledge
Кнут Хамсун	Knut Hamsun
Коала	Koala
Полуострво Кола	Kola Peninsula
Колката	Kolkata
Komodo zmaj	Komodo dragon
Конрад Аденауер	Konrad Adenauer
Корејски рат	Korean War
Косово и Метохија	Kosovo
Категорија:Косово и Метохија	Kosovo
Кракатау	Krakatoa
Кремљ	Kremlin
Кришна (божанство)	Krishna
Криптон	Krypton
Кју-клукс-клан	Ku Klux Klan
Куала Лумпур	Kuala Lumpur
Кублај-кан	Kublai Khan
Којперов појас	Kuiper belt
Кунг фу	Kung fu (term)
Кунлун	Kunlun Mountains
Курдистан	Kurdistan
Курск	Kursk
Курт Вонегат	Kurt Vonnegut
Курт Валдхајм	Kurt Waldheim
Кувајт	Kuwait
Категорија:Кувајт	Kuwait
Кувајт (град)	Kuwait City
Квазулу-Натал	KwaZulu-Natal
Кјото	Kyoto
Киргистан	Kyrgyzstan
Категорија:Киргизија	Kyrgyzstan
L (слово латинице)	L
Л'Аквила	L'Aquila
Ла Паз	La Paz
Ла Специја	La Spezia
Лабораторија	Laboratory
Лабрадор ретривер	Labrador Retriever
Лактоза	Lactose
Лагос	Lagos
Лахор	Lahore
Лесе фер	Laissez-faire
Језеро	Lake
Бајкалско језеро	Lake Baikal
Балатон (језеро)	Lake Balaton
Боденско језеро	Lake Constance
Женевско језеро	Lake Geneva
Иљмењ	Lake Ilmen
Ладога	Lake Ladoga
Језеро Малави	Lake Malawi
Мичиген (језеро)	Lake Michigan
Језеро Оњега	Lake Onega
Језеро Тангањика	Lake Tanganyika
Викторијино језеро	Lake Victoria
Змијуљице	Lamprey
Копљаши	Lancelet
Депонија	Landfill
Језик	Language
Лангдок-Русијон	Languedoc-Roussillon
Лансинг	Lansing
Лантаноиди	Lanthanide
Лантан	Lanthanum
Лаос	Laos
Категорија:Лаос	Laos
Лаптевско море	Laptev Sea
Ариш	Larch
Ларва	Larva
Лас Вегас	Las Vegas
Пећина Ласко	Lascaux
Ласер	Laser
Струг	Lathe
Латински језик	Latin
Латинска Америка	Latin America
Латиница	Latin alphabet
Географска ширина	Latitude
Летонија	Latvia
Категорија:Летонија	Latvia
Лозана	Lausanne
Лава	Lava
Категорија:Право	Law
Лоренцијум	Lawrencium
Адвокат	Lawyer
Лацио	Lazio
Ле Корбизје	Le Corbusier
Авр	Le Havre
Олово	Lead
Лист	Leaf
Друштво народа	League of Nations
Криви торањ у Пизи	Leaning Tower of Pisa
Преступна година	Leap year
Учење	Learning
Либан	Lebanon
Категорија:Либан	Lebanon
Леда (митологија)	Leda (mythology)
Ли Харви Освалд	Lee Harvey Oswald
Лидс	Leeds
Леворукост	Left-handed
Законодавна власт	Legislature
Лего	Lego
Лајден	Leiden
Лајпциг	Leipzig
Limun	Lemon
Матичњак	Lemon balm
Лена (река)	Lena River
Дужина	Length
Сочиво (оптика)	Lens (optics)
Сочиво (биљка)	Lentil
Лав I	Leo I (emperor)
Лав Троцки	Leon Trotsky
Леонардо да Винчи	Leonardo da Vinci
Леонард Ојлер	Leonhard Euler
Леонид Брежњев	Leonid Brezhnev
Леопард	Leopard
Lepidoptera	Lepidoptera
Лептон	Lepton
Лезбејка	Lesbian
Лесото	Lesotho
Категорија:Лесото	Lesotho
Мали Антили	Lesser Antilles
Лето (митологија)	Leto
Слово	Letter (alphabet)
Леукемија	Leukemia
Левант	Levant
Трећа књига Мојсијева	Leviticus
Луис Керол	Lewis Carroll
Либерализам	Liberalism
Либерија	Liberia
Категорија:Либерија	Liberia
Библиотека	Library
Либрето	Libretto
Либрвил	Libreville
Либија	Libya
Категорија:Либија	Libya
Лишај	Lichen
Лихтенштајн	Liechtenstein
Категорија:Лихтенштајн	Liechtenstein
Потпоручник	Lieutenant
Живот	Life
Категорија:Живот	Life
Светлост	Light
Светлећа диода	Light-emitting diode
Светлосна година	Light-year
Упаљач	Lighter
Светионик	Lighthouse
Лигурија	Liguria
Liliaceae	Liliaceae
Лилит	Lilith
Лил	Lille
Лилонгве	Lilongwe
Лима	Lima
Кречњак	Limestone
Лимнологија	Limnology
Лимузен	Limousin (region)
Линколн (Небраска)	Lincoln
Права (линија)	Line (mathematics)
Линеарна алгебра	Linear algebra
Категорија:Линеарна алгебра	Linear algebra
Лингва франка	Lingua franca
Лингвистика	Linguistics
Категорија:Лингвистика	Linguistics
Линукс	Linux
Категорија:Линукс	Linux
Линц	Linz
Лав	Lion
Липиди	Lipid
Сладић	Liquorice
Лисабон	Lisbon
Лиса Мајтнер	Lise Meitner
Lisp	Lisp (programming language)
Писменост	Literacy
Књижевност	Literature
Категорија:Књижевност	Literature
Портал:Књижевност	Literature
Литијум	Lithium
Литосфера	Lithosphere
Литванија	Lithuania
Категорија:Литванија	Lithuania
Литар	Litre
Ћук	Little Owl
Ливерпул	Liverpool
Тит Ливије	Livy
Гуштер	Lizard
Љубљана	Ljubljana
Локална мрежа	Local area network
Чудовиште из Лох Неса	Loch Ness Monster
Локомотива	Locomotive
Логаритам	Logarithm
Логика	Logic
Категорија:Логика	Logic
Логичка капија	Logic gate
Лого	Logo
Лоара (департман)	Loire
Loki	Loki
Лолита	Lolita
Ломбардија	Lombardy
Лондон	London
Категорија:Лондон	London
Лонг Бич	Long Beach
Лонг Ајленд	Long Island
Скок удаљ	Long jump
Мала ушара	Long-eared Owl
Лопе де Вега	Lope de Vega
Оче наш	Lord's Prayer
Лорена	Lorraine (region)
Лос Анђелес	Los Angeles
Лот (департман)	Lot (department)
Рачунарски звучник	Loudspeaker
Луј Арагон	Louis Aragon
Луј Армстронг	Louis Armstrong
Луј Брај	Louis Braille
Луј Пастер	Louis Pasteur
Луј I Побожни	Louis the Pious
Луј II	Louis the Stammerer
Луизијана	Louisiana
Луивил	Louisville
Лувр	Louvre
Љубав	Love
Нисконемачки језик	Low German
Доња Саксонија	Lower Saxony
Луанда	Luanda
Лублин	Lublin
Луцерн	Lucerne
Лучано Павароти	Luciano Pavarotti
Лукреције Кар	Lucretius
Лудвиг Болцман	Ludwig Boltzmann
Лудвиг Мис ван дер Рое	Ludwig Mies van der Rohe
Лудвиг Витгенштајн	Ludwig Wittgenstein
Лудвиг ван Бетовен	Ludwig van Beethoven
Луфтвафе	Luftwaffe
Луиђи Галвани	Luigi Galvani
Луиђи Пирандело	Luigi Pirandello
Лумен	Lumen (unit)
Помрачење Месеца	Lunar eclipse
Лунд	Lund
Плућа	Lung
Рибе дводихалице	Lungfish
Лусака	Lusaka
Лаута	Lute
Лутецијум	Lutetium
Лукс	Lux
Луксембург	Luxembourg
Категорија:Луксембург	Luxembourg
Луксембург (град)	Luxembourg (city)
Луксор	Luxor
Лузон	Luzon
Лидија (краљевина)	Lydia
Лимфни систем	Lymphatic system
Лион	Lyon
ЛСД	Lysergic acid diethylamide
Лизозом	Lysosome
M (слово латинице)	M
MESSENGER	MESSENGER
MIME	MIME
MS-DOS	MS-DOS
Макау	Macau
Македонија	Macedonia
Егејска Македонија	Macedonia (Greece)
Мах	Mach number
Аутоматско оружје	Machine gun
Машинско превођење	Machine translation
Мачу Пикчу	Machu Picchu
Макроекономија	Macroeconomics
Категорија:Макроекономија	Macroeconomics
Мадагаскар	Madagascar
Категорија:Мадагаскар	Madagascar
Мадеира	Madeira
Мадона	Madonna (entertainer)
Мадрид	Madrid
Покрајина Мадрид	Madrid (autonomous community)
Мафија	Mafia
Модни часопис	Magazine
Магреб	Maghreb
Магија	Magic (paranormal)
Мажино линија	Maginot Line
Магма	Magma
Магна карта	Magna Carta
Магнезијум	Magnesium
Магнет	Magnet
Магнетно поље	Magnetic field
Магнетизам	Magnetism
Категорија:Магнетизам	Magnetism
Магнетит	Magnetite
Лупа	Magnifying glass
Махараштра	Maharashtra
Махатма Ганди	Mahatma Gandhi
Махајана	Mahayana
Шаблон:Посебан чланак	Main
Мејн	Maine
Маитреја	Maitreya
Кукуруз	Maize
Мајор	Major
Дур	Major scale
Мајорка	Majorca
Малабо	Malabo
Маларија	Malaria
Малезија	Malaysia
Категорија:Малезија	Malaysia
Malkolm Iks	Malcolm X
Малдиви	Maldives
Категорија:Малдиви	Maldives
Мали	Mali
Категорија:Мали	Mali
Малта	Malta
Категорија:Малта	Malta
Малтешки језик	Maltese language
Малтоза	Maltose
Сисари	Mammal
Мамут	Mammoth
Руковођење	Management
Манагва	Managua
Манама	Manama
Манчестер	Manchester
Мандарински језик	Mandarin (linguistics)
Мандарина	Mandarin orange
Манган	Manganese
Манго	Mango
Мангрове	Mangrove
Менхетн	Manhattan
Пројекат Менхетн	Manhattan Project
Манила	Manila
Манипур	Manipur
Манитоба	Manitoba
Маниризам	Mannerism
Манхајм	Mannheim
Мантл	Mantle (geology)
Мантра	Mantra
Мантова	Mantua
Мануел де Фаља	Manuel de Falla
Mao Cedung	Mao Zedong
Карта (мапа)	Map
Јавор	Maple
Мапуто	Maputo
Маратон (спорт)	Marathon
Мермер	Marble
Марк Шагал	Marc Chagall
Марсел Дишан	Marcel Duchamp
Марсел Пруст	Marcel Proust
Март	March
17. март	March 17
19. март	March 19
2. март	March 2
25. март	March 25
Марке	Marche
Марко Поло	Marco Polo
Марко Аурелије	Marcus Aurelius
Марко Випсаније Агрипа	Marcus Vipsanius Agrippa
Маргарет Тачер	Margaret Thatcher
Марија Калас	Maria Callas
Marijanska ostrva	Mariana Islands
Марија Антоанета	Marie Antoinette
Марија Кири	Marie Curie
Мариехамн	Mariehamn
Мерилин Монро	Marilyn Monroe
Марио Варгас Љоса	Mario Vargas Llosa
Марко Антоније	Mark Antony
Марк Твен	Mark Twain
Тржиште	Market
Маркетинг	Marketing
Категорија:Маркетинг	Marketing
Марлен Дитрих	Marlene Dietrich
Брак	Marriage
Марс (вишезначна одредница)	Mars (disambiguation)
Марс (митологија)	Mars (mythology)
Марсеј	Marseille
Маршалска Острва	Marshall Islands
Маршалов план	Marshall Plan
Торбари	Marsupial
Мартин Бубер	Martin Buber
Martin Hajdeger	Martin Heidegger
Мартин Лутер	Martin Luther
Мартин Лутер Кинг	Martin Luther King
Мартин Ван Бјурен	Martin Van Buren
Мартина Навратилова	Martina Navratilova
Мартиник	Martinique
Браћа Маркс	Marx Brothers
Марксизам	Marxism
Категорија:Марксизам	Marxism
Богородица	Mary (mother of Jesus)
Марија Магдалена	Mary Magdalene
Мери Вулстонкрафт	Mary Wollstonecraft
Мериленд	Maryland
Масеру	Maseru
Маса	Mass
Масени број	Mass number
Масачусетс	Massachusetts
МИТ	Massachusetts Institute of Technology
Мастурбација	Masturbation
Мата Хари	Mata Hari
Материјализам	Materialism
Математичка логика	Mathematical logic
Категорија:Математичка логика	Mathematical logic
Математика	Mathematics
Категорија:Математика	Mathematics
Портал:Математика	Mathematics
Матрица (математика)	Matrix (mathematics)
Материја	Matter
Велики четвртак	Maundy Thursday
Морис Равел	Maurice Ravel
Мауританија	Mauritania
Категорија:Мауританија	Mauritania
Маурицијус	Mauritius
Категорија:Маурицијус	Mauritius
Макс Борн	Max Born
Макс Ернст	Max Ernst
Макс Планк	Max Planck
Максимијан	Maximian
Максвелове једначине	Maxwell's equations
Мај	May
1. мај	May 1
24. мај	May 24
Мајен (департман)	Mayenne
Мајонез	Mayonnaise
Мбабане	Mbabane
Мера (математика)	Measure (mathematics)
Месо	Meat
Мека	Mecca
Машинство	Mechanical engineering
Категорија:Машинство	Mechanical engineering
Категорија:Механика	Mechanics
Механика	Mechanics
Медеја	Medea
Медијана (статистика)	Median
Лек	Medication
Медичи	Medici
Медицина	Medicine
Категорија:Медицина	Medicine
Медитација	Meditation
Категорија:Средоземно море	Mediterranean
Средоземно море	Mediterranean Sea
Медуза (митологија)	Medusa
Мегабајт	Megabyte
Мејоза	Meiosis
Мајтнеријум	Meitnerium
Меконг	Mekong
Мел Гибсон	Mel Gibson
Меланезија	Melanesia
Мелодија	Melody
Мелпомена	Melpomene
Тачка топљења	Melting point
Памћење	Memory
Менахем Бегин	Menachem Begin
Мендељејевијум	Mendelevium
Менелај	Menelaus
Менструација	Menstrual cycle
Менструација	Menstruation
Ментални поремећај	Mental disorder
Нана	Mentha
Меркантилизам	Mercantilism
Меркур	Mercury
Жива	Mercury (element)
Меркур (митологија)	Mercury (mythology)
Меркур (планета)	Mercury (planet)
Меритократија	Meritocracy
Меровинзи	Merovingian
Мерил Стрип	Meryl Streep
Мескалин	Mescaline
Мезолит	Mesolithic
Месопотамија	Mesopotamia
Категорија:Месопотамија	Mesopotamia
Мезозоик	Mesozoic
Месија	Messiah
Месина	Messina
Метал (хемија)	Metal
Металоиди	Metalloid
Металургија	Metallurgy
Категорија:Металургија	Metallurgy
Метаморфне стене	Metamorphic rock
Metafora	Metaphor
Метафизика	Metaphysics
Категорија:Метафизика	Metaphysics
Метеорит	Meteorite
Метеориди	Meteoroid
Категорија:Метеорологија	Meteorology
Метадон	Methadone
Метамфетамин	Methamphetamine
Метионин	Methionine
Метис	Metis (moon)
Metonimija	Metonymy
Метар	Metre
Метрички простор	Metric space
Меза (департман)	Meuse
Меза	Meuse River
Мексико	Mexico
Категорија:Мексико	Mexico
Мексико (град)	Mexico City
Мајами	Miami
Мајкл Фарадеј	Michael Faraday
Мишел Неј	Michel Ney
Микеланђело Буонароти	Michelangelo
Мичиген (држава)	Michigan
Мик Џегер	Mick Jagger
Мики Маус	Mickey Mouse
Микробиологија	Microbiology
Категорија:Микробиологија	Microbiology
Микроекономија	Microeconomics
Микронезија (регија)	Micronesia
Микрофон	Microphone
Микропроцесор	Microprocessor
Микроскоп	Microscope
Микроталаси	Microwave
Микроталасна пећ	Microwave oven
Средњи вијек	Middle Ages
Категорија:Средњи век	Middle Ages
Блиски Исток	Middle East
Мигел де Сервантес	Miguel de Cervantes
Мајк Тајсон	Mike Tyson
Михаил Бакуњин	Mikhail Bakunin
Михаил Иванович Глинка	Mikhail Glinka
Михаил Горбачов	Mikhail Gorbachev
Милано	Milan
Мајлс Дејвис	Miles Davis
Категорија:Војска	Military
Млеко	Milk
Млечни пут	Milky Way
Миленијум	Millennium
Milimetar	Millimetre
Милтон Фридман	Milton Friedman
Милвоки	Milwaukee
Минарет	Minaret
Минерал	Mineral
Минералогија	Mineralogy
Категорија:Минералогија	Mineralogy
Минерва	Minerva
Династија Минг	Ming Dynasty
Минимализам	Minimalism
Рударство	Mining
Минеаполис	Minneapolis
Минесота	Minnesota
Минојска цивилизација	Minoan civilization
Мол (музика)	Minor scale
Минос (митологија)	Minos
Минотаур	Minotaur
Минск	Minsk
Минут	Minute
Ogledalo	Mirror
Мисури (држава)	Missouri
Мисури (река)	Missouri River
Митохондрије	Mitochondrion
Мнемозина	Mnemosyne
Мобилни телефон	Mobile phone
Модем	Modem
Модернизам	Modernism
Модест Мусоргски	Modest Mussorgsky
Могадишу	Mogadishu
Мојра	Moirae
Молдавија	Moldova
Категорија:Молдавија	Moldova
Мол (јединица)	Mole (unit)
Молекуларна биологија	Molecular biology
Категорија:Молекуларна биологија	Molecular biology
Молекул	Molecule
Молизе	Molise
Мекушци	Mollusca
Молотовљев коктел	Molotov cocktail
Молибден	Molybdenum
Момбаса	Mombasa
Импулс	Momentum
Монако	Monaco
Категорија:Монако	Monaco
Монархија	Monarchy
Манастир	Monastery
Понедељак	Monday
Новац	Money
Монголија	Mongolia
Категорија:Монголија	Mongolia
Моника Селеш	Monica Seles
Монизам	Monism
Монокотиледоне биљке	Monocotyledon
Монопол	Monopoly
Монопол (игра)	Monopoly (game)
Моносахарид	Monosaccharide
Монотеизам	Monotheism
Кљунари	Monotreme
Монроова доктрина	Monroe Doctrine
Монровија	Monrovia
Монс	Mons
Монблан	Mont Blanc
Монтана	Montana
Монте Карло	Monte Carlo
Црна Гора	Montenegro
Категорија:Црна Гора	Montenegro
Монтереј	Monterrey
Монтевидео	Montevideo
Месеци	Month
Монтреал	Montreal
Монсерат	Montserrat
Месец	Moon
Лос	Moose
Морал	Morality
Moravska	Moravia
Мароко	Morocco
Категорија:Мароко	Morocco
Морфијум	Morphine
Морфологија (лингвистика)	Morphology (linguistics)
Морзеова азбука	Morse code
Мозаик	Mosaic
Москва	Moscow
Категорија:Москва	Moscow
Мозел (департман)	Moselle
Мојсије	Moses
Моше Дајан	Moshe Dayan
Џамија	Mosque
Комарац	Mosquito
Маховине	Moss
Мосад	Mossad
Мосул	Mosul
Мајка	Mother
Мајка Тереза	Mother Teresa
Кретање (физика)	Motion (physics)
Мотоцикл	Motorcycle
Арарат	Mount Ararat
Света Гора	Mount Athos
Етна	Mount Etna
Монт Еверест	Mount Everest
Килиманџаро	Mount Kilimanjaro
Олимп	Mount Olympus
Маунт Рашмор	Mount Rushmore
Везув	Mount Vesuvius
Планина	Mountain
Брдски бициклизам	Mountain bike
Рачунарски миш	Mouse (computing)
Мозамбик	Mozambique
Категорија:Мозамбик	Mozambique
Микро знак	Mu (letter)
Мујезин	Muezzin
Мухамед	Muhammad
Мохамед Али	Muhammad Ali
Дуд	Mulberry
Multipla skleroza	Multiple sclerosis
Мумбај	Mumbai
Мумија	Mummy
Минхен	Munich
Мион	Muon
Марфијев закон	Murphy's law
Musa	Musa (genus)
Маскат	Muscat
Мишићно ткиво	Muscle
Музе	Muse
Музеј	Museum
Гљива	Mushroom
Музика	Music
Категорија:Музика	Music
Музички инструменти	Musical instrument
Музикологија	Musicology
Мускета	Musket
Мутација	Mutation
Категорија:Мијанмар	Myanmar
Микена	Mycenae
Микологија	Mycology
Срчани удар	Myocardial infarction
Стоноге	Myriapoda
Мистицизам	Mysticism
Митологија	Mythology
Категорија:Митологија	Mythology
N (слово латинице)	N
Нџамена	N'Djamena
Нездек	NASDAQ
НАТО	NATO
Категорија:НАТО	NATO
Нагасаки	Nagasaki
Нагоја	Nagoya
Наватл	Nahuatl
Ексер	Nail (fastener)
Најроби	Nairobi
Намиб	Namib Desert
Намибија	Namibia
Категорија:Намибија	Namibia
Намир	Namur (city)
Нанси	Nancy
Нанкинг	Nanjing
Нанотехнологија	Nanotechnology
Нант	Nantes
Напуљ	Naples
Наполеонски ратови	Napoleonic Wars
Нарцис (митологија)	Narcissus (mythology)
Нешвил	Nashville
Насау	Nassau
НСА	National Security Agency
Химна	National anthem
Национални парк	National park
Национализам	Nationalism
Категорија:Национализам	Nationalism
Zemni gas	Natural gas
Obrada prirodnih jezika	Natural language processing
Природан број	Natural number
Природне науке	Natural science
Природна селекција	Natural selection
Природа	Nature
Категорија:Природа	Nature
Натуризам	Naturism
Науру	Nauru
Категорија:Науру	Nauru
Наутичка миља	Nautical mile
Ратна морнарица	Navy
Назарет	Nazareth
Нацистичка Немачка	Nazi Germany
Категорија:Нацистичка Немачка	Nazi Germany
Национал-социјалистичка немачка радничка партија	Nazi Party
Категорија:Нацизам	Nazism
Неандерталац	Neanderthal
Небраска	Nebraska
Набукодоносор	Nebuchadrezzar II
Кравата	Necktie
Нефертити	Nefertiti
Негев	Negev
Нил Армстронг	Neil Armstrong
Нелсон Мандела	Nelson Mandela
Ваљкасти црви	Nematode
Немејски лав	Nemean Lion
Немеза (митологија)	Nemesis (mythology)
Неодијум	Neodymium
Неолит	Neolithic
Неон	Neon
Неоплатонизам	Neoplatonism
Непал	Nepal
Категорија:Непал	Nepal
Нефтис	Nephthys
Нептун (планета)	Neptune
Нептунијум	Neptunium
Нерон	Nero
Нерва	Nerva
Нервни систем	Nervous system
Гнездо	Nest
Несторијанство	Nestorianism
Холандија	Netherlands
Категорија:Холандија	Netherlands
Холандски Антили	Netherlands Antilles
Mrežne topologije	Network topology
Неурологија	Neurology
Категорија:Неурологија	Neurology
Неурон	Neuron
Неуротрансмитери	Neurotransmitter
Неутрино	Neutrino
Неутрон	Neutron
Нева	Neva River
Невада	Nevada
Невил Чемберлен	Neville Chamberlain
Њу Бранзвик	New Brunswick
Нова Каледонија	New Caledonia
Њу Делхи	New Delhi
Нова Гвинеја	New Guinea
Њу Хемпшир	New Hampshire
Њу Џерси	New Jersey
Нови Мексико	New Mexico
Њу Орлеанс	New Orleans
Нови Јужни Велс	New South Wales
Нови завет	New Testament
Нови свет	New World
Нова година	New Year
Њујорк (држава)	New York
Њујорк (вишезначна одредница)	New York (disambiguation)
Њујорк	New York City
Категорија:Њујорк	New York City
Нови Зеланд	New Zealand
Категорија:Нови Зеланд	New Zealand
Њуарк (Њу Џерси)	Newark
Њуфаундленд	Newfoundland (island)
Њуфаундленд и Лабрадор	Newfoundland and Labrador
Њутн (јединица)	Newton
Витамин Б3	Niacin
Нијагарини водопади	Niagara Falls
Нијамеј	Niamey
Никарагва	Nicaragua
Категорија:Никарагва	Nicaragua
Ница	Nice
Никејски Симбол Вере	Nicene Creed
Петровић-Његош	Nicholas
Никл	Nickel
Никола Пусен	Nicolas Poussin
Никола Коперник	Nicolaus Copernicus
Никозија	Nicosia
Никотинска зависност	Nicotine
Нилс Бор	Niels Bohr
Нилс Абел	Niels Henrik Abel
Нигер	Niger
Категорија:Нигер	Niger
Нигер (река)	Niger River
Нигерија	Nigeria
Категорија:Нигерија	Nigeria
Нихилизам	Nihilism
Најки (фирма)	Nike
Ника	Nike (mythology)
Никита Хрушчов	Nikita Khrushchev
Никола Тесла	Nikola Tesla
Нил	Nile
Нилски крокодил	Nile crocodile
Нинива	Nineveh
Ниобијум	Niobium
Нирвана	Nirvana
Азотна киселина	Nitric acid
Азот	Nitrogen
Ноје	Noah
Ноам Чомски	Noam Chomsky
Нобелова награда	Nobel Prize
Категорија:Нобелова награда	Nobel Prize
Нобелијум	Nobelium
Категорија:Племство	Nobility
Племенити гасови	Noble gas
Номадизам	Nomad
Номинатив	Nominative case
Неметали	Nonmetal
Острво Норфок	Norfolk Island
Нормална расподела	Normal distribution
Нордијска митологија	Norse mythology
Категорија:Нордијска митологија	Norse mythology
Север	North
Северна Африка	North Africa
Северна Америка	North America
Категорија:Северна Америка	North America
Северна Каролина	North Carolina
Северна Дакота	North Dakota
Северно острво	North Island
Северна Кореја	North Korea
Категорија:Северна Кореја	North Korea
Сјеверни пол	North Pole
Северно море	North Sea
Северна Европа	Northern Europe
Северна Ирска	Northern Ireland
Категорија:Северна Ирска	Northern Ireland
Северна Маријанска острва	Northern Mariana Islands
Северна територија (Аустралија)	Northern Territory
Штука	Northern pike
Севернозападне територије	Northwest Territories
Норвешка	Norway
Категорија:Норвешка	Norway
Норвешко море	Norwegian Sea
Норвешка круна	Norwegian krone
Нострадамус	Nostradamus
Нуакшот	Nouakchott
Именице	Noun
Нова Шкотска	Nova Scotia
Нова Земља	Novaya Zemlya
Роман	Novel
Новембар	November
1. новембар	November 1
11. новембар	November 11
2. новембар	November 2
5. новембар	November 5
Новиал	Novial
Новосибирск	Novosibirsk
Nuklearna fisija	Nuclear fission
Nuklearna fuzija	Nuclear fusion
Нуклеарна физика	Nuclear physics
Категорија:Нуклеарна физика	Nuclear physics
Нуклеарно оружје	Nuclear weapon
Нуклеинске киселине	Nucleic acid
Нуклеотид	Nucleotide
Број	Number
Категорија:Бројеви	Numbers
Нумидија	Numidia
Категорија:Нумизматика	Numismatics
Нунавут	Nunavut
Нирнберг	Nuremberg
Нимфа	Nymph
Nymphaeaceae	Nymphaeaceae
Њукта	Nyx (mythology)
O (слово латинице)	O
OPEK	OPEC
Храст	Oak
Оаза	Oasis
Ovas	Oat
Оахака (држава)	Oaxaca
Об (река у Русији)	Ob River
Гојазност	Obesity
Објектно оријентисано програмирање	Object-oriented programming
Обоа	Oboe
Опсерваторија	Observatory
Обсидијан	Obsidian
Окамова бритва	Occam's razor
Океан	Ocean
Океанија	Oceania
Категорија:Океанија	Oceania
Океаниде	Oceanid
Океанографија	Oceanography
Категорија:Океанографија	Oceanography
Октални систем	Octal
Октава (музика)	Octave
Октобар	October
12. октобар	October 12
24. октобар	October 24
Октобарска револуција	October Revolution
Октопод	Octopus
Одра	Oder River
Одеса	Odessa
Один	Odin
Вилински коњици	Odonata
Одисеј	Odysseus
Одисеја	Odyssey
Едип	Oedipus
Охајо (држава)	Ohio
Ом (јединица)	Ohm
Омов закон	Ohm's law
Окапи	Okapi
Оклахома	Oklahoma
Оклахома (град)	Oklahoma City
Октоберфест	Oktoberfest
Старословенски језик	Old Church Slavonic
Стари завет	Old Testament
Олигархија	Oligarchy
Маслина	Olive
Маслиново уље	Olive oil
Оливер Кромвел	Oliver Cromwell
Олимпија (Грчка)	Olympia
Олимпијске игре	Olympic Games
Категорија:Олимпијске игре	Olympics
Омаха	Omaha
Оман	Oman
Категорија:Оман	Oman
Категорија:Онкологија	Oncology
Црни лук	Onion
Онтарио	Ontario
Категорија:Онтарио	Ontario
Онтологија	Ontology
Ортов облак	Oort cloud
Опера	Opera
Опера (браузер)	Opera (Internet suite)
Оперета	Operetta
опијум	Opium
Оптички кабл	Optical fiber
Оптика	Optics
Категорија:Оптика	Optics
Оптимизација (математика)	Optimization (mathematics)
Орални секс	Oral sex
Наранџаста боја	Orange (colour)
Наранџа	Orange (fruit)
Орангутан	Orangutan
Орбита	Orbit
Кит убица	Orca
Оркестар	Orchestra
Бенедиктинци	Order of Saint Benedict
Вранилова трава	Oregano
Орегон	Oregon
Орест	Orestes (mythology)
Оргуље	Organ (music)
Органска хемија	Organic chemistry
Категорија:Органска хемија	Organic chemistry
Организам	Organism
Организације	Organization
Организација америчких држава	Organization of American States
Оргазам	Orgasm
Ориген	Origen
Првородни грех	Original sin
Ориноко	Orinoco
Сазвежђе Орион	Orion (constellation)
Ориса	Orissa
Орнитологија	Ornithology
Категорија:Орнитологија	Ornithology
Орфеј	Orpheus
Орсон Велс	Orson Welles
Правопис	Orthography
Осака	Osaka
Осама бин Ладен	Osama bin Laden
Оскар Вајлд	Oscar Wilde
Озирис	Osiris
Осло	Oslo
Осман I	Osman I
Осмијум	Osmium
Острава	Ostrava
Ној	Ostrich
Отело (драма)	Othello
Отон	Otho
Отава	Ottawa
Ото Хан	Otto Hahn
Отон I	Otto I
Ото фон Бизмарк	Otto von Bismarck
Османско царство	Ottoman Empire
Категорија:Османско царство	Ottoman Empire
Унца	Ounce
Јајници	Ovary
Овидије	Ovid
Овиједо	Oviedo
Јајна ћелија	Ovum
Сова	Owl
Оксфорд	Oxford
Оксидациони број	Oxidation state
Оксид	Oxide
Кисеоник	Oxygen
Окситоцин	Oxytocin
Озон	Ozone
P (слово латинице)	P
PH вредност	PH
Пабло Неруда	Pablo Neruda
Пабло Пикасо	Pablo Picasso
Велики тихи океан	Pacific Ocean
Пацифизам	Pacifism
Падова	Padua
Паганизам	Paganism
Категорија:Сликарство	Painting
Пакистан	Pakistan
Категорија:Пакистан	Pakistan
Версајска палата	Palace of Versailles
Палау	Palau
Категорија:Палау	Palau
Палеолит	Paleolithic
Палеонтологија	Paleontology
Палеозоик	Paleozoic
Палермо	Palermo
Палестина	Palestine
Категорија:Палестина	Palestine
Палестинска ослободилачка организација	Palestine Liberation Organization
Пали	Pali
Паладијум	Palladium
Палмира	Palmyra
Пан	Pan (mythology)
Панама	Panama
Категорија:Панама	Panama
Панамски канал	Panama Canal
Панама (град)	Panama City
Гуштерача	Pancreas
Пандора	Pandora
Пангеа	Pangaea
Папска држава	Papal States
Папуа Нова Гвинеја	Papua New Guinea
Категорија:Папуа Нова Гвинеја	Papua New Guinea
Папирус	Papyrus
Парабола	Parabola
Парацелзус	Paracelsus
Парадигма	Paradigm
Једрење падобраном	Paragliding
Парагвај	Paraguay
Категорија:Парагвај	Paraguay
Паралелограм	Parallelogram
Парамарибо	Paramaribo
Параноја	Paranoia
Парафилије	Paraphilia
Парапсихологија	Parapsychology
Паразитизам	Parasitism
Париз	Paris
Категорија:Париз	Paris
Парис	Paris (mythology)
Парни и непарни бројеви	Parity (mathematics)
Паркинсонова болест	Parkinson's disease
Скупштина	Parliament
Парменид	Parmenides
Parodija	Parody
Парсек	Parsec
Першун	Parsley
Партенон	Parthenon
Партијско царство	Parthia
Паскал (програмски језик)	Pascal (programming language)
Паскал	Pascal (unit)
Пасха	Passover
Пасош	Passport
Лозинка	Password
Патагонија	Patagonia
Патологија	Pathology
Патра	Patras
Патријарх	Patriarch
Пол Гоген	Paul Gauguin
Paul Hajze	Paul Johann Ludwig von Heyse
Паул Кле	Paul Klee
Пол Макартни	Paul McCartney
Пол Њуман	Paul Newman
Пол Верлен	Paul Verlaine
Свети апостол Павле	Paul the Apostle
Паул фон Хинденбург	Paul von Hindenburg
Паулијев принцип	Pauli exclusion principle
Пешак (шах)	Pawn (chess)
Регион Лоара	Pays de la Loire
Грашак	Pea
Мир	Peace
Вестфалски мир	Peace of Westphalia
Бресква	Peach
Паун	Peafowl
Кикирики	Peanut
Крушка	Pear
Бисер	Pearl
Педагогија	Pedagogy
Категорија:Педагогија	Pedagogy
Педијатрија	Pediatrics
Педофилија	Pedophilia
Храст лужњак	Pedunculate Oak
Пелопонез	Peloponnese
Пелопонески рат	Peloponnesian War
Оловка	Pencil
Пенелопа	Penelope
Пингвин	Penguin
Пеницилин	Penicillin
Полуострво	Peninsula
Пенсилванија	Pennsylvania
Петоугао	Pentagon
Духови (празник)	Pentecost
Категорија:Биографије	People
Кина	People's Republic of China
Пипин Мали	Pepin the Short
Пепси	Pepsi
Опажање	Perception
Удараљке	Percussion instrument
Сиви соко	Peregrine Falcon
Перестројка	Perestroika
Парфем	Perfume
Перикле	Pericles
Периода периодног система елемената	Period (periodic table)
Периодни систем елемената	Periodic table
Перм (Русија)	Perm
Пермафрост	Permafrost
Пернамбуко	Pernambuco
Перпетуум мобиле	Perpetual motion
Персефона	Persephone
Персепољ	Persepolis
Персеј	Perseus
Персијско царство	Persian Empire
Персијски залив	Persian Gulf
Перт	Perth
Перу	Peru
Категорија:Перу	Peru
Пестициди	Pesticide
Абелар	Peter Abelard
Петер Паул Рубенс	Peter Paul Rubens
Питер Селерс	Peter Sellers
Франческо Петрарка	Petrarch
Нафта	Petroleum
Петрологија	Petrology
Фараон	Pharaoh
Категорија:Фармакологија	Pharmacology
Ждрело	Pharynx
Феноменологија	Phenomenology
Фенотип	Phenotype
Фенилаланин	Phenylalanine
Фенилкетонурија	Phenylketonuria
Филаделфија (САД)	Philadelphia
Филателија	Philately
Категорија:Филателија	Philately
Филип II Македонски	Philip II of Macedon
Филип II од Шпаније	Philip II of Spain
Филипинско море	Philippine Sea
Филипини	Philippines
Категорија:Филипини	Philippines
Филологија	Philology
Категорија:Филологија	Philology
Филозофија	Philosophy
Категорија:Филозофија	Philosophy
Пном Пен	Phnom Penh
Фобија	Phobia
Фобос	Phobos (moon)
Феникија	Phoenicia
Финикс	Phoenix
Феникс	Phoenix (mythology)
Феникс (свемирски брод)	Phoenix (spacecraft)
Фонетика	Phonetics
Категорија:Фонетика	Phonetics
Фонологија	Phonology
Фосфорна киселина	Phosphoric acid
Фосфор	Phosphorus
Фотографија	Photography
Категорија:Фотографија	Photography
Фотон	Photon
Фотосинтеза	Photosynthesis
Физичка хемија	Physical chemistry
Категорија:Физичка хемија	Physical chemistry
Физика	Physics
Категорија:Физика	Physics
Портал:Физика	Physics
Физиологија	Physiology
Категорија:Физиологија	Physiology
Пи	Pi
Клавир	Piano
Пикардија	Picardie
Гаим	Pidgin (software)
Пијемонт	Piedmont
Пјер Кири	Pierre Curie
Пјер де Ферма	Pierre de Fermat
Пит Мондријан	Piet Mondrian
Питер Земан	Pieter Zeeman
pigment	Pigment
Плзењ	Pilsen
Pindar	Pindar
Бор (биљка)	Pine
Ananas comosus	Pineapple
Перајари	Pinniped
Гусари	Piracy
Пиза	Pisa
Сазвежђе Рибе	Pisces (constellation)
Питсбург	Pittsburgh
Хипофиза	Pituitary gland
Пиксел	Pixel
Пица	Pizza
Раван	Plane (mathematics)
Планета	Planet
Планктон	Plankton
Биљке	Plant
Плазма (физика)	Plasma (physics)
Плазмид	Plasmid
Пластика	Plastic
Пластид	Plastid
Тектоника плоча	Plate tectonics
Крвне плочице	Platelet
Платина	Platinum
Платон	Plato
Плејбој (часопис)	Playboy
Плевен	Pleven
Плиније Млађи	Pliny the Younger
Плотин	Plotinus
Пловдив	Plovdiv
Шљива	Plum
Плутарх	Plutarch
Плутон (патуљаста планета)	Pluto
Плутон	Pluto (disambiguation)
Плутонијум	Plutonium
Упала плућа	Pneumonia
По (река)	Po River
Поезија	Poetry
Категорија:Поезија	Poetry
Тачка (геометрија)	Point (geometry)
Отров	Poison
Поату-Шарант	Poitou-Charentes
Пољска	Poland
Категорија:Пољска	Poland
Бели медвед	Polar bear
Полиција	Police
Политичка партија	Political party
Политичке науке	Political science
Политика	Politics
Категорија:Политика	Politics
Контаминација	Pollution
Поло (спорт)	Polo
Полонијум	Polonium
Полигамија	Polygamy
Многоугао	Polygon
Полиедар	Polyhedron
Полихимнија	Polyhymnia
Полимер	Polymer
Полинезија	Polynesia
Полином	Polynomial
Политеизам	Polytheism
Нар	Pomegranate
Гнеј Помпеј Велики	Pompey
Поп-арт	Pop art
Папа	Pope
Топола (дрво)	Poplar
Популизам	Populism
Порцелан	Porcelain
Порнографија	Pornography
Порт Луис	Port Louis
Порт Морсби	Port Moresby
Порт Вила	Port Vila
Порт о Пренс	Port-au-Prince
Портланд	Portland
Портрет	Portrait
Португал	Portugal
Категорија:Португал	Portugal
Посејдон	Poseidon
Позитрон	Positron
Поштанска марка	Postage stamp
Поштански код	Postal code
Постмодернизам	Postmodernism
Калијум	Potassium
Шалитра	Potassium nitrate
Кромпир	Potato
Потенцијална енергија	Potential energy
Потсдам	Potsdam
Британска фунта	Pound sterling
Сиромаштво	Poverty
Претор	Praetor
Праг	Prague
Категорија:Праг	Prague
Праја	Praia
Празеодијум	Praseodymium
Молитва	Prayer
Падавине	Precipitation (meteorology)
Трудноћа	Pregnancy
Праисторија	Prehistory
Категорија:Праисторија	Prehistory
Председник	President
Председник Сједињених Америчких Држава	President of the United States
Притисак	Pressure
Преторија	Pretoria
Пријам	Priam
Цена	Price
Примати	Primate
Категорија:Примати	Primates
Премијер	Prime minister
Прост број	Prime number
Острво Принца Едварда	Prince Edward Island
Штампарство	Printing
Приони	Prion
Ратни заробљеници	Prisoner of war
Вероватноћа	Probability
Теорија вероватноће	Probability theory
Категорија:Теорија вероватноће	Probability theory
Професор	Professor
Профит	Profit
Програмски језик	Programming language
Progresivni rok	Progressive rock
Прокариоте	Prokaryote
Прометеј	Prometheus
Прометијум	Promethium
Заменице	Pronoun
Пропаганда	Propaganda
Пропан	Propane
Проза	Prose
Протактинијум	Protactinium
Протеин	Protein
Реформација	Protestant Reformation
Протестантизам	Protestantism
Протисти	Protist
Протон	Proton
Протозоа	Protozoa
Прусија	Prussia
Псалми	Psalms
Категорија:Псеудонаука	Pseudoscience
Псеудонаука	Pseudoscience
Психијатрија	Psychiatry
Категорија:Психијатрија	Psychiatry
Психоанализа	Psychoanalysis
Психологија	Psychology
Категорија:Психологија	Psychology
Психоза	Psychosis
Психотерапија	Psychotherapy
Птах	Ptah
Птеросаури	Pterosaur
Птолемејиди	Ptolemaic dynasty
Клаудије Птоломеј	Ptolemy
Пубертет	Puberty
Јавно власништво	Public domain
Односи с јавношћу	Public relations
Порторико	Puerto Rico
Категорија:Порторико	Puerto Rico
Пула	Pula
Пулсар	Pulsar
Пенџаб (Индија)	Punjab (India)
Категорија:Панк	Punk
Панк	Punk rock
Пјонгјанг	Pyongyang
Пирамиде	Pyramid
Пирамида (геометрија)	Pyramid (geometry)
Пиринеји	Pyrenees
Пирова победа	Pyrrhic victory
Питагора	Pythagoras
Програмски језик Пајтон	Python (programming language)
Q (слово латинице)	Q
Катар	Qatar
Категорија:Катар	Qatar
Династија Ћинг	Qing Dynasty
Квадратна једначина	Quadratic equation
Четвороугао	Quadrilateral
Квестор	Quaestor
Квантна механика	Quantum mechanics
Категорија:Квантна механика	Quantum mechanics
Карантин	Quarantine
Кварк	Quark
Кварц	Quartz
Квазар	Quasar
Квартар	Quaternary
Кватернион	Quaternion
Квебек	Quebec
Квебек (град)	Quebec City
Кечуа језик	Quechua
Краљица (шах)	Queen (chess)
Квинс	Queens
Квинсленд	Queensland
Квентин Тарантино	Quentin Tarantino
Знак питања	Question mark
Дуња	Quince
Кито	Quito
R (слово латинице)	R
РАФ	RAF (disambiguation)
Рибонуклеинска киселина	RNA
Ра	Ra
Рабат	Rabat
Рабин	Rabbi
Рабиндранат Тагор	Rabindranath Tagore
Раса	Race
Рејчел Карсон	Rachel Carson
Расизам	Racism
Категорија:Расизам	Racism
Радар	Radar
Радијан	Radian
Категорија:Радио	Radio
Радио телескоп	Radio telescope
Радиоактивност	Radioactive decay
Радијум	Radium
Полупречник	Radius
Радон	Radon
Киша	Rain
Дуга	Rainbow
Рајнер Марија Рилке	Rainer Maria Rilke
Рамајана	Ramayana
Рамзес II	Ramesses II
RAM	Random access memory
Љутићи	Ranunculaceae
Силовање	Rape
Рафаел	Raphael
Категорија:Метро	Rapid transit
Малина	Raspberry
Пацов	Rat
Рационалан број	Rational number
Равена	Ravenna
ROM	Read-only memory
Реалан број	Real number
Ресифе	Recife
Правоугаоник	Rectangle
Исправљач	Rectifier
Рекурзија	Recursion
Recikliranje	Recycling
Црвена боја	Red
Фракција црвене армије	Red Army Faction
Црвена лисица	Red Fox
Црвена панда	Red Panda
Црвено море	Red Sea
Црвене алге	Red algae
Црвена крвна зрнца	Red blood cell
Crveni div	Red giant
Црвени помак	Redshift
Црвени помак	Redshift (disambiguation)
RISC	Reduced instruction set computer
Референдум	Referendum
Индекс преламања	Refractive index
Избеглица	Refugee
Реге	Reggae
Пук	Regiment
Риџајна	Regina
Ремс	Reims
Реинкарнација	Reincarnation
Ирвас	Reindeer
Релација (математика)	Relation (mathematics)
Категорија:Релативност	Relativity
Религија	Religion
Категорија:Религија	Religion
Рембрант	Rembrandt
Ренесанса	Renaissance
Категорија:Ренесанса	Renaissance
Репродукција	Reproduction
Гмизавци	Reptile
Република	Republic
Република Кина	Republic of China
Република Ирска	Republic of Ireland
Категорија:Република Ирска	Republic of Ireland
Република Конго	Republic of the Congo
Категорија:Република Конго	Republic of the Congo
Републиканска странка (САД)	Republican Party (United States)
Отпорник	Resistor
Систем органа за дисање	Respiratory system
Ресторан	Restaurant
Ретинол	Retinol
Револуција	Revolution
Револвер	Revolver
Реа	Rhea (mythology)
Ренијум	Rhenium
Категорија:Реторика	Rhetoric
Рајна	Rhine
Носорози	Rhinoceros
Род Ајленд	Rhode Island
Родос	Rhodes
Родијум	Rhodium
Ромб	Rhombus
Ritam i bluz	Rhythm and blues
Витамин Б2	Riboflavin
Рибозом	Ribosome
Пиринач	Rice
Ричард Филип Фајнман	Richard Feynman
Ричард Никсон	Richard Nixon
Рихард Штраус	Richard Strauss
Рихард Вагнер	Richard Wagner
Ричард Рајт	Richard Wright (musician)
Рига	Riga
Ригел VII	Rigel
Прстен (математика)	Ring (mathematics)
Ринго Стар	Ringo Starr
Рио де Жанеиро	Rio de Janeiro
Рио де Жанеиро (држава)	Rio de Janeiro (state)
Река	River
Темза	River Thames
Ријад	Riyadh
Пут	Road
Роалд Амундсен	Roald Amundsen
Роберт Миликен	Robert Andrews Millikan
Роберт Бојл	Robert Boyle
Роберт Де Ниро	Robert De Niro
Роберт Фалкон Скот	Robert Falcon Scott
Роберт Хук	Robert Hooke
Роберт Кох	Robert Koch
Роберт Луис Стивенсон	Robert Louis Stevenson
Роберт Опенхајмер	Robert Oppenheimer
Robert Redford	Robert Redford
Роберт Шуман (композитор)	Robert Schumann
Робот	Robot
Стене	Rock (geology)
Рокенрол	Rock and roll
Категорија:Рок	Rock music
Стеновите планине	Rocky Mountains
Рококо	Rococo
Глодари	Rodent
Срна	Roe Deer
Рентгенијум	Roentgenium
Роџер Бејкон	Roger Bacon
Римокатоличка црква	Roman Catholic Church
Римско царство	Roman Empire
Римска Република	Roman Republic
Римски календар	Roman calendar
Римско право	Roman law
Римска легија	Roman legion
Римска митологија	Roman mythology
Категорија:Римска митологија	Roman mythology
Румунија	Romania
Категорија:Румунија	Romania
Романш	Romansh
Романтизам	Romanticism
Рим	Rome
Категорија:Рим	Rome
Роналд Реган	Ronald Reagan
Топ (шах)	Rook (chess)
Рузвелт	Roosevelt
Корен	Root
Роза Паркс	Rosa Parks
Rosaceae	Rosaceae
Rosales	Rosales
Росарио	Rosario
Ружа	Rose
Камен из Розете	Rosetta Stone
Рош Хашана	Rosh Hashanah
Росово море	Ross Sea
Росток	Rostock
Ротердам	Rotterdam
Рутер	Router
Веслање	Rowing (sport)
Краљевско друштво	Royal Society
Рубикон	Rubicon
Рубидијум	Rubidium
Рубља	Ruble
Малина	Rubus idaeus
Рубин	Ruby
Програмски језик Руби	Ruby (programming language)
Рудолф Хес	Rudolf Hess
Рудолф Штајнер	Rudolf Steiner
Радјард Киплинг	Rudyard Kipling
Рагби	Rugby football
Руперт Мердок	Rupert Murdoch
Русија	Russia
Категорија:Русија	Russia
Руска православна црква	Russian Orthodox Church
Рутенијум	Ruthenium
Радерфордијум	Rutherfordium
Руанда	Rwanda
Категорија:Руанда	Rwanda
S (слово латинице)	S
Свете тајне	Sacrament
Сакраменто	Sacramento
Садам Хусеин	Saddam Hussein
Safari (brauzer)	Safari (web browser)
Шафран	Saffron
Сахара	Sahara
Светац	Saint
Андреј Првозвани	Saint Andrew
Свети великомученик Георгије	Saint George
Свети Китс и Невис	Saint Kitts and Nevis
Категорија:Свети Китс и Невис	Saint Kitts and Nevis
Света Луција (острво)	Saint Lucia
Категорија:Света Луција	Saint Lucia
Острво Свети Мартин	Saint Martin
Свети Никола	Saint Nicholas
Свети апостол Петар	Saint Peter
Санкт Петербург	Saint Petersburg
Свети Винсент и Гренадини	Saint Vincent and the Grenadines
Категорија:Свети Винсент и Гренадини	Saint Vincent and the Grenadines
Sake	Sake
Саладин	Saladin
Намаз (молитва)	Salah
Салерно	Salerno
Пљувачка	Saliva
Salman Rušdi	Salman Rushdie
Пастрмке	Salmonidae
Солт Лејк Сити	Salt Lake City
Салвадор (Бразил)	Salvador
Салцбург	Salzburg
Салцбург (покрајина)	Salzburg (state)
Самара	Samara
Самаријум	Samarium
Самарканд	Samarkand
Самоа	Samoa
Категорија:Самоа	Samoa
Самсара	Samsara
Семјуел Бекет	Samuel Beckett
Семјуел Морзе	Samuel F. B. Morse
Самурај	Samurai
Сан Антонио	San Antonio
Сан Дијего	San Diego
Сан Франциско	San Francisco
Сан Хозе	San Jose
Сан Марино	San Marino
Категорија:Сан Марино	San Marino
Сан Марино (град)	San Marino
Сан Салвадор	San Salvador
Песак	Sand
Сандро Ботичели	Sandro Botticelli
Пешчар	Sandstone
Санскрит	Sanskrit
Санта Фе	Santa Fe
Сантијаго де Чиле	Santiago
Сантјаго де Куба	Santiago de Cuba
Санто Доминго	Santo Domingo
Сапфа	Sappho
Сапоро	Sapporo
Сара Бернар	Sarah Bernhardt
Сарајево	Sarajevo
Саратов	Saratov
Sarkofag	Sarcophagus
Сардинија	Sardinia
Саскачеван	Saskatchewan
Шејтан	Satan
Сатанизам	Satanism
Вештачки сателит	Satellite
Субота	Saturday
Сатурн (планета)	Saturn
Категорија:Сатурн	Saturn
Сатурн	Saturn (disambiguation)
Сатурн (митологија)	Saturn (mythology)
Сатири	Satyr
Зачин	Sauce
Саудијска Арабија	Saudi Arabia
Категорија:Саудијска Арабија	Saudi Arabia
Сол Белоу	Saul Bellow
Савана	Savanna
Саксонија	Saxony
Категорија:Саксонија	Saxony
Саксофон	Saxophone
Скандинавија	Scandinavia
Скандијум	Scandium
Лопатица	Scapula
Схизофренија	Schizophrenia
Схоластика	Scholasticism
Школа	School
Шуцштафел	Schutzstaffel
Наука	Science
Категорија:Наука	Science
Научна фантастика	Science fiction
Категорија:Научна фантастика	Science fiction
Научни метод	Scientific method
Публије Корнелије Сципион Африканац Старији	Scipio Africanus
Sciuridae	Sciuridae
Скорпије	Scorpion
Шкотска	Scotland
Категорија:Шкотска	Scotland
Шкотски гелски језик	Scottish Gaelic
Вијак	Screw
Одвијач	Screwdriver
Скротум	Scrotum
Вајарство	Sculpture
Категорија:Вајарство	Sculpture
Море	Sea
Морска видра	Sea Otter
Морска саса	Sea anemone
Азовско море	Sea of Azov
Јапанско море	Sea of Japan
Мраморно море	Sea of Marmara
Охотско море	Sea of Okhotsk
Морски јежеви	Sea urchin
Сиборгијум	Seaborgium
Морски коњић	Seahorse
Интернет претраживач	Search engine
Сијетл	Seattle
Секунд	Second
Други крсташки рат	Second Crusade
Други принцип термодинамике	Second law of thermodynamics
Секта	Sect
Категорија:Безбедност	Security
Седиментне стене	Sedimentary rock
Семе	Seed
Сеговија	Segovia
Сена	Seine
Сеизмологија	Seismology
Категорија:Сеизмологија	Seismology
Селен	Selenium
Селеук I	Seleucus I Nicator
Семантика	Semantics
Категорија:Семантика	Semantics
Полупроводник	Semiconductor
Семиологија	Semiotics
Семити	Semitic
Сенатор	Senate
Сенегал	Senegal
Категорија:Сенегал	Senegal
Сеул	Seoul
Сепуку	Seppuku
Септембар	September
11. септембар	September 11
Напади 11. септембра 2001.	September 11
17. септембар	September 17
29. септембар	September 29
Септуагинта	Septuagint
Србија	Serbia
Категорија:Србија	Serbia
Србија и Црна Гора	Serbia and Montenegro
Категорија:Србија и Црна Гора	Serbia and Montenegro
Сергеј Ејзенштајн	Sergei Eisenstein
Сергеј Рахмањинов	Sergei Rachmaninoff
Ред (математика)	Series (mathematics)
Серотонин	Serotonin
Server	Server (computing)
Скуп	Set
Сет (митологија)	Set (mythology)
Теорија скупова	Set theory
Категорија:Теорија скупова	Set theory
Седмогодишњи рат	Seven Years' War
Севиља	Seville
Сексизам	Sexism
Секс	Sexual intercourse
Категорија:Сексуалност	Sexuality
Полне болести	Sexually transmitted disease
Сејшели	Seychelles
Категорија:Сејшели	Seychelles
Šamanizam	Shamanism
Шангај	Shanghai
Акција	Share (finance)
Шеријат	Sharia
Ајкула	Shark
Шефилд	Sheffield
Šerlok Holms	Sherlock Holmes
Штит	Shield
Шикоку	Shikoku
Шинтоизам	Shinto
Брод	Ship
Шива	Shiva
Шогун	Shogun
Стенограф	Shorthand
Сибир	Siberia
Сибирски хаски	Siberian Husky
Сечуан	Sichuan
Сицилија	Sicily
Категорија:Сицилија	Sicily
Сименс (јединица)	Siemens (unit)
Сијера Леоне	Sierra Leone
Категорија:Сијера Леоне	Sierra Leone
Зигмунд Фројд	Sigmund Freud
Сигрид Унсет	Sigrid Undset
Сикизам	Sikhism
Сиким	Sikkim
Шлеска	Silesia
Силицијум	Silicon
Силицијум диоксид	Silicon dioxide
Пут свиле	Silk Road
Сребро	Silver
Симон де Бовоар	Simone de Beauvoir
Грех	Sin
Синклер Луис	Sinclair Lewis
Сингапур	Singapore
Категорија:Сингапур	Singapore
Сингл (музика)	Single (music)
Сиријус	Sirius
Сизиф	Sisyphus
Бик Који Седи	Sitting Bull
Шестодневни рат	Six-Day War
Скагерак	Skagerrak
Скептицизам	Skepticism
Skinhedsi	Skinhead
Скопље	Skopje
Лобања	Skull
Облакодер	Skyscraper
Робовласништво	Slavery
Словачка	Slovakia
Категорија:Словачка	Slovakia
Словенија	Slovenia
Категорија:Словенија	Slovenia
Танко црево	Small intestine
Смоленск	Smolensk
Змије	Snake
Снукер	Snooker
Снијег	Snow
Социјална психологија	Social psychology
Социјализам	Socialism
Категорија:Социјализам	Socialism
Категорија:Људска друштва	Society
Друштво	Society
Исусовци	Society of Jesus
Социолингвистика	Sociolinguistics
Социологија	Sociology
Категорија:Социологија	Sociology
Сократ	Socrates
Натријум	Sodium
Кухињска со	Sodium chloride
Софија	Sofia
Софтбол	Softball
Едафски фактори	Soil
Сунчев систем	Solar System
Категорија:Сунчев систем	Solar System
Соларна енергија	Solar energy
Сунчев ветар	Solar wind
Соломон	Solomon
Соломонова Острва	Solomon Islands
Категорија:Соломонова Острва	Solomon Islands
Солон	Solon
Раствор	Solution
Растварач	Solvent
Сомалија	Somalia
Категорија:Сомалија	Somalia
Сома (департман)	Somme
Соната	Sonata
Песма над песмама	Song of Solomon
Сонет	Sonnet
Софија Лорен	Sophia Loren
Софокле	Sophocles
Сирак	Sorghum
Душа	Soul
Звук	Sound
Супа	Soup
Југ	South
Категорија:Јужноафричка Република	South Africa
Јужна Америка	South America
Категорија:Јужна Америка	South America
Јужна Аустралија	South Australia
Јужна Каролина	South Carolina
Јужно кинеско море	South China Sea
Јужна Дакота	South Dakota
Јужно острво	South Island
Јужна Кореја	South Korea
Категорија:Јужна Кореја	South Korea
Јужни пол	South Pole
Јужни Вијетнам	South Vietnam
Југоисточна Азија	Southeast Asia
Јужна хемисфера	Southern Hemisphere
Suverenost	Sovereignty
Савез Совјетских Социјалистичких Република	Soviet Union
Категорија:Совјетски Савез	Soviet Union
Соја	Soybean
Свемирске летелице	Spacecraft
Шпанија	Spain
Категорија:Шпанија	Spain
Шпански грађански рат	Spanish Civil War
Категорија:Шпанци	Spanish people
Спарта	Sparta
Specijalna teorija relativnosti	Special relativity
Врста (биологија)	Species
Спектроскопија	Spectroscopy
Брзина светлости	Speed of light
Спенсер Трејси	Spencer Tracy
Сфера	Sphere
Сфинга	Sphinx
Пауци	Spider
Спин	Spin (physics)
Кичмена мождина	Spinal cord
Спирална галаксија	Spiral galaxy
Слезина	Spleen
Сплит	Split
Сунђери	Sponge
Спорт	Sport
Шпреја	Spree
Пролеће	Spring (season)
Спајвер	Spyware
Squamata	Squamata
Квадрат	Square (geometry)
Квадратни метар	Square metre
Квадратни корен	Square root
Skvoš	Squash (sport)
Веверица	Squirrel
Сри Ланка	Sri Lanka
Категорија:Сри Ланка	Sri Lanka
Сент Луис	St. Louis
Стадион	Stadium
Витраж	Stained glass
Нерђајући челици	Stainless steel
Стандардна девијација	Standard deviation
Стенли Кјубрик	Stanley Kubrick
Звезда	Star
Давидова звезда	Star of David
Морске звезде	Starfish
Држава	State
Статистичка механика	Statistical mechanics
Статистика	Statistics
Категорија:Статистика	Statistics
Кип слободе	Statue of Liberty
Парна машина	Steam engine
Челик	Steel
Штефи Граф	Steffi Graf
Стегосаур	Stegosaurus
Изворна ћелија	Stem cell
Стендал	Stendhal
Стивен Хокинг	Stephen Hawking
Степа	Steppe
Стерадијан	Steradian
Стернум	Sternum
Стероиди	Steroid
Стивен Спилберг	Steven Spielberg
Стокхолм	Stockholm
Камено доба	Stone Age
Стоунхенџ	Stonehenge
Рода	Stork
Олуја	Storm
Гибралтарски мореуз	Strait of Gibraltar
Магеланов мореуз	Strait of Magellan
Месински мореуз	Strait of Messina
Категорија:Мореузи	Straits
Стразбур	Strasbourg
Стратегија	Strategy
Стратиграфија	Stratigraphy
Стратосфера	Stratosphere
Стрес	Stress (medicine)
Јака сила	Strong interaction
Стронцијум	Strontium
Шаблон:Клица	Stub
Студент	Student
Ступа	Stupa
Штурмабтајлунг	Sturmabteilung
Штутгарт	Stuttgart
Подсахарска Африка	Sub-Saharan Africa
Potkultura	Subculture
Сублимација (физика)	Sublimation (chemistry)
Подморница	Submarine
Подскуп	Subset
SVN	Subversion (software)
Сукре	Sucre
Сахароза	Sucrose
Судан	Sudan
Категорија:Судан	Sudan
Судоку	Sudoku
Суецки канал	Suez Canal
Суфизам	Sufism
Сухарто	Suharto
Сулавеси	Sulawesi
Сумпор	Sulfur
Сумпор диоксид	Sulfur dioxide
Сумпорна киселина	Sulfuric acid
Султан	Sultan
Суматра	Sumatra
Сумер	Sumer
Лето	Summer
Сунце	Sun
Категорија:Сунце	Sun
Недеља	Sunday
Сунчани сат	Sundial
Сунцокрет	Sunflower
Сунити	Sunni Islam
Сунчеве пеге	Sunspot
Суперпроводност	Superconductivity
Супермен	Superman
Supernova	Supernova
Хирургија	Surgeon
Хирургија	Surgery
Категорија:Хирургија	Surgery
Суринам	Suriname
Категорија:Суринам	Suriname
Надреализам	Surrealism
Сува	Suva
Свалбард	Svalbard
Кукасти крст	Swastika
Свазиленд	Swaziland
Категорија:Свазиленд	Swaziland
Шведска	Sweden
Категорија:Шведска	Sweden
Шведска круна	Swedish krona
Пливање	Swimming
Категорија:Пливање	Swimming
Швајцарски франак	Swiss franc
Категорија:Швајцарци	Swiss people
Швајцарска	Switzerland
Категорија:Швајцарска	Switzerland
Мач	Sword
Сиднеј	Sydney
Симбиоза	Symbiosis
Симбол	Symbol
Simfonija	Symphony
Симптом	Symptom
Синагога	Synagogue
Синдикат	Syndicate
Синоним	Synonym
Синтакса	Syntax
Синтисајзер	Synthesizer
Сифилис	Syphilis
Сирија	Syria
Категорија:Сирија	Syria
Систем	System
Систематика	Systematics
T (слово латинице)	T
Томас Стернс Елиот	T. S. Eliot
Стони тенис	Table tennis
Табу	Taboo
Тацит	Tacitus
Теквондо	Taekwondo
Тахити	Tahiti
Тајпеј	Taipei
Категорија:Тајван	Taiwan
Таџ Махал	Taj Mahal
Таџикистан	Tajikistan
Категорија:Таџикистан	Tajikistan
Талк	Talc
Талибани	Taliban
Талин	Tallinn
Талмуд	Talmud
Тамил Наду	Tamil Nadu
Тампа	Tampa
Тампере	Tampere
Танго	Tango (dance)
Тенк	Tank
Тантал	Tantalum
Тантал (митологија)	Tantalus
Танзанија	Tanzania
Категорија:Танзанија	Tanzania
Таоизам	Taoism
Tardigrada	Tardigrade
Тарн	Tarn
Тарту	Tartu
Ташкент	Tashkent
Тасманово море	Tasman Sea
Тасманија	Tasmania
Таксономија	Taxonomy
Европска тиса	Taxus baccata
Тбилиси	Tbilisi
Чај	Tea
Категорија:Чајеви	Tea
Техницијум	Technetium
Tehno	Techno
Технологија	Technology
Категорија:Технологија	Technology
Тегусигалпа	Tegucigalpa
Техеран	Tehran
Тел Авив	Tel Aviv
Телекомуникације	Telecommunication
Телеграф	Telegraphy
Телепатија	Telepathy
Телефон	Telephone
Телескоп	Telescope
Телевизија	Television
Категорија:Телевизија	Television
Телур	Tellurium
Температура	Temperature
Храм	Temple
Артемидин храм	Temple of Artemis
Десет Божјих заповести	Ten Commandments
Тенерифе	Tenerife
Тенеси	Tennessee
Тенеси Вилијамс	Tennessee Williams
Тенис	Tennis
Категорија:Тенис	Tennis
Тензинг Норгај	Tenzing Norgay
Тербијум	Terbium
Термит	Termite
Терпсихора	Terpsichore
Терестричка планета	Terrestrial planet
Тероризам	Terrorism
Категорија:Тероризам	Terrorism
Тертулијан	Tertullian
Тесла (јединица)	Tesla (unit)
Тестис	Testicle
Тестостерон	Testosterone
Тетанус	Tetanus
Тетија	Tethys (mythology)
Тетраедар	Tetrahedron
Tetrahidrokanabinol	Tetrahydrocannabinol
Тексас	Texas
Tekstil	Textile
Тајланд	Thailand
Категорија:Тајланд	Thailand
Талес из Милета	Thales
Талија	Thalia
Талијум	Thallium
Нагон смрти	Thanatos
Гамбија	The Gambia
Категорија:Гамбија	The Gambia
Хаг	The Hague
The Star-Spangled Banner	The Star-Spangled Banner
Сценска уметност	Theatre
Теба (сателит)	Thebe (moon)
Теба (град у Грчкој)	Thebes
Теба (град у Египту)	Thebes
Теја (митологија)	Theia
Темида	Themis
Темистокле	Themistocles
Теократија	Theocracy
Теодор Момсен	Theodor Mommsen
Теодор Рузвелт	Theodore Roosevelt
Теодосије I	Theodosius I
Теологија	Theology
Категорија:Теологија	Theology
Теорема	Theorem
Теорија	Theory
Теорија релативитета	Theory of relativity
Teravada	Theravada
Термодинамика	Thermodynamics
Категорија:Термодинамика	Thermodynamics
Тезеј	Theseus
Солун	Thessaloniki
Периферија Тесалија	Thessaly
Тетида	Thetis
Витамин Б1	Thiamine
Трећи крсташки рат	Third Crusade
Трећи свет	Third World
Тридесетогодишњи рат	Thirty Years' War
Тома Аквински	Thomas Aquinas
Томас Алва Едисон	Thomas Edison
Томас Харди	Thomas Hardy
Томас Хобс	Thomas Hobbes
Томас Џеферсон	Thomas Jefferson
Томас Роберт Малтус	Thomas Malthus
Томас Ман	Thomas Mann
Tomas Mor	Thomas More
Томас Пејн	Thomas Paine
Томас Јанг	Thomas Young (scientist)
Тор (митологија)	Thor
Торијум	Thorium
Мишљење	Thought
Тракија	Thrace
Тукидид	Thucydides
Тулијум	Thulium
Тирингија	Thuringia
Категорија:Тирингија	Thuringia
Четвртак	Thursday
Мајчина душица	Thyme
Тимин	Thymine
Штитаста жлезда	Thyroid
Тијенђин	Tianjin
Тибар	Tiber
Тиберије	Tiberius
Тибет	Tibet
Огњена Земља	Tierra del Fuego
Тигар	Tiger
Тигар (река)	Tigris
Липа (дрво)	Tilia
Тимбукту	Timbuktu
Време	Time
Категорија:Време	Time
Тајм (магазин)	Time (magazine)
Временска зона	Time zone
Тимор	Timor
Тамерлан	Timur
Калај	Tin
Тирана	Tirana
Ткиво	Tissue (biology)
Титан (месец)	Titan (moon)
Титанијум	Titanium
Тицијан Вечели	Titian
Тит	Titus
Токантинс	Tocantins (state)
Того	Togo
Категорија:Того	Togo
Токио	Tokyo
Толедо	Toledo
Том Хенкс	Tom Hanks
Том и Џери	Tom and Jerry
Парадајз	Tomato
Тона	Ton
Тонга	Tonga
Тони Морисон	Toni Morrison
Тона	Tonne
Тони Блер	Tony Blair
Alat	Tool
Зуби	Tooth
Топологија	Topology
Категорија:Топологија	Topology
Тора	Torah
Торнадо	Tornado
Торонто	Toronto
Торпедо	Torpedo
Момент силе	Torque
Корњача	Tortoise
Торус	Torus
Тоталитаризам	Totalitarianism
Тулон	Toulon
Тулуз	Toulouse
Тур де Франс	Tour de France
Туризам	Tourism
Категорија:Туризам	Tourism
Куле	Tower
Вавилонска кула	Tower of Babel
Лондон тауер	Tower of London
Град	Town
Отров	Toxicity
Токсикологија	Toxicology
Тојота	Toyota
Трактор	Tractor
Синдикат	Trade union
Традиција	Tradition
Воз	Train
Трајан	Trajan
Трансформатор	Transformer
Транзистор	Transistor
Категорија:Саобраћај	Transportation
Транссексуализам	Transsexualism
Трансилванија	Transylvania
Трапез (геометрија)	Trapezoid
Међународни уговор	Treaty
Версајски споразум	Treaty of Versailles
Дрво	Tree
Тренто	Trento
Троугао	Triangle
Тријас	Triassic
Трицератопс	Triceratops
Трир	Trier
Тригонометријске функције	Trigonometric function
Тригонометрија	Trigonometry
Категорија:Тригонометрија	Trigonometry
Трилобити	Trilobite
Трилогија	Trilogy
Тринидад и Тобаго	Trinidad and Tobago
Категорија:Тринидад и Тобаго	Trinidad and Tobago
ТНТ	Trinitrotoluene
Света Тројица	Trinity
Триполи	Tripoli
Трицијум	Tritium
Тритон (митологија)	Triton (mythology)
Тројански коњ (митологија)	Trojan Horse
Тројански рат	Trojan War
Тројански коњ (информатика)	Trojan horse (computing)
Трол	Troll
Интернет трол	Troll (Internet)
Тролејбус	Trolleybus
Тромбон	Trombone
Трондхајм	Trondheim
Тропосфера	Troposphere
Троја (град)	Troy
Труба	Trumpet
Истина	Truth
Тригве Ли	Trygve Lie
Цар	Tsar
Цунами	Tsunami
Туарези	Tuareg
Туба	Tuba
Туберкулоза	Tuberculosis
Тусон	Tucson
Уторак	Tuesday
Лала	Tulip
Волфрам	Tungsten
Плашташи	Tunicate
Тунис (град)	Tunis
Тунис	Tunisia
Категорија:Тунис	Tunisia
Тунел	Tunnel
Торино	Turin
Тјурингова машина	Turing machine
Турска	Turkey
Категорија:Турска	Turkey
Туркменистан	Turkmenistan
Категорија:Туркменистан	Turkmenistan
Корњача	Turtle
Тоскана	Tuscany
Тувалу	Tuvalu
Tuks	Tux
Тихо Брахе	Tycho Brahe
Тифон	Typhon
Tipografija	Typography
Категорија:Типографија	Typography
Тираносаурус	Tyrannosaurus
Тир	Tyre
Тирол (покрајина)	Tyrol (state)
Тиренско море	Tyrrhenian Sea
U (слово латинице)	U
Унеско	UNESCO
Уфа	Ufa
Уганда	Uganda
Категорија:Уганда	Uganda
Украјина	Ukraine
Категорија:Украјина	Ukraine
Улан Батор	Ulan Bator
Алстер	Ulster
Ултраљубичасто зрачење	Ultraviolet
Јулисиз Симпсон Грант	Ulysses S. Grant
Умбрија	Umbria
Незапосленост	Unemployment
Једнорог	Unicorn
НЛО	Unidentified flying object
Уједињени Арапски Емирати	United Arab Emirates
Категорија:Уједињени Арапски Емирати	United Arab Emirates
Уједињено Краљевство	United Kingdom
Категорија:Уједињено Краљевство	United Kingdom
Уједињене нације	United Nations
Категорија:Уједињене нације	United Nations
Уницеф	United Nations Children's Fund
Сједињене Америчке Државе	United States
Категорија:Сједињене Америчке Државе	United States
Конгрес Сједињених Америчких Држава	United States Congress
Устав Сједињених Америчких Држава	United States Constitution
Сенат Сједињених Америчких Држава	United States Senate
Америчка Девичанска острва	United States Virgin Islands
Амерички долар	United States dollar
Свемир	Universe
Универзитет у Пенсилванији	University of Pennsylvania
Уникс	Unix
Категорија:Уникс	Unix
Унунбијум	Ununbium
Унунхексијум	Ununhexium
Унунпентијум	Ununpentium
Унунквадијум	Ununquadium
Унунтријум	Ununtrium
Упсала	Uppsala
Ур	Ur
Урацил	Uracil
Урал (планина)	Ural Mountains
Уранија	Urania
Уранијум	Uranium
Уран (планета)	Uranus
Уран (митологија)	Uranus (mythology)
Урду	Urdu
Уругвај	Uruguay
Категорија:Уругвај	Uruguay
Јута (држава)	Utah
Материца	Uterus
Утилитаризам	Utilitarianism
Утопија	Utopia
Утрехт	Utrecht (city)
Утар Прадеш	Uttar Pradesh
Узбекистан	Uzbekistan
Категорија:Узбекистан	Uzbekistan
Вакуола	Vacuole
Вакуум	Vacuum
Електронска цев	Vacuum tube
Вадуц	Vaduz
Вагина	Vagina
Валенсија	Valencia
Валентина Терешкова	Valentina Tereshkova
Валкире	Valkyrie
Валета	Valletta
Вампир	Vampire
Ванадијум	Vanadium
Ванкувер	Vancouver
Вандализам	Vandalism
Вануату	Vanuatu
Вар (департман)	Var (department)
Варна	Varna
Ватикан	Vatican City
Категорија:Ватикан	Vatican City
Вектор	Vector (spatial)
Поврће	Vegetable
Vegetarijanstvo	Vegetarianism
Венето	Veneto
Венецуела	Venezuela
Категорија:Венецуела	Venezuela
Венеција	Venice
Венера (планета)	Venus
Венера	Venus (disambiguation)
Венера (митологија)	Venus (mythology)
Глаголи	Verb
Вермонт	Vermont
Верона	Verona
Версај	Versailles
Кичмењаци	Vertebrate
Веспазијан	Vespasian
Вето	Veto
Виктор Иго	Victor Hugo
Викторија (Сејшели)	Victoria
Викторија (град)	Victoria
Викторија	Victoria
Викторија (Аустралија)	Victoria (Australia)
Викторијини водопади	Victoria Falls
Видео	Video
Рачунарска игра	Video game
Беч	Vienna
Категорија:Беч	Vienna
Вијен (департман)	Vienne
Вијентијан	Vientiane
Вијетнам	Vietnam
Категорија:Вијетнам	Vietnam
Вијетнамски рат	Vietnam War
Категорија:Вијетнамски рат	Vietnam War
Викинзи	Viking
Вилфредо Парето	Vilfredo Pareto
Село	Village
Виљњус	Vilnius
Винсент ван Гог	Vincent van Gogh
Винћенцо Белини	Vincenzo Bellini
Виола	Viola
Насиље	Violence
Виолина	Violin
Вергилије	Virgil
Девичанска острва	Virgin Islands
Вирџинија	Virginia
Вирџинија Вулф	Virginia Woolf
Виртуелна стварност	Virtual reality
Врлина	Virtue
Вирус	Virus
Вишну	Vishnu
Висла	Vistula
Vitamini	Vitamin
Ретинол	Vitamin A
Витамин Б6	Vitamin B6
Витамин Ц	Vitamin C
Нафтокинон	Vitamin K
Витус Беринг	Vitus Bering
Вивијен Ли	Vivien Leigh
Владимир Иљич Уљанов Лењин	Vladimir Lenin
Владимир Набоков	Vladimir Nabokov
Владимир Путин	Vladimir Putin
Владивосток	Vladivostok
Вокатив	Vocative case
Вотка	Vodka
Вулкан	Volcano
Категорија:Вулканологија	Volcanology
Волга (река)	Volga River
Волгоград	Volgograd
Одбојка	Volleyball
Категорија:Одбојка	Volleyball
Волт	Volt
Електрични напон	Voltage
Volter	Voltaire
Повраћање	Vomiting
Вуду	Voodoo
Вулкан (митологија)	Vulcan (mythology)
Вулгарни латински	Vulgar Latin
Вулгата	Vulgate
Vulva	Vulva
Вехабизам	Wahhabism
Вејк	Wake Island
Велс	Wales
Категорија:Велс	Wales
Orah	Walnut
Морж	Walrus
Волт Дизни	Walt Disney
Волт Витмен	Walt Whitman
Валтер Гропијус	Walter Gropius
Волтер Скот	Walter Scott
Рат	War
Категорија:Ратови	War
Ратни злочини	War crime
Рат за шпанско наслеђе	War of the Spanish Succession
Ратови ружа	Wars of the Roses
Варшава	Warsaw
Вашингтон (град)	Washington
Вашингтон (држава)	Washington
Вашингтон	Washington (disambiguation)
Василиј Васиљевич Кандински	Wassily Kandinsky
Отпад	Waste
Вода	Water
Категорија:Вода	Water
Ватерполо	Water polo
Водопад	Waterfall
Лубеница	Watermelon
Ват	Watt
Талас (физика)	Wave
Таласна дужина	Wavelength
Восак	Wax
Оружје	Weapon
Браузер	Web browser
Вебер (јединица)	Weber (unit)
Среда	Wednesday
Седмица	Week
Тежина	Weight
Дизање тегова	Weightlifting
Вајмар	Weimar
Вајмарска Република	Weimar Republic
Заваривање	Welding
Велингтон	Wellington
Вукодлак	Werewolf
Вернер фон Браун	Wernher von Braun
Запад	West
Западна Африка	West Africa
Западна обала	West Bank
Западни Бенгал	West Bengal
Западни Берлин	West Berlin
Западна Немачка	West Germany
Западна Вирџинија	West Virginia
Западна Аустралија	Western Australia
Западно римско царство	Western Roman Empire
Западна Сахара	Western Sahara
Категорија:Западна Сахара	Western Sahara
Пшеница	Wheat
Точак	Wheel
Виски	Whisky
Бела кућа	White House
Бело море	White Sea
Бела крвна зрнца	White blood cell
Beli patuljak	White dwarf
Вајтхорс	Whitehorse
Vika	Wicca
Висбаден	Wiesbaden
Дивља мачка	Wildcat
Тестамент	Will (law)
Вилијам Блејк	William Blake
Вилијам Батлер Јејтс	William Butler Yeats
Вилијам Фокнер	William Faulkner
Вилхелм Хершел	William Herschel
Вилијам Хауард Тафт	William Howard Taft
Вилхелм II Немачки	William II
Вилијам Макинли	William McKinley
Вилијам Роуан Хамилтон	William Rowan Hamilton
Вилијам Шекспир	William Shakespeare
Вилијам Окамски	William of Ockham
Врба	Willow
Вили Брант	Willy Brandt
Виндхук	Windhoek
Вјетрењача	Windmill
Прозор	Window
Вино	Wine
Винипег (град)	Winnipeg
Винстон Черчил	Winston Churchill
Зима	Winter
Зимске олимпијске игре	Winter Olympic Games
Категорија:Зимске олимпијске игре	Winter Olympic Games
Висконсин	Wisconsin
Волфганг Амадеус Моцарт	Wolfgang Amadeus Mozart
Волфганг Паули	Wolfgang Pauli
Жена	Woman
Вудро Вилсон	Woodrow Wilson
Дрвени дувачки инструменти	Woodwind instrument
Вуди Ален	Woody Allen
Реч	Word
Текст процесор	Word processor
Светска банка	World Bank
Светска здравствена организација	World Health Organization
Светски трговински центар	World Trade Center
Светска трговинска организација	World Trade Organization
Први светски рат	World War I
Категорија:Први светски рат	World War I
Други светски рат	World War II
Категорија:Други светски рат	World War II
WWW	World Wide Web
Црвоточина	Wormhole
Писац	Writer
Вухан	Wuhan
Вајоминг	Wyoming
Рентгенски зраци	X-ray
Ксенон	Xenon
Ксенофан	Xenophanes
Ксенофобија	Xenophobia
Ксенофонт	Xenophon
Ксилофон	Xylophone
Јакузе	Yakuza
Рангун	Yangon
Јангцекјанг	Yangtze River
Јард	Yard
Јасер Арафат	Yasser Arafat
Година	Year
Жута боја	Yellow
Хоангхо	Yellow River
Жуто море	Yellow Sea
Јелоустоун	Yellowstone National Park
Јемен	Yemen
Категорија:Јемен	Yemen
Јенисеј	Yenisei River
Јереван	Yerevan
Јети	Yeti
Joga	Yoga
Јогурт	Yoghurt
Јокохама	Yokohama
Јом кипур	Yom Kippur
Јом Кипурски рат	Yom Kippur War
Јорк	York
Итербијум	Ytterbium
Итријум	Yttrium
Југославија	Yugoslavia
Категорија:Југославија	Yugoslavia
Јукон	Yukon
Јуриј Гагарин	Yuri Gagarin
Закари Тејлор	Zachary Taylor
Загреб	Zagreb
Замбези	Zambezi
Замбија	Zambia
Категорија:Замбија	Zambia
Сарагоса	Zaragoza
Зебра	Zebra
Зен	Zen
Зенит	Zenith
Зенон (цар)	Zeno (emperor)
Zenon iz Kitijuma	Zeno of Citium
Зенон из Елеје	Zeno of Elea
Зевс	Zeus
Зевс	Zeus (disambiguation)
Зигурат	Ziggurat
Зимбабве	Zimbabwe
Категорија:Зимбабве	Zimbabwe
Цинк	Zinc
Ционизам	Zionism
Цирконијум	Zirconium
Зодијак	Zodiac
Зомби	Zombie
Zoološki vrt	Zoo
Зоологија	Zoology
Категорија:Зоологија	Zoology
Заратуштра	Zoroaster
Зороастризам	Zoroastrianism
Зулу	Zulu
