Breton	English
Abc'hazeg ; abkhazeg	Abkhaz ; Abkhazian ; Abkhazian
Abkhazia	Abkhazia
Mor Adria ; Mor Adriatek	Adriatic Sea
afareg ; afar	Afar ; Afar
Afrikaans ; afrikaans	Afrikaans
Albania	Albania ; Republic of Albania
Aljeria	Algeria ; People's Democratic Republic of Algeria
Alpoù	Alps
Samoa Amerikan	American Samoa
Angola	Angola ; Republic of Angola
Antarktika	Antarctica
Antigua ha Barbuda	Antigua and Barbuda
Ebrel	April
arabeg	Arabic ; Standard Arabic
aragoneg	Aragonese ; Aragonese
Arc'hantina	Argentina ; Argentine Republic
Arizona	Arizona
Armenia	Armenia
brezhoneg ; Armenianeg ; armenianeg	Armenian
Aruba	Aruba
asameg	Assamese ; Assamese
Astureg	Astur-Leonese ; Asturian ; Asturian-Leonese ; Astur
Eost	August
অস্ট্রেলিয়া	Australia ; Commonwealth of Australia
Aostria	Austria ; Republic of Austria
Azerbaidjan	Azerbaijan ; Republic of Azerbaijan
azereg	Azerbaijani ; Azeri ; Azerbaijani Cluster
Bahrein	Bahrain
Bangladesh	Bangladesh ; People's Republic of Bangladesh
euskareg	Basque ; Basque
Bavaria	Bavaria
belaruseg	Belarusan ; Belarusan ; Belarusian ; Belorussian ; Byelorussian
Belgia	Belgium ; Kingdom of Belgium
Belize	Belize
bengaleg	Bengali ; Bengali
berlin	Berlin
Bermuda	Bermuda
Bhoutan	Bhutan ; Kingdom of Bhutan
Mor Du	Black Sea
bokmål ; daneg-norvegeg	Bokmål
Bolivia	Bolivia ; Republic of Bolivia
Bosnia-ha-Herzegovina	Bosnia and Herzegovina ; Republic of Bosnia and Herzegovina
bosneg	Bosnian ; Bosnian
Burgondia	Bourgogne
Brazil	Brazil
brezhoneg	Breton ; Breton
Bulgaria	Bulgaria ; Republic of Bulgaria
Bulgareg ; bulgareg	Bulgarian ; Bulgarian
Burmeg ; burmeg ; birmaneg	Burmese
Kalifornia	California
Kambodja	Cambodia ; Kingdom of Cambodia
Kameroun	Cameroon ; Republic of Cameroon
Kanada	Canada
spagnoleg	Castilian ; Spanish ; Spanish
kataloneg ; katalaneg	Catalan ; Catalan
Tchad	Chad ; Republic of Chad
Charente	Charente
Tchetcheneg ; tchetcheneg	Chechen ; Chechen
Chihuahua	Chihuahua
Chile	Chile ; Republic of Chile
sinaeg	Chinese
gwezenn Nedeleg	Christmas tree
tchouvacheg ; tchouvatch ; tchouvatcheg	Chuvash ; Chuvash ; Chuwash ; Chovash ; Chavash ; Chttash
Inizi Cook	Cook Islands
kerneveureg	Cornish
Korseg ; korseg	Corsican ; Corsican
Kroatia	Croatia ; Republic of Croatia
Kroateg ; kroateg	Croatian ; Croation
Kuba	Cuba ; Republic of Cuba
Kiprenez ; Republik Kiprenez	Cyprus ; Republic of Cyprus
lizherenneg kirillek	Cyrillic alphabet
Tchekeg ; tchekeg	Czech ; Czech
Republik Tchek	Czech Republic ; Czechia
Dakar	Dakar
Daneg ; daneg	Danish
Kerzu	December
Delaware	Delaware
Republik Dominikan	Dominican Republic
nederlandeg	Dutch
Unaniezh Europa	EU ; European Union
Timor ar Reter	East Timor ; Democratic Republic of Timor-Leste
Pask	Easter
Egipt	Egypt ; Arab Republic of Egypt
Salvador	El Salvador ; Republic of El Salvador
saozneg	English
Gouel ar Rouaned ; Gouel ar Rouanez ; Gouel ar Sterenn	Epiphany
Eritrea	Eritrea
esperanteg	Esperanto ; Esperanto
Estonia	Estonia ; Republic of Estonia
Estoneg ; estoneg	Estonian
Etiopia	Ethiopia ; Federal Democratic Republic of Ethiopia
Europa	Europe
inizi Falkland	Falkland Islands
Faero	Faroe Islands
Faeroeg ; faeroeg	Faroese ; Faeroese
C'hwevrer	February
Finland	Finland ; Republic of Finland
Finneg ; finneg	Finnish
Flandrez	Flanders ; Flemish region
Flevoland	Flevoland
Frañs ; Bro-C'hall ; Bro-C'hall	France
galleg	French ; French
Gwiana c'hall	French Guiana
Polinezia C'hall	French Polynesia
Dispac'h Gall	French Revolution
Douaroù Aostral hag Antarktikel Frañs	French Southern Territories ; French Southern and Antarctic LandsA ; French Southern and Antarctic Lands ; Territory of the French Southern and Antarctic Lands
Frizeg ; frizeg	Frisian ; Western Frisian
Gabon	Gabon ; Gabonese Republic
galizeg	Galician ; Galician
Jorjia	Georgia
Georgia	Georgia
jorjianeg	Georgian ; Georgian
alamaneg	German
Republik Kevreadel Alamagn ; Alamagn	Germany ; Federal Republic of Germany
Ghana	Ghana ; Republic of Ghana
Jibraltar	Gibraltar
Gres	Greece ; Hellenic Republic
gresianeg	Greek ; Greek
Greunland	Greenland
Grenada	Grenada
Gwadeloup	Guadeloupe
Guam	Guam ; Guam ; Guam
gujarati	Gujarati ; Gujarati
Haiti	Haiti ; Republic of Haiti
bloavezh mat	Happy New Year
Hebreeg ; hebraeg	Hebrew
hindi	Hindi ; Hindi
Izelvroioù	Holland ; Kingdom of the Netherlands ; The Netherlands
Honduras	Honduras ; Republic of Honduras
Hungareg ; hungareg	Hungarian
Hungaria	Hungary ; Republic of Hungary
me	I
reolad ISO	ISO standard
Island	Iceland ; Republic of Iceland
islandeg	Icelandic
India	India ; Republic of India
Indonezia	Indonesia ; Republic of Indonesia
bahasa Indonesia ; indoneseg	Indonesian
Indre	Indre
interlingua	Interlingua ; Interlingua, "Simplified" Latin ; Interlingua, "Simplified" Latin
Iran	Iran ; Islamic Republic of Iran
Iraq	Iraq ; Republic of Iraq
Iwerzhon	Ireland ; Republic of Ireland
iwerzhoneg	Irish ; Irish ; Irish Gaelic ; Irish
Israel	Israel ; State of Israel
Italianeg ; italianeg	Italian ; Italian
Italia	Italian Republic ; Italy
Aod an Olifant	Ivory Coast ; Cote d'Ivoire ; Republic of Cote d'Ivoire
Jamaika	Jamaica
Genver	January
Japan	Japan ; State of Japan
Japoneg ; japaneg	Japanese ; Japanese
javaneg	Javanese
Jerzenez	Jersey ; Bailiwick of Jersey
Jordania	Jordan ; Hashemite Kingdom of Jordan
yuzevegezh	Judaism
Gouere	July
Mezheven ; Even	June
greunlandeg	Kalaallisut
kannada ; kanareg	Kannada ; Kannada
Karelieg	Karelian
kazak	Kazakh ; Kazakh
Kazac'hstan ; Kazakstan	Kazakhstan ; Republic of Kazakhstan
kambodjeg	Khmer ; Central Khmer
koreaneg	Korean ; Korean
Kirgizstan	Kyrgyzstan ; Kyrgyz Republic
laoseg	Lao ; Lao
Laos	Laos ; Lao People's Democratic Republic
Latin ; latin	Latin ; Latin
Latvia	Latvia ; Republic of Latvia
Latvieg ; latveg ; latvieg	Latvian ; Latvian
Sankt Peterbourg	Leningrad ; Petrograd ; Saint Petersburg ; St. Petersburg
Lesotho	Lesotho ; Kingdom of Lesotho
Liberia	Liberia ; Republic of Liberia
Libia	Libya ; Great Socialist People's Libyan Arab Jamahiriya
limburgeg	Limburgish ; Limburgian
Lisbon ; Lisboa	Lisbon
Lituania	Lithuania ; Republic of Lithuania
lituaneg	Lithuanian ; Lithuanian
Saks-Izelañ	Lower Saxony
luksembourgeg	Luxembourgish ; Luxemburgish ; Luxembourgian
Makedonia	Macedonia ; Republic of Macedonia
Makedoneg ; makedoneg	Macedonian ; Macedonian
Madagaskar	Madagascar ; Republic of Madagascar
Malayalameg ; malayalameg ; malayalam	Malayalam ; Malayalam
Malaysia	Malaysia
Malta	Malta ; Republic of Malta
Malteg ; malteg	Maltese
maori	Maori
marathi	Marathi ; Marāthi ; Marāthi ; MarÄthi
Meurzh	March
Martinik	Martinique
Massachusetts	Massachusetts
Maouritania	Mauritania ; Islamic Republic of Mauritania
Mae	May
Mayotte	Mayotte
nedeleg laouen	Merry Christmas
Nedeleg laouen ha bloavezh mat	Merry Christmas and a happy New Year
Mec'hiko ; Stadoù-Unanet Mechiko	Mexico ; United Mexican States
Milan	Milan
Monaco	Monaco
Montenegro	Montenegro
Montserrat	Montserrat
Maroko	Morocco ; Kingdom of Morocco
Myanmar	Myanmar
emzalc'h NIMBY ; emzalc'h Vokedumañ	NIMBY aptitude ; NIMBY attitude
Naplez	Naples
napolitaneg	Neapolitan ; Neapolitan
nepaleg	Nepali ; Nepali
Neizhan	Neptune
Kaledonia Nevez	New Caledonia
New York	New York
Zeland-Nevez	New Zealand
Nicaragua	Nicaragua
Niue ; Niuo	Niue
Norvegia	Norway ; Kingdom of Norway
Du	November
norvegeg ; nynorsk	Nynorsk
Here	October
Oklahoma	Oklahoma
Panama	Panama
Papoua Ginea-Nevez	Papua New Guinea
Pariz	Paris
Sina	People's Republic of China ; China
perseg	Persian ; Western Farsi ; Farsi
Polonia	Poland
poloneg	Polish ; Polish
Portugal	Portugal
Portugaleg ; portugaleg	Portuguese ; Portuguese
Puerto Rico	Puerto Rico
pandjabeg	Punjabi ; Panjabi
Pireneoù	Pyrenees
Ron	Rhône
Roumaneg ; roumaneg	Romanian ; Romanaian
Roma	Rome
Ruseg ; rusianeg	Russian ; Russian
Sant-Pêr-ha-Mikelon	Saint-Pierre and Miquelon
Sañskriteg ; sañskriteg	Sanskrit ; Sanskrit
Damkan Sapir ha Whorf	Sapir–Whorf hypothesis
Sadorn	Saturn
Arabia Saoudat	Saudi Arabia ; Kingdom of Saudi Arabia
Saks	Saxony
Saena	Seine
Senegal	Senegal
Gwengolo	September
serbeg	Serbian ; Serbian
sindhi	Sindhi ; Sindhi
Sloveg ; slovakeg	Slovak ; Slovak
Slovakia	Slovakia
sloveneg	Slovene ; Slovenian ; Slovenian
somali	Somali ; somali
Suafrika	South Africa
Spagn	Spain
Sri Lanka	Sri Lanka
Soudan	Sudan
Sveden	Sweden
Svedeg ; svedeg	Swedish
Suis	Switzerland
Siria	Syria ; Syrian Arab Republic
tagalogeg ; tagalog	Tagalog
Taiwan	Taiwan
Tadjikeg ; tadjikeg ; tadjik	Tajik
Tamouleg ; tamouleg ; tamileg	Tamil ; Tamil
Tanzania	Tanzania
tatar ; tatareg	Tatar ; Tatar
telougou	Telugu ; Telugu
Tennessee	Tennessee
thai	Thai ; Thai
Thailand	Thailand
Turingia	Thuringia
Togo	Togo
Tonga	Tonga
Tswaneg ; tswaneg ; tswana	Tswana
Turkia	Turkey
turkeg	Turkish ; Turkish
Ouganda	Uganda ; Republic of Uganda
ukraineg	Ukrainian ; Ukrainian
SUA ; S.U.A. ; Stadoù-Unanet Amerika	United States ; United States of America ; America ; US ; U.S. ; U.S.A. ; U.S. of A. ; States
ourdoueg ; ourdou	Urdu ; Urdu
Utah	Utah
Keoded ar Vatikan	Vatican City ; The Holy See ; State of the Vatican City
Venezia	Venice
Vienna	Vienna
vietnameg	Vietnamese ; Vietnamese
volapük	Volapük
Volga	Volga
KemBre ; Kembre	Wales
Inizi Wallis ha Futuna	Wallis and Futuna ; Territory of the Wallis and Futuna Islands
Walloneg ; walloneg	Walloon ; Walloon
Washington	Washington
Kembraeg ; kembraeg	Welsh ; Welsh
Kornôg Europa	Western Europe
Wikeriadur	Wiktionary
World Wide Web ; Web ; Gwiad ; Gwiad bedel	World Wide Web ; WWW
Wyoming	Wyoming
Xhosaeg ; xhosaeg ; xhosa	Xhosa
yidicheg	Yiddish
Zambia	Zambia ; Republic of Zambia
Zimbabwe	Zimbabwe ; Republic of Zimbabwe
zouloueg	Zulu
Lec'hiad greantel dilezet	abandoned industrial site
karbed dilezet	abandoned vehicle ; car wreck
vilaat	abasement
berradur	abbreviation
kont	account
trenkenn	acid
ober	act ; deed
anv-gwan	adjective ; describing word
melestradurezh ; mererezh	administration ; direction ; management
advabañ	adoption
avantur	adventure
adverb	adverb
nijerez ; karr-nij	aeroplane ; bird ; plane
aersol	aerosol
dihuner	alarm clock
alchimiour	alchemist
aljebr	algebra
gant ; get	alongside ; amongst ; with
lizherenneg	alphabet
aluminiom	aluminium
ambasader	ambassador
c'hoantek	ambitious
klañvgarr	ambulance
amerikiom	americium
amfiteatr	amphitheatre
programm dielfennañ	analysis programme
anarkouriezh	anarchy
korfadurezh ; anatomiezh	anatomy
ha	and
ha	and ; as well as ; in addition to ; together with ; too
loen	animal
deiz-ha-bloaz	anniversary
merienenn	ant
brezhoneg ; enepster	antonym
abostol	apostle
tavañjer	apron
arc'hdug	archduke
gwareger	archer ; archer
tisaverezh ; tiijinerezh	architecture
argon	argon
tabut	argument
arsav-brezel	armistice
kazel	armpit
damgemmañ	arrange ; adapt ; adjust ; conform ; accommodate ; suit
arsenik	arsenic
tangwaller	arsonist
ger-mell	article
ludu	ash
asperjez	asparagus
aspirin	aspirin
goulakadenn	assumption ; supposition
berralan	asthma
steredoniezh	astronomy
disimetrek	asymmetric ; asymmetrical
skragn	avaricious
babouz	baboon
binioù	bagpipes
dilennadeg	ballot
freuz-stal	bankruptcy
bason	bassoon
genoù ; beg	beak ; mouth
gwenvidikadur	beatification
gwele	bed
ruskenn	beehive
beriliom	beryllium ; glucinium
evach ; evaj ; died	beverage ; drink
evach	beverage ; drink
bras ; meur	big ; large
bevliesseurted	biodiversity
labous ; evn	bird
gwilioud	birth ; birth ; birth ; childbirth ; childbirth ; childbirth ; parturition
deiz-ha-bloaz	birthday
eskob	bishop
bismut	bismuth
du	black
gov	blacksmith
dall	blind
gwad	blood
glas	blue
bor	boron
louzawouriezh	botany
louzawouriezh	botany ; phytology
termenoù ledanoc'h	broader term ; broader terms ; hypernym ; holonym
brom	bromine
savadur	building
boled	bullet
sardonenn	bumblebee
balafenn	butterfly
ellig	button ; clit ; clitoris
kaktus	cactus
kadmiom	cadmium
seziom	caesium
deiziadur	calendar
pizhskriverezh	calligraphy
kêr-benn ; kêrbenn	capital
karbon	carbon
dizimeziñ	celibacy
pennad	chapter
trugarez	cheers ; thank you ; thanks
kazh-ki	cheetah ; chetah
elfenn gimiek	chemical element ; element
kimiezh	chemistry
kerez	cherry
bugel	child
klor	chlorine
chokolad	chocolate
kêr	city
rummatadur	classification
koumoul	cloud
liv	colour ; colour ; colo(u)r
dont	come
kometenn	comet
komunouriezh	communism
stevell	condom ; prophylactic ; rubber ; safe ; safety
steredeg	constellation
yezh savet ; yezh kalvezel	constructed language ; artificial language
debriñ	consume ; eat ; swallow
bro ; Stad	country ; nation ; state
buoc'h	cow
krouiñ	creativity ; inventiveness
krusifi	crucifix
kuriom	curium
teulenn ; unanenn voneiz	currency
deiz	day ; daytime
bouzar	deaf
poan a varv	death penalty ; capital punishment ; death sentence
diviz	decision
disklêriadur	declaration ; statement
gwilioudiñ ; genel	deliver
demokratelezh	democracy
poblañsouriezh	demography
foerell	diarrhea
geriadur	dictionary
eskopti	diocese ; diocese
distaol	discount
diampoezoner	disinfectant
dizimeziñ ; torr-dimeziñ ; dibriediñ	divorce
ki ; kiez	dog
merc'hodenn ; poupinell	doll
beg-hir	dolphin
eva ; evañ	drink ; gulp ; quaff ; sip
dremedal	dromedary
sec'h	dry
poultrenn ; uloc'h ; houan	dust
skouarn	ear
debriñ ; predañ	eat
striv	effort ; exertion
vi	egg
einsteiniom	einsteinium
diskargadenn	ejaculation
ilin	elbow
postel ; post elektronek	electronic mail ; email ; e-mail
mall	emergency
empennad ; enkefalit	encephalitis
spesad loenel en arvar	endangered animal species
epikreizenn	epicentre
keheder	equator
europiom	europium
skiant rik	exact science
tarzhadenn	explosion
lagad	eye
danvez ; gwiad	fabric
tad ; tata	father
plu ; pluñv ; pluenn	feather
maouez	female ; woman
biz	finger
pomper	firefighter ; fireman ; firewoman ; fire fighter ; fire-eater
pesk	fish
pemp	five
bleunienn ; bleuñv	flower ; bloom ; blossom
lusenn ; brumenn ; latar ; mogidell ; morenn ; nivlenn	fog
boued	food
Treuzdougen boued ; treuzdougen boued	food transport
troad	foot
koad ; koadeg	forest
fosilenn	fossil
pevar ; peder	four
torradur	fracture
frouezh	fruit
leun	full
gadoliniom	gadolinium
galioa	gallium
karrdi	garage
douaroniezh ; geografiezh	geography
nadoezioù	geranium
germaniom	germanium
aour	gold
gong	gong
gwaz	goose
gouarner	governor
yezhadur	grammer ; grammar
biloba ; biloba ; douaren	grandson
geot	grass
gouelan	gull
hafniom	hafnium
blev	hair
barver	hairdresser ; barber
frilien	handkerchief
diskarg lastez dañjerus	hazardous waste dump
eñ	he
penn	head
kalon	heart
pagan	heathen ; infidel ; pagan
tommerezh	heating
pounner ; tuzum	heavy
heliom	helium
salud	hello ; hey ; hi ; howdy
amañ	here
hierarc'hiezh	hierarchy
holmiom	holmium
mel	honey
goanag ; esperañs	hope
hormon	hormone
marc'h	horse
ostaj ; gouestl	hostage
eur	hour
lusenn	huckleberry ; blueberry
kant	hundred
gwaz	husband ; spouse
hidrogen	hydrogen
termenoù strishoc'h	hyponym ; narrower terms ; narrower term
skorn ; kler	ice
dizalc'hted	independence
indiom	indium
hinienn	individual
endro diabarzh	indoor environment
grip	influenza ; flu
stlenneg ; urzhiataerezh	informatics ; computer science ; information science
binvioù seniñ ; benveg seniñ	instrument ; musical instrument
aozadur etrebroadel	international organisation
iridiom	iridium
houarn	iron
mell	joint ; articulation
kelaouenner	journalist
pod-berver	kettle
lounezh	kidney
kraoñ-kokoz	kokosnoot ; coconut
kripton	krypton
yezh	language
letern	lantern
lantan ; лантан	lanthanum
c'hoarzhin	laugh
lavand	lavender ; lavander
plom	lead
delienn	leaf
gar	leg
sitron	lemon
lizherenn	letter
tailh ; tell	levy
levraouegour	librarian
yezhoniezh	linguistics
litiom	lithium
biz-bihan	little finger ; pinkie
avu	liver
marc'h-du	locomotive
hir	long
lotiri	lottery
lenkrauzenn	lubricant
lutesiom	lutetium
magneziom	magnesium
gwaz ; den ; paotr ; gour	male ; man
den	man
manganez	manganese
jedoniezh ; matematikoù	mathematics
kig	meat
medisinerezh ; mezegiezh	medicine ; medicine (practice)
mendeleviom	mendelevium
merkur	mercury
metabolegezh	metabolism
ebrenn ; steredenn-lostek	meteor ; meteor ; meteor ; meteor ; meteor ; shooting star ; falling star
meteoritenn ; oablvaen ; maen-kurun	meteorite
metronom	metronome
laezh	milk
dant	molar ; tooth
blotvil	mollusc
molibden	molybdenum
miz	month
loar	moon ; Luna ; Moon
mamm	mother
mamm-gaer	mother-in-law ; mother in law
menez	mountain
Torosad meneziek ; torosad meneziek	mountain range
mirdi	museum
muzik ; sonerezh	music
muziker ; soner	musician
moustik	musquito ; mosquito
nadir	nadir
anv	name ; proper name ; proper noun
lien-revr	nappy
amezeg	neighbour ; vecino
neodim	neodymium
nevezc'her	neologism
neon	neon
neptuniom	neptunium
nevez	new ; novel
niobiom	niobium
nann	no
nobeliom	nobelium
fri	nose
ni	nosotros ; we
ket ; neket ; ne... ket	not
anv ; anv-kadarn	noun ; substantive
torrer-kraoñ	nutcracker
evezhiadenn	observation
arvestva	observatory
skoilh	obstacle ; obstruction
yezh ofisiel	official language
unan	one
ognonenn	onion
opiom	opium
gwellwelerezh	optimism ; optimism ; optimism ; optimism ; optimism ; optimism ; optimism
pe	or
laz-seniñ	orchestra
orkideenn ; orkide	orchid
organ	organ
evnoniezh	ornithology
reizhskrivadur	orthography
osmiom	osmium
struskańval	ostrich
perc'henn	owner
oksigen	oxygen
ozon	ozone
peoc'helour	pacifist
palladiom	palladium
Rummenn-ger ; rummenn-ger ; bomm lavar	part of speech ; lexical category
perenn	pear
pengouin	penguin
garbedenn	perineum
prederouriezh	philosophy
telefon	phone ; telephone
fonetik	phonetics
dube	pigeon ; dove
lec'h ; -va	place ; location
planedenn	planet
plant	plant
elfenn blant	plant component
orogell	platitude ; cliche ; cliché
saotradur	pollution
Pab	pope
pozitron	positron
prazeodim	praseodymium
prelad	prelate
politikerezh priziañ an danvezioù	pricing policy of resources
priñs	prince
problem	problem
brudañ produioù	product advertising
prometiom	promethium
distagadur	pronunciation
prostat	prostate
protaktiniom	protactinium
bredvezeg	psychiatrist
lapin ; konikl	rabbit
skinoniezh	radiology
radiom	radium
kanevedenn	rainbow
rekipe	recipe
fleüt-pigos	recorder
karv-erc'h	reindeer
relijion	religion
enklask ; imbourc'h	research
reniom	rhenium
riz	rice
kehentiñ war ar riskloù	risk communication
stêr	river
hent	road
gwrizienn	root
roz	rose
ruzvaen	ruby
ruteniom	ruthenium
rutherfordiom	rutherfordium
cахара	sahara
lestr-dre-lien	sailing ship
holen	salt
samariom	samarium
traezh	sand
sardinenn	sardine
loarell	satellite
lavaret	say
skiant	science
gouelezennouriezh	sedimentology
gwelet	see
greun	seed
had	seed
semantik	semantics
jener ; reizh ; rev	sex ; gender
seksologiezh	sexology
dañvad	sheep
bihan ; munut ; bitik	short ; small
yezh ar sinoù	sign language
silisiom	silicon
arc'hant	silver
kroc'hen	skin
pantouflenn	slipper
moged	smoke
naer	snake
erc'h	snow
skiant sokial	social science
yezhoniezh kevdredel	sociolinguistics ; sociology of language
natriom	sodium
spesad	species
nevezamzer	spring
steredenn	star
stomog	stomach
marvailh	story
strategel	strategic
strontiom	strontium
sulfur	sulphur
gourmarc'had	supermarket
surjian	surgeon
strinkell	syringe
tantal	tantalum
teknetiom	technetium
sponterezh	terrorism
taliom	thallium
doueoniezh	theology
terapiezh	therapy
tri ; teir	three
kurun ; taran	thunder
staen	tin
titan	titanium
biz-troad	toe
warc'hoazh	tomorrow
teod	tongue
hengounel	traditional
tren	train
treiñ	translate ; interpret
troidigezh	translation
gwez	tree
tric'hornventouriezh	trigonometry
koun-trec'h	trophy
trovan	tropics ; torrid zone
dluzh	trout
tonno	tunafish
gevell	twin
daou ; div	two
uzurpañ	usurp
vaksin	vaccination
sunerez-poultr	vacuum cleaner
prizius	valuable
verb	verb
veterant	veteran
gwinieg	vineyard
voltadur	voltage
vogalenn	vowel
gwespedenn	wasp
pod-lastez ; poubelenn	waste bin
lezenn a denn d'an ober ouzh al lastez	waste disposal act
balum	whale
gwenn	white
gwreg	wife ; spouse
wiki	wiki
haleg	willow
avel	wind
test	witness
sorser	wizard ; sorcerer ; magician
ger	word
lec'h labour	workplace
c'hwi	y'all ; you ; you lot ; yous
bloaz ; bloavezh	year ; solar year
melen	yellow
mann ; zero	zero ; null
zirkoniom	zirconium
zodiak	zodiac
loenoniezh	zoology
Åland	Åland Islands
