Czech	English
devět	9 ; nine
AIDS	AIDS
hodnota AOX	AOX value
ASEAN	ASEAN ; Association of Southeast Asian Nations
Abidžan	Abidjan
abchazština ; abcházština	Abkhaz ; Abkhazian ; Abkhazian
Abcházie	Abkhazia
Abraham Lincoln ; Abraham Lincoln ; Abraham Lincoln ; Abraham Lincoln ; Abraham Lincoln	Abraham Lincoln ; Abraham Lincoln ; Abraham Lincoln ; Abraham Lincoln ; Abraham Lincoln ; Abraham Lincoln ; Abraham Lincoln ; Abraham Lincoln ; Abraham Lincoln ; Abraham Lincoln ; Abraham Lincoln
Abuja	Abuja
Adelaide	Adelaide
Jaderské moře ; Jadran	Adriatic Sea
Egejské moře	Aegean Sea
afarština	Afar ; Afar
Afghánistán	Afghanistan ; Transitional Islamic State of Afghanistan
Afrika	Africa
afrikánština	Afrikaans
Albánie	Albania ; Republic of Albania
Alžírsko	Algeria ; People's Democratic Republic of Algeria
Alpy	Alps
Americká Samoa	American Samoa
americký fotbal	American football ; American football
Amerika	Americas
test Ames	Ames test
Amsterdam	Amsterdam
Andorra	Andorra ; Principality of Andorra
Angola	Angola ; Republic of Angola
Anguilla	Anguilla
Antarktický oceán	Antarctic Ocean ; Southern Ocean
antarktický ekosystém	Antarctic ecosystem
Antarktida	Antarctica
Antigua a Barbuda	Antigua and Barbuda
duben	April
Rajka	Apus
Vodnář	Aquarius
Orel	Aquila
arabský ; arabština	Arabic ; Standard Arabic
aragonština	Aragonese ; Aragonese
Arktický oceán ; Severní ledový oceán	Arctic Ocean
ekosystém arktický ; arktický ekosystém	Arctic ecosystem
Argentina	Argentina ; Argentine Republic
Beran	Aries
Arizona	Arizona
Arménie	Armenia
arménský ; arménština	Armenian
článkovec	Articulata
Aruba	Aruba
Asie	Asia
Hvězdnicovité	Asteraceae ; sunflower family ; Compositae ; daisy family ; aster family
asturština	Astur-Leonese ; Asturian ; Asturian-Leonese ; Astur
Athény	Athens
Atlantický oceán ; Atlantik	Atlantic Ocean
srpen	August
Austrálie	Australia ; Commonwealth of Australia
Rakousko	Austria ; Republic of Austria
Rakousko-Uhersko	Austria-Hungary ; Austro-Hungarian Empire
Ázerbájdžán	Azerbaijan ; Republic of Azerbaijan
Ázerbájdžánština ; Azeri ; ázerbájdžánština	Azerbaijani ; Azeri ; Azerbaijani Cluster
Azory	Azores
systém počítačový pro výměnu dat	BBS ; bulletin board system
Bahamy	Bahamas ; Commonwealth of the Bahamas ; Bahama Islands
Bahrajn	Bahrain
Baleáry	Balearic Islands
Bangladéš	Bangladesh ; People's Republic of Bangladesh
Barbados	Barbados
Baskičtina ; baskičtina	Basque ; Basque
Bavorsko	Bavaria
Peking	Beijing
Bělorusko	Belarus ; Republic of Belarus
běloruský ; běloruština	Belarusan ; Belarusan ; Belarusian ; Belorussian ; Byelorussian
Belgie	Belgium ; Kingdom of Belgium
Bělehrad	Belgrade
Belize	Belize
bengálština	Bengali ; Bengali
Berlín	Berlin
Bermudy	Bermuda
Bhútán	Bhutan ; Kingdom of Bhutan
Bible	Bible
Birmingham	Birmingham
Černé moře	Black Sea
Bolívie	Bolivia ; Republic of Bolivia
Bosna a Hercegovina	Bosnia and Herzegovina ; Republic of Bosnia and Herzegovina
bosenština	Bosnian ; Bosnian
Botswana	Botswana ; Republic of Botswana
Burgundsko	Bourgogne
Bouvetův ostrov	Bouvet Island
Pastýř	Boötes
Bratislava	Bratislava
Brazílie	Brazil
bretonský ; bretonština	Breton ; Breton
Britské indickooceánské území	British Indian Ocean Territory ; BIOT
Brunej	Brunei ; Negara Brunei Darussalam
Bulharsko	Bulgaria ; Republic of Bulgaria
bulharský ; bulharština	Bulgarian ; Bulgarian
barmština	Burmese
Burundi	Burundi ; Republic of Burundi
CD-ROM	CD-ROM
pomoc při vyhledávání na CD-ROM	CD-ROM search service
chlorfluorovaný uhlovodík	CFC ; chlorofluorocarbon
zákaz CFC a halonů	CFC and halons prohibition
Káhira ; Káhira ; Káhira	Cairo
Kambodža	Cambodia ; Kingdom of Cambodia
Kamerun	Cameroon ; Republic of Cameroon
Kanada	Canada
Rak	Cancer
Honící psi	Canes Venatici
Velký pes	Canis Major
Malý pes	Canis Minor
Zöld fok	Cape Verde ; Republic of Cape Verde
Kozoroh	Capricorn
karibská oblast	Caribbean Area ; Caribbean
Karibské moře	Caribbean Sea
Kaspické moře	Caspian Sea
Kasiopeja	Cassiopeia
španělština	Castilian ; Spanish ; Spanish
katalánsky ; katalánština	Catalan ; Catalan
Kajmanské ostrovy	Cayman Islands
střední Afrika	Central Africa
Střední Amerika	Central America
střední Asie	Central Asia
Čad	Chad ; Republic of Chad
čečenština	Chechen ; Chechen
Chihuahua	Chihuahua
čivava	Chihuahua ; chihuahua
Chile	Chile ; Republic of Chile
Vánoce	Christmas
Vánoční ostrov	Christmas Island
vánoční stromek	Christmas tree
čuvašština	Chuvash ; Chuvash ; Chuwash ; Chovash ; Chavash ; Chttash
Kolín nad Rýnem	Cologne
Kolumbie	Colombia ; Republic of Colombia
rozhodnutí Společenství	Community act
rozpočet Společenství	Community budget
finanční prostředky Společenství	Community finance
právo Společenství	Community law
systém legislativní Společenství	Community legal system
usnesení Společenství	Community ruling
Kodaň	Copenhagen
korsičtina	Corsican ; Corsican
Soudní dvůr Společenství	Court of Justice of the European Communities
Chorvatsko	Croatia ; Republic of Croatia
charvátština ; chorvatština	Croatian ; Croation
Kuba	Cuba ; Republic of Cuba
Kypr	Cyprus ; Republic of Cyprus
cyrilice	Cyrillic alphabet
čeština	Czech ; Czech
Česko ; Česká Republik	Czech Republic ; Czechia
DDT	DDT ; dichloro-diphenyl-trichloroethane
DNA	DNA ; deoxyribonucleic acid
dagestán ; Dagestán	Dagestan
Dakar	Dakar
dánský ; dánština	Danish
prosinec	December
definice	Definition ; definition
Dánsko	Denmark ; Kingdom of Denmark
Dominikánská republika	Dominican Republic
Downův syndrom	Down syndrome ; Down’s syndrome
nizozemština	Dutch
Rada ministrů ES	EC Council of Ministers
smlouva o ES	EC Treaty
směrnice ES	EC directive
směrnice ES o biocidech	EC directive on biocides
směrnice ES o zneškodňování odpadů	EC directive on waste disposal
směrnice ES o ochraně vod	EC directive on water protection
značení ekologické ES	EC ecolabel
politika ES	EC policy
předpis ES	EC regulation
předpis ES o řízení ekologickém a auditu	EC regulation on eco-management and audit
předpis ES o vyskytujících se chemikáliích	EC regulation on existing chemicals
EIA místní	EIA (local)
posuzování vlivů na prostředí životní	EIA ; environmental impact assessment
směrnice o EIA	EIA directive
zákon o EIA	EIA law
Evropská unie	EU ; European Union
Rada EU	EU Council
vztahy Slunce a Země	Earth-Sun relationship
východní Afrika	East Africa
Východní Timor	East Timor ; Democratic Republic of Timor-Leste
vztahy Východu a Západu	East-West relations
obchod mezi Východem a Západem	East-West trade
Velikonoce	Easter
východní Asie	Eastern Asia ; East Asia
Evropa východní	Eastern Europe
Ekvádor	Ecuador ; Republic of Ecuador
Egypt	Egypt ; Arab Republic of Egypt
Salvador	El Salvador ; Republic of El Salvador
Anglie	England
angličtina	English
zahrada anglická	English garden
Epifanie ; Slavnost Zjevení Páně ; svátek Tří králů	Epiphany
Jerevan	Erevan ; Yerevan
Eritrea	Eritrea
esperanto	Esperanto ; Esperanto
Estonsko	Estonia ; Republic of Estonia
estonský ; estonština	Estonian
Etiopie	Ethiopia ; Federal Democratic Republic of Ethiopia
Euratom	Euratom
Evropa	Europe
Evropská komise	European Commission
Evropská společenství	European Communities
Evropský soudní dvůr	European Court of Justice
Evropská agentura pro životní prostředí	European Environment Agency
Evropská rada pro životní prostředí	European Environmental Council
Evropský měnový fond	European Monetary Fund
Evropský měnový systém	European Monetary System ; EMS
Evropský parlament	European Parliament
rezervace přírodní evropská	European nature reserve
norma evropská	European standard
Falklandy	Falkland Islands
Faerské ostrovy	Faroe Islands
faerský	Faroese ; Faeroese
únor	February
Fidži	Fiji ; Republic of the Fiji Islands
Finsko	Finland ; Republic of Finland
finština	Finnish
Flandry	Flanders ; Flemish region
Flevoland	Flevoland
Francie	France
francouzský ; francouzština	French ; French
Francouzská Guyana	French Guiana
Francouzská Polynésie	French Polynesia
Francouzská jižní a antarktická území	French Southern Territories ; French Southern and Antarctic LandsA ; French Southern and Antarctic Lands ; Territory of the French Southern and Antarctic Lands
zahrada francouzská	French formal garden
pátek	Friday
frísky ; fríština	Frisian ; Western Frisian
produkt hrubý domácí	GDP ; gross domestic product
NDR ; Německá demokratická republika	GDR ; German Democratic Republic
digitální formát GIS	GIS digital format
digitální systém GIS	GIS digital system
technika GIS digitální	GIS digital technique
laboratoř GIS	GIS laboratory
Gabon	Gabon ; Gabonese Republic
galicijský ; galicijština	Galician ; Galician
Gambie	Gambia ; Gambia ; Gambia ; Gambia ; The Gambia ; Republic of The Gambia
Pásmo Gazy	Gaza Strip
Blíženci	Gemini
Gruzie	Georgia
Georgie	Georgia
gruzínština	Georgian ; Georgian
němčina	German
němec ; němec	German
německý	German
němčina (Rakousko)	German (Austria)
němčina (Švýcarsko)	German (Switzerland)
Německo	Germany ; Federal Republic of Germany
Ghana	Ghana ; Republic of Ghana
Gibraltar	Gibraltar
Světový ekologický fond	Global Environment Facility ; GEF
Velká Británie	Great Britain ; Britain
Řecko	Greece ; Hellenic Republic
řecký ; řečtina	Greek ; Greek
řecká abeceda	Greek alphabet
Grónsko	Greenland
Grenada	Grenada
Guadeloupe	Guadeloupe
Guam	Guam ; Guam ; Guam
H5N1	H5N1 ; Influenza A virus subtype H5N1 ; A(H5N1)
Haiti	Haiti ; Republic of Haiti
Chanuka	Hannukah
Hannover	Hanover
šťastný nový rok	Happy New Year
hebrejština	Hebrew
Herkules	Hercules
Héraklés ; Hercules	Hercules
hindský ; hindština	Hindi ; Hindi
Nizozemsko	Holland ; Kingdom of the Netherlands ; The Netherlands
Honduras	Honduras ; Republic of Honduras
maďarský ; maďarština	Hungarian
Maďarsko	Hungary ; Republic of Hungary
já	I
kodex IMCO	IMCO code
Mezinárodní měnový fond	IMF ; International Monetary Fund
norma ISO	ISO standard
Island	Iceland ; Republic of Iceland
islandský ; islandština	Icelandic
ido	Ido ; Ido
Ilias	Iliad
Indie	India ; Republic of India
Indický oceán	Indian Ocean
Indonésie	Indonesia ; Republic of Indonesia
indonéský	Indonesian
interlingua	Interlingua ; Interlingua, "Simplified" Latin ; Interlingua, "Simplified" Latin
Mezinárodní soudní dvůr	International Court of Justice
Internet	Internet
Írán	Iran ; Islamic Republic of Iran
Irák	Iraq ; Republic of Iraq
Irsko	Ireland ; Republic of Ireland
irština	Irish ; Irish ; Irish Gaelic ; Irish
Man ; Ostrov Man	Isle of Man ; Isle of Mann ; Mann
Izrael	Israel ; State of Israel
italský ; italčina ; italština	Italian ; Italian
Itálie	Italian Republic ; Italy
Pobřeží slonoviny	Ivory Coast ; Cote d'Ivoire ; Republic of Cote d'Ivoire
Jakarta	Jakarta ; Djakarta ; DKI Jakarta
Jamajka	Jamaica
leden	January
Japonsko	Japan ; State of Japan
japonský ; japonština	Japanese ; Japanese
Jersey	Jersey ; Bailiwick of Jersey
Jordánsko	Jordan ; Hashemite Kingdom of Jordan
židovství ; judaismus	Judaism
červenec	July
červen	June
Jupiter	Jupiter
Kazachstán	Kazakhstan ; Republic of Kazakhstan
Keňa	Kenya ; Republic of Kenya
Chartúm	Khartoum
khmerský ; khmerština	Khmer ; Central Khmer
Kiribati	Kiribati ; Republic of Kiribati
korejský ; korejština	Korean ; Korean
Kosovo	Kosovo
Krakov	Krakow ; Cracow
Kjóto	Kyoto
Lagos	Lagos
laoština	Lao ; Lao
Laos	Laos ; Lao People's Democratic Republic
latina	Latin ; Latin
Lotyšsko	Latvia ; Republic of Latvia
lotyšský ; lotyština	Latvian ; Latvian
Lausanne	Lausanne
Libanon	Lebanon ; Lebanese Republic
Petrohrad	Leningrad ; Petrograd ; Saint Petersburg ; St. Petersburg
Lev	Leo
Lesotho	Lesotho ; Kingdom of Lesotho
Libérie	Liberia ; Republic of Liberia
Váhy	Libra
Libye	Libya ; Great Socialist People's Libyan Arab Jamahiriya
Lichtenštejnsko ; Knížectví Lichtenštejn	Liechtenstein ; Principality of Liechtenstein
Litva	Lithuania ; Republic of Lithuania
litevština	Lithuanian ; Lithuanian
sněmovna Dolní	Lower House
Dolní Sasko	Lower Saxony
Lucembursko	Luxembourg ; Grand Duchy of Luxembourg
lucemburština	Luxembourgish ; Luxemburgish ; Luxembourgian
Lyon	Lyon
Makedonie	Macedonia ; Republic of Macedonia
makedonský ; makedonština	Macedonian ; Macedonian
Malawi	Malawi ; Republic of Malaŵi
malajálamština	Malayalam ; Malayalam
Malajsie	Malaysia
Malta	Malta ; Republic of Malta
maltština	Maltese
maráthský	Marathi ; Marāthi ; Marāthi ; MarÄthi
březen	March
Marshallovy ostrovy	Marshall Islands ; Republic of the Marshall Islands
Martinik	Martinique
květen	May
Mayotte	Mayotte
Mekka	Mecca
oblast Středozemního moře	Mediterranean Area
Středozemní moře	Mediterranean Sea
podnebí Středozemního moře	Mediterranean climate
les v oblasti Středozemního moře	Mediterranean forest
les v oblasti Středozemního moře	Mediterranean wood
Merkur	Mercury
veselé vánoce	Merry Christmas
Mexiko	Mexico ; United Mexican States
Milán	Milan
Mléčná dráha	Milky Way ; Galaxy
Milwaukee	Milwaukee
Moldavsko	Moldova
Monako	Monaco
pondělí	Monday
Černá Hora	Montenegro
Montserrat	Montserrat
Maroko	Morocco ; Kingdom of Morocco
Moskva	Moscow
Fudži ; Hora Fudži	Mount Fuji
Mosambik	Mozambique
Mnichov	Munich
Myanmar	Myanmar
způsobilost NIMBY	NIMBY aptitude ; NIMBY attitude
NOEL	NOEL
Náhorní Karabach	Nagorno-Karabakh
Nairobi	Nairobi
Namibie	Namibia
Nauru	Nauru ; Republic of Nauru
Nepál	Nepal
nepálský ; nepálština	Nepali ; Nepali
Neptun	Neptune
Nová Kaledonie	New Caledonia
New York	New York
Nový Zéland	New Zealand
Nikaragua	Nicaragua
Niue	Niue
severní Afrika	North Africa
Severní Amerika	North America
část Atlantického oceánu severní	North Atlantic Ocean
vztahy Severu a Jihu	North-South relationship
Severní Irsko	Northern Ireland
Norsko	Norway ; Kingdom of Norway
Nuuk	Nuuk
Oceánie	Oceania
Oslo	Oslo
Pákistán	Pakistan ; Islamic Republic of Pakistan
Panama	Panama
Papua-Nová Guinea	Papua New Guinea
Paraguay	Paraguay
parlament	Parliament
Čína	People's Republic of China ; China
perština	Persian ; Western Farsi ; Farsi
Peru	Peru ; Republic of Peru
Filadelfie	Philadelphia
Phobos ; Fobos	Phobos
Polsko	Poland
polština	Polish ; Polish
Portugalsko	Portugal
portugalský ; portugalština	Portuguese ; Portuguese
Portoriko	Puerto Rico
paňdžábština	Punjabi ; Panjabi
Pyreneje	Pyrenees
pyrrhovo vítězství	Pyrrhic victory
Katar	Qatar
Rhône	Rhône
Rumunsko	Romania
rumunský ; rumunština	Romanian ; Romanaian
Rusko	Russia ; Russian Federation
ruský ; ruština	Russian ; Russian
Střelec	Sagittarius
Saint-Pierre a Miquelon	Saint-Pierre and Miquelon
Sachalin	Sakhalin ; Saghalien
San Marino	San Marino
sanskrt	Sanskrit ; Sanskrit
Sapir-Whorfova hypotéza	Sapir–Whorf hypothesis
sobota	Saturday
Saturn	Saturn
Saúdská Arábie	Saudi Arabia ; Kingdom of Saudi Arabia
Sasko	Saxony
Štír	Scorpio
Skotsko	Scotland
Seina	Seine
Senegal	Senegal
září	September
Srbsko	Serbia
Srbsko a Černá Hora	Serbia and Montenegro
srbština	Serbian ; Serbian
slovenský ; Slovenština ; slovenština	Slovak ; Slovak
Slovensko	Slovakia
slovinština	Slovene ; Slovenian ; Slovenian
Slovinsko	Slovenia
somálsky	Somali ; somali
Jihoafrická republika	South Africa
Jižní Amerika	South America
Jižní Korea	South Korea ; Republic of Korea
jihovýchodní Asie	Southeast Asia
jižní Asie	Southern Asia ; South Asia
Španělsko	Spain
Šrí Lanka	Sri Lanka
Súdán	Sudan
Král Slunce	Sun King
neděle	Sunday
Surinam	Suriname
svahilština	Swahili
švédský ; švédština	Swedish
Švýcarsko	Switzerland
Sýrie	Syria ; Syrian Arab Republic
Tchaj-wan	Taiwan
tamilský ; tamilština	Tamil ; Tamil
Tanzanie	Tanzania
tatarský	Tatar ; Tatar
Býk	Taurus
Teherán	Tehran
teluguský ; teluguský ; telugština	Telugu ; Telugu
Tennessee	Tennessee
thajský ; thajština	Thai ; Thai
Thajsko	Thailand
Durynsko	Thuringia
čtvrtek	Thursday
Togo	Togo
Tokio	Tokyo
Tonga	Tonga
Toronto	Toronto
úterý	Tuesday
Tunisko	Tunisia
Turecko	Turkey
turecký ; turečtina	Turkish ; Turkish
Organizace spojených národů	UN ; United Nations
Uganda	Uganda ; Republic of Uganda
Ukrajina	Ukraine
ukrajinský ; ukrajinčina ; ukrajinština	Ukrainian ; Ukrainian
Spojené království Velké Británie a Severního Irska ; Spojené království	United Kingdom ; United Kingdom of Great Britain and Northern Ireland ; UK
Spojené státy americké	United States ; United States of America ; America ; US ; U.S. ; U.S.A. ; U.S. of A. ; States
urdština	Urdu ; Urdu
Utah	Utah
Vaduz	Vaduz
Vatikán	Vatican City ; The Holy See ; State of the Vatican City
Venezuela	Venezuela
Benátky	Venice
Venuše	Venus
vietnamský ; vietnamština	Vietnamese ; Vietnamese
volapük	Volapük
Volha	Volga
Wales	Wales
Wallis a Futuna	Wallis and Futuna ; Territory of the Wallis and Futuna Islands
wallonský ; wallonština	Walloon ; Walloon
Washington	Washington
středa	Wednesday ; quarta-feira
velšský ; velština	Welsh ; Welsh
západní Asie	Western Asia ; Southwest Asia
Evropa západní	Western Europe
Wikipedie	Wikipedia
Wikcionář	Wiktionary
World Wide Web	World Wide Web ; WWW
Wyoming	Wyoming
Jemen	Yemen ; Republic of Yemen
jidiš	Yiddish
Jugoslávie	Yugoslavia
Zambie	Zambia ; Republic of Zambia
Zanzibar	Zanzibar
Zimbabwe	Zimbabwe ; Republic of Zimbabwe
amplituda	aAmplitude ; amplitude
překvapený	aback
abakus	abacus
opuštěné průmyslové místo	abandoned industrial site
opuštěné vozidlo	abandoned vehicle ; car wreck
ponížení	abasement
zkratka	abbreviation
prostředí abiotické	abiotic environment
abiotický činitel	abiotic factor
brusný	abrasive
krátit	abridge
absces	abscess
absolutně	absolutely
absorpce	absorption
zrychlení	acceleration
přijatelný denní příjem	acceptable daily intake
přijatelná úroveň rizika	acceptable risk level
akceptace	acceptance ; credence
přístupová cesta	access road
přístup k listinám úředním	access to administrative documents
přístup ke kultuře	access to culture
přístup k informacím	access to information
přístup k soudům	access to the courts
havárie	accident
zdroj havárie	accident source ; cause of the accident
havarijní únik organizmů	accidental release of organisms
akordeon ; harmonika	accordion ; squeeze box ; piano accordion
účet	account
účetnictví	accountancy
účetnictví	accounting
účetní systém	accounting system
akumulátor	accumulator
kyselina	acid
kyselá depozice	acid deposition
deště kyselé ; kyselý déšť	acid rain
acidifikace	acidification
kyselost	acidity
stupeň kyselosti	acidity degree
akne	acne
pohodlí akustické	acoustic comfort
akustický filtr	acoustic filter ; audio filter
akustická izolace	acoustic insulation
akustická hladina	acoustic level ; sound pressure level
akustické vlastnosti	acoustic property
kvalita akustická	acoustical quality
akustika	acoustics
štiplavý	acrid
zákon	act ; deed
prvky radioaktivní	actinide
aktinium	actinium
akční skupina	action group ; action committee
aktivní uhlí	activated carbon
aktivovaný kal	activated sludge
aktivní účast	active participation
obyvatelstvo ve věku aktivním	active population
doba adaptace	adaptation period
sčítání	addition
doplňkový obal	additional packaging
přídavná látka	additive
zásobování potravinami dostatečné	adequate food supply
lepidlo	adhesive
přídavné jméno	adjective ; describing word
nastavit	adjust
správa	administration ; direction ; management
správní orgán	administrative body ; administrative organ
hranice správní	administrative boundary
úřední kompetence	administrative competence ; administrative ability
listina úřední	administrative deed
úřední nařízení	administrative fiat
pokyny úřední	administrative instructions
správní právo	administrative law
správní zaměstnanec	administrative occupation
organizace správní	administrative organisation
správní řízení	administrative procedure
správní sankce	administrative sanction
adsorpce	adsorption
dospělý	adult
vzdělávání dospělých	adult education
inzerce	advertisement ; promotion
doporučení	advice
provzdušňování	aeration
anténa	aerial
letecký snímek	aerial photograph
snímkování letecké	aerial photography
aerobní proces	aerobic process
aerobní čištění	aerobic treatment
aerobiologie	aerobiology
aerodynamický hluk	aerodynamic noise
aerosol	aerosol
estetika	aesthetics
zalesňování	afforestation ; tree planting ; afforestment
přídavné spalování	afterburning ; afterburning ; afterburner
věk	age
agresivní	aggressive
útočník	aggressor ; assailant ; attacker ; assaulter
agorafobie ; agorafobie	agoraphobia ; agoraphobia ; agoraphobia ; agoraphobia
smlouva	agreement
souhlas	agreement
dohoda	agreement
potraviny zemědělské	agri-foodstuff
zemědělská biotechnologie	agricultural biotechnology
hospodářská budova	agricultural building
zemědělská katastrofa	agricultural disaster
ekologie zemědělství	agricultural ecology ; agroecology
zemědělská ekonomika	agricultural economics
zemědělské odpadní vody	agricultural effluent
zemědělské inženýrství	agricultural engineering
zemědělské zařízení	agricultural equipment
zemědělské stroje ; zemědělské zařízení	agricultural equipment ; agricultural machinery ; farm machinery
využití zemědělské	agricultural exploitation
hydraulika zemědělská	agricultural hydraulics
zemědělská půda	agricultural land
zemědělská krajina	agricultural landscape
zemědělská legislativa	agricultural legislation
zemědělské hospodářství	agricultural management
metoda v zemědělství	agricultural method
škůdce v zemědělství	agricultural pest
zemědělské plánování	agricultural planning
zemědělská politika	agricultural policy
zemědělské znečištění	agricultural pollution
zemědělský výrobek	agricultural product
zemědělská výroba	agricultural production ; farm production ; agricultural output
nemovitost zemědělská	agricultural real estate
skladování v zemědělství	agricultural storage
struktura zemědělská	agricultural structure
podhodnocení výrobků zemědělských	agricultural undervaluation
odpady ze zemědělství	agricultural waste
zemědělství	agriculture
zemědělství ; zemědělství	agriculture ; agriculture
zemědělská velkovýroba	agriculture and cattle industry
rámcový plán v zemědělství	agriculture framework plan
agroturistika	agritourism
agrochemikálie	agrochemical
agrolesnictví	agroforestry
agroprůmysl	agroindustry
agrometeorologie	agrometeorology
hodnota agronomická	agronomic value
agronomie	agronomy
agroekosystém	agrosystem
politika pomoci	aid policy
vzduch	air
klimatizace	air conditioning ; AC ; air-conditioning
proudění vzduchu	air movement
látka znečišťující ovzduší	air pollutant
znečištění ovzduší	air pollution
kvalita ovzduší	air quality
kontrola kvality ovzduší	air quality control
řízení kvality ovzduší	air quality management
monitorování kvality ovzduší	air quality monitoring
alveola	air sac ; alveolus
bezpečnost ovzduší	air safety
teplota vzduchu	air temperature
letecká doprava	air traffic
zákon o letecké dopravě	air traffic law
letecká přeprava	air transportation
interakce vzduch-voda	air-water interaction
hluk přenášený vzduchem	airborne noise
letadlo	aircraft
hluk z letecké dopravy	aircraft noise
letecká pošta	airmail
letiště	airport
plánování vzdušného prostoru	airspace planning
poplach	alarm ; alert ; warning
budík	alarm clock
albinedd	albinism
alchymie	alchemy
alkohol	alcohol
alkoholismus	alcoholism
řasy	alga
květ řas	algal bloom
algicid	algicide ; algaecide
alibi	alibi
alicyklická sloučenina	alicyclic compound
alicyklický uhlovodík	alicyclic hydrocarbon
vytýčení trasy	alignment
alifatická sloučenina	aliphatic compound
alifatický uhlovodík	aliphatic hydrocarbon
alkalická půda	alkali soil
alkalické ; prvky skupiny I	alkaline ; element of group I ; alkaline metal ; alkali metal
baterie alkalická	alkaline battery
alkan	alkane ; paraffin ; methane series ; alkane series
alkylická sloučenina	alkyl compound
vozidlo terénní	all-terrain vehicle
alegorie	allegory
alergen	allergen
alergie	allergy
příděl	allocation ; allotment ; resource allotment
přídělový plán	allocation plan
alotropie	allotropy
podpora finanční	allowance
slitina	alloy
nížina naplaveninová	alluvial plain
naplaveniny	alluvion ; flood ; overflowing ; inundation
mandle	almond
skoro ; téměř	almost
záření alfa	alpha radiation
abeceda	alphabet
alternativní materiál	alternative material
alternativní technologie	alternative technology
výška nadmořská	altitude
oxid hlinitý	alumina
hliník	aluminium
hliníková nádoba	aluminium container
obsah hliníku	aluminium content
průmysl hliníku	aluminium industry
amalgám	amalgam
velvyslanec	ambassador
sanitka	ambulance
americium	americium
amin	amine
aminokyseliny	amino acid
amoniak	ammonia
amonifikace	ammonification
amonium	ammonium
obojživelník	amphibian
amfiteátr	amphitheatre
zábavní park	amusement park
anaerobní proces	anaerobic process
anaerobní čištění	anaerobic treatment
anagram	anagram
analogie	analogy
analýza	analysis
plán analýzy	analysis programme
analytická chemie	analytical chemistry
analytické zařízení	analytical equipment
analytická metoda	analytical method
anarchismus	anarchism
anatomie	anatomy
kotva	anchor
a	and
a ; i ; ale	and ; as well as ; in addition to ; together with ; too
rostlina krytosemenná ; rostlina kvetoucí	angiosperm ; flowering plant
rybolov	angling ; fishing ; line-fishing
živočich	animal
chování živočichů	animal behaviour
biologie živočichů	animal biology
zvířecí rezervace	animal conservatory
koridor pro zvířata	animal corridor
škoda způsobená zvířaty	animal damage
choroba zvířat	animal disease
stěhování živočichů	animal displacement
ekologie živočichů	animal ecology
exkrementy živočichů	animal excrement
pokusy na zvířatech	animal experiment
potrava zvířat	animal foodstuff
jateční zvíře	animal for slaughter
stanoviště živočichů	animal habitat
dědictví živočichů	animal heritage
živočišná výroba	animal husbandry
hnůj	animal manure
migrace živočichů	animal migration
zvuky vydávané zvířaty	animal noise
výživa živočichů	animal nutrition
fyziologie živočichů	animal physiology
stav zvěře	animal population
živočišný výrobek	animal product
živočišná výroba	animal production
ochrana živočichů	animal protection
rozmnožování zvířat	animal reproduction
živočišný zdroj	animal resource
práva zvířat	animal rights
úkryt zvířat	animal shelter
druhy živočišné	animal species
reintrodukce druhů živočišných	animal species reintroduction
obchod se zvířaty	animal trade
odpad živočišného původu	animal waste
anime	anime
aniont	anion
anýz	anise
kotník	ankle ; talocrural joint
kroužkovec	annelid
výročí	anniversary
mravenec	ant
antagonismus ; antagonizmus	antagonism
antilopa	antelope
antropogenní aktivita	anthropic activity
antropologická rezervace	anthropologic reserve
antropolog	anthropologist
antropologie	anthropology
antibiotikum	antibiotic
protilátka	antibody
riziko nebezpečí	anticipation of danger
prostředek proti usazeninám	antifouling agent
antimon	antimony
stimul ke snížení znečištění	antipollution incentive
zastaralé zařízení	antiquated plant
směrnice k minimalizaci rizika při zemětřesení	antiseismic regulation
antiteze	antithesis
antonymum	antonym
apartheid	apartheid
blok obytných budov	apartment block
apatie	apathy
včelařství	apiculture ; beekeeping
apoptóza	apoptosis
odvolání	appeal
odvolací řízení	appeal procedure
jabko ; jablko	apple
jabloň	apple ; apple tree
aplikovaná ekologie	applied ecology
aplikovaná výživa	applied nutrition
výzkum aplikovaný	applied research
užité vědy	applied science
posouzení	appraisal
vážit si	appreciate
přístup	approach
vhodná technnologie	appropriate technology
schválení	approval ; approbation
kolaudace zařízení	approval of installations
meruňka	apricot
zástěra	apron
chov ryb v nádržích	aquaculture
akvárium	aquarium
vodní živočich	aquatic animal
vodní ekologie	aquatic ecology
vodní ekosystém	aquatic ecosystem
prostředí vodní	aquatic environment
vodní savec	aquatic mammal
vodní organizmus	aquatic organism
vodní rostlina	aquatic plant
akvadukt	aqueduct
vodonosná vrstva	aquifer
obdělávání půdy	arable farming
arboretum	arboretum
pěstování dřevin	arboriculture
archeologický	archaeological
archeologická lokalita	archaeological site
archeologie	archaeology ; archeology ; archæology
arcibiskup	archbishop
lučištník	archer ; archer
souostroví	archipelago
architekt	architect
architektura	architecture
území znečištění potenciálního	area of potential pollution
oblast ohrožená využíváním nadměrným	area under stress
argon	argon
hádka	argument
oblast aridní	arid land
aristokracie	aristocracy
aritmetika	arithmetic ; arithmetics
vojenský potenciál	armament
konverze vojenské výzbroje	armament conversion
ozbrojené síly	armed forces
arzenál	armoury
podpaží	armpit
aromatická sloučenina	aromatic compound
aromatický uhlovodík	aromatic hydrocarbon
látka aromatická	aromatic substance
zálohování obalů	arrangement for a deposit on packaging
šíp	arrow
hrot šípu	arrowhead
arzén	arsenic
žhářství	arson
žhář	arsonist
umění	art
tepna	artery
rafinovaný	artful
artritida	arthritis
členovec	arthropod
artyèok	artichoke
jezero umělé	artificial lake
technika rozmnožování umělého	artificial reproductive technique
umělá družice	artificial satellite
umìlec	artist ; creative person
azbest	asbestos
azbestocement	asbestos cement
zaprášení plic	asbestosis
nadvláda	ascendancy
výstup	ascent
svah	ascent
zjistit	ascertain
asketa	ascetic
popel	ash
zahanbený	ashamed
bledý	ashen
na břehu	ashore
popelník	ashtray
spící	asleep
asfalt	asphalt
aspirace	aspiration
vrah	assassin ; assassinator
test	assay
svolat	assemble ; get together ; gather
souhlas	assent
souhlasit	assent
tvrdit	assert
trvat na	assert
určit	assign
úkol	assignment
přijímat	assimilate
asimilace	assimilation
asistovat	assist
sdružení	association
míchaný	assorted
předpoklad	assumption ; supposition
astat	astatine
hvězdička	asterisk
asteroid	asteroid
astenosféra	asthenosphere
astma	asthma
udivit	astonish
udivující	astonishing
údiv	astonishment
ohromit	astound
ohromující	astounding
obkročmo	astride
rozkročeně	astride
astrolog	astrologer
astrologie	astrology ; star divination
astrometrie	astrometry
astronautika	astronautics
astronom	astronomer
astronomie	astronomy
asymptota	asymptote
ateista	atheist
atlas	atlas
atmosféra	atmosphere
aerosol atmosférický	atmospheric aerosol
chemie atmosféry	atmospheric chemistry
proudění atmosférické	atmospheric circulation
složky atmosféry	atmospheric component
složení atmosféry	atmospheric composition
korekce atmosférická	atmospheric correction
emise do ovzduší	atmospheric emission
spad atmosférický	atmospheric fallout
atmosférické vrstvy	atmospheric layering
monitorování atmosféry	atmospheric monitoring
ozón atmosférický	atmospheric ozone
částice látek atmosféry	atmospheric particulate
Aeronomie ; fyzika atmosféry	atmospheric physics
znečištění atmosféry	atmospheric pollution
atmosférické srážky	atmospheric precipitation ; precipitation
proces atmosférický	atmospheric process
věda o ovzduší	atmospheric science
struktura atmosféry	atmospheric structure
atol	atoll
atom	atom
atraktivní	atractive
atrazin	atrazine
krutost	atrocity
oddaný	attached
náklonnost	attachment
příslušenství	attachment
útok	attack
dosáhnout	attain
pečovat o	attend
přijít	attend
dávat pozor	attend
věnovat se	attend
dozorce	attendant
pozorný	attentive
oděv	attire
obléci	attire
poloha	attitude
přitahovat	attract
vlastnost	attribute
aukce ; dražba	auction
odvážný	audacious
audiovizuální prezentace	audio-visual presentation
audiovizuální technika	audiovisual equipment
audiovizuální médium	audiovisual media
audit	audit
zvětšit	augment
zdárný	auspicious
oprávnění	authorisation
autoritářský	authoritarian
směrodatný	authoritative
správní orgán	authority body
autorství	authorship
samovláda	autocracy
autoekologie	autoecology
průmysl automobilový	automobile industry
pitva	autopsy
podzim	autumn
přístupný	available
lavina	avalanche
protilavinové opatření	avalanche protection
zamezit	avert
odvrátit	avert
voliéra	aviary
zákon o letectví	aviation law
chov ptactva	aviculture
ptactvo	avifauna
bázlivá úcta	awe
chvilku	awhile
pavián	baboon
úroveň prostředí	background level
hluk v pozadí	background noise
záření pozadí	background radiation
slanina	bacon
filtr biologický	bacterial bed
baktericid	bactericide
bakteriologické znečištění	bacteriological pollution
bakteriologie	bacteriology
bakterie	bacterium
badminton	badminton
dudy	bagpipes
pekař	baker
pekařství	baker ; bakery
prášek do pečiva	baking powder
ekonomická bilance	balance
látková bilance	balance of matter
rovnováha zájmů	balancing of interests
balada	ballad
taneční sál	ballroom
banán	banana
násep ; násep ; břeh	bank
zpevňování břehů	bank protection
bankovnictví	banking
baryum	barium
ječmen	barley
barometr	barometer
baron	baron
ostrov písečný paralelní s pobřežím	barrier beach
útes korálový	barrier reef
zásada	base
baseball	baseball ; baseball game
monitorování ovzduší	baseline monitoring
potřeba potravy základní	basic food requirement
zásaditost	basicity
houba stopkovýtrusná	basidiomycete
basketbal	basketball ; basketball game
fagot	bassoon
bastardizace fauny	bastardisation of fauna
bastardizace flóry	bastardisation of flora
diskontinuální proces	batch process
voda ke koupání	bathing freshwater
voda ke koupání	bathing seawater
voda ke koupání	bathing water
baterie	battery
zneškodňování baterií	battery disposal
záliv	bay
pláž	beach
čištění pláže	beach cleansing
fazole	bean ; edible bean
medvěd	bear
blahoslavený	beatification
bobr	beaver
včela	bee
ochrana včel	bee conservation
hovězí dobytek	beef cattle
pivo	beer
brouk	beetle
chování	behaviour
reaktivita látek	behaviour of substances
vzorec chování	behaviour pattern
věda o chování	behavioural science
organismus užitečný	beneficial organism
zóna bentická	benthic division
bentos	benthos
benzen	benzene
benzopyren	benzopyrene
berkelium	berkelium
beryllium	beryllium ; glucinium
záření beta	beta radiation
lepší ; líp ; lépe ; lépe	better
mezi	between
nápoj	beverage ; drink
výroba nápojů	beverage industry
bibliografická informace	bibliographic information
bibliografický informační systém	bibliographic information system
bibliografie	bibliography
kolo jízdní	bicycle ; bike ; cycle
velký ; velký	big ; large
zvěř divoká velká	big game
úmluva bilaterální	bilateral convention
žluč	bile
olej dnový	bilge oil
voda dnová	bilge water
dvojhvězda	binary star
biologická dostupnost	bio-availability
bioakumulace	bioaccumulation
bioakumulativní znečišťující látka	bioaccumulative pollutant
metoda biochemická	biochemical method
spotřeba kyslíku biochemická	biochemical oxygen demand
biochemický proces	biochemical process
látka biochemická	biochemical substance
biochemie	biochemistry
biocid	biocide
bioklimatologie	bioclimatology
biocenóza	biocoenosis
činitel koncentrace biologické	bioconcentration factor
biologická odbouratelnost	biodegradability
biologicky odbouratelná znečišťující látka	biodegradable pollutant
odbourávání biologické ; biodegradace	biodegradation
biodiverzita	biodiversity
etika biologická	bioethics
biologická filtrace	biofiltration
palivo biologické	biofuel
bioplyn	biogas
biogeochemický cyklus	biogeochemical cycle
region biogeografický ; biogeografický region	biogeographical region
biogeografie	biogeography
analýza biologická ; biologická analýza	biological analysis
biologická vlastnost	biological attribute
kontaminace biologická	biological contamination
biologický cyklus	biological cycle
biologický vývoj	biological development
biologický účinek	biological effect
biologický účinek znečištění	biological effect of pollution
inženýrství biologické	biological engineering
dědictví biologické	biological heritage
indikátor biologický	biological indicator
monitorování biologické ; biologické monitorování	biological monitoring
ochrana proti škůdcům biologická	biological pest control
biologická znečišťující látka	biological pollutant
biologické znečištění	biological pollution
biologický proces	biological process
biologická produkce	biological production
rezervace biologická	biological reserve ; wildlife reserve
biologický zdroj	biological resource
test biologický	biological test
biologické čištění	biological treatment
biologické čištění odpadních plynů	biological waste gas purification
biologické zpracování odpadů	biological waste treatment
biologické čištění odpadních vod	biological wastewater treatment
biologická bilance vody	biological water balance
zbraň biologická	biological weapon
biologie	biology ; biological science
bioluminiscence	bioluminescence
indikátor biologický	biomarker
biomasa	biomass
energie z biomasy	biomass energy
biom	biome
biofyzika	biophysics
bioreaktor	bioreactor
biorytmus	biorhythm
biologická bezpečnost	biosafety
biosféra	biosphere
rezervace biosférická	biosphere reserve
biosyntéza	biosynthesis
biotechnologické riziko	biotechnological hazard
biotechnologie	biotechnology
biotický činitel	biotic factor
index biotický	biotic index
biotop	biotope
síť biotopů	biotope network
uspořádání biotopu	biotope order
ochrana biotopu	biotope protection
pták	bird
dravec [pták] ; dravec (pták)	bird of prey
rezervace ptačí	bird sanctuary
druhy ptačí	bird species
narození ; porod	birth ; birth ; birth ; childbirth ; childbirth ; childbirth ; parturition
kontrola porodnosti	birth control
narozeniny	birthday
biskup	bishop
bismut	bismuth
bitumen	bitumen
černá	black
uhlí černé	black coal ; black coal ; black coal ; anthracite coal
kos	blackbird
kovář	blacksmith
vysoká pec	blast furnace
bělicí prostředek	bleaching agent
bělicí hlinka	bleaching clay
bělící proces	bleaching process
slepý	blind
weblog	blog ; weblog ; web log
krev	blood
krevní plazma	blood plasma
modrý	blue
sinice	blue-green alga ; cyanobacteria
člun	boat
projížďka na loďce	boating
krajina s remízky	bocage
rašeliniště	bog
bohrium	bohrium
kotel	boiler
bod varu	boiling point
bonsai	bonsai
kniha	book
účetnictví	bookkeeping
hranice	border
bór	boron
botanický skleník	botanical conservatory
botanická zahrada	botanical garden
botanika	botany
botanika	botany ; phytology
víčko lahve	bottle cap
přechod hraniční	boundary crossing
mezní vrstva	boundary layer
luk	bow
voda brakická	brackish water
větev	branch
obor činnosti	branch of activity
chléb	bread
snídaně	breakfast
mléko mateřské	breast milk
šlechtění	breeding
pták vyvádějící mláďata	breeding bird
technika chovu zvířat	breeding technique
cihla	brick
most	bridge
strom širokolistý	broad-leaved tree
hyperonymum ; nadřazené výrazy	broader term ; broader terms ; hypernym ; holonym
bróm	bromine
odchov umělý	brooding
potok	brook
křoví	brushwood
mechorost	bryophyte
bubble policy [povolení obchodovatelná emisní] ; bubble policy	bubble policy (emissions trading) ; bubble policy
rozpočet	budget
politika rozpočtová	budget policy
hmyz ; hmyz [Heteroctera]	bug ; põrnikas
budova	building
plocha zastavěná	building area
stavební prvek	building component
demolice budovy	building destruction
stavebnictví	building industry
pozemek stavební	building land
stavební hmoty	building material
průmysl hmot stavebních	building materials industry
povolení stavební	building permit
plánování staveb	building planning
předpisy stavební	building regulation
syndrom nezdravé budovy	building related illness ; sick building syndrome
restaurace budov	building restoration
správa budov	building service
staveniště	building site
příprava staveniště	building site preparation
stavební technologie	building technology
stavební odpady	building waste
systém odvodňovací umělý	built drainage system
prostředí vystavěné člověkem	built environment
konstrukce stavební	built structure
území zastavěné	built-up area
pěstování cibulovin	bulb cultivation
odpady velkorozměrné	bulky waste
byrokratizace	bureaucratisation
autobus	bus ; coach
zastávka autobusová	bus station
prosvětlování křovin	bush clearing
podnikání	business
činnost podnikatelská	business activity
kategorizace podniků	business classification
podnikové hospodaření	business economics
organizace obchodní	business organisation
politika obchodní	business policy
řezník	butcher
máslo	butter
motýl	butterfly
klitoris ; poštěváček	button ; clit ; clitoris
baterie knoflíková	button-cell battery
kupovat	buy ; purchase
nákup	buy ; purchase
úlovek vedlejší	by-catch
produkt vedlejší	by-product
kabel	cable
kaktus	cactus
kadmium	cadmium
cesium	caesium
kofein	caffeine
vápník	calcium
obsah vápníku	calcium content
výpočet	calculation
způsob výpočtu	calculation method
kalendář	calendar
ráže	caliber
kalibrace	calibration
kalifornium	californium
kaligrafie	calligraphy
velbloud	camel
fotoaparát	camera
kamufláž	camouflage
tábor	camp ; military camp ; army camp ; campsite
táboření	camping ; camping ground
kemp	camping site
kanál	canal
komora plavební	canal lock
rakovina	cancer
riziko rakoviny	cancer risk
svíèka ; svíčka	candle
šelmy psovité	canid
kaňon	canyon
automobil	car ; automobile
parkoviště	car park
pneumatika	car tyre
sacharid	carbohydrate
uhlík	carbon
oxid uhličitý	carbon dioxide
daň z oxidu uhličitého	carbon dioxide tax
oxid uhelnatý	carbon monoxide
uhličitan	carbonate
zneškodňování odpadů jatečních	carcass disposal
karcinogen	carcinogen
karcinogenita	carcinogenicity
test karcinogenity	carcinogenicity test
kardinál	cardinal
kardiologie	cardiology
nemoc kardiovaskulární	cardiovascular disease
kardiovaskulární systém	cardiovascular system
kariéra	career
masožravci	carnivore
vliv přenosu	carry-over effect
kartografie	cartography
proces soudní	case ; lawsuit ; trial
plodina tržní	cash crop
hrad	castle
katalýza	catalysis
katalyzátor	catalyst
automobilový katalyzátor	catalytic converter
katastrofa	catastrophe
výtěžek z oblasti rybolovné	catch yield
povodí	catchment
oblast spádová	catchment area
kategorie	category
kategorie ohrožených druhů	category of endangered species
kationt	cation
dobytek	cattle
karfiol ; květák	cauliflower
vztah příčina-následek	cause-effect relation
jeskyně	cave
celer	celery
celibát	celibacy
buňka ; buňka	cell ; cell
článek ; Galvanický článek	cell ; electrochemical cell ; energy cell ; Galvanic cell ; στοιχείο
celulóza	cellulose
průmysl celulózy	cellulose industry
cement	cement
průmysl cementárenský	cement industry
výroba cementu	cement manufacture
sčítání lidu	census survey
řízení centrální	central government
část parku centrální	central park area
centralizace	centralisation
odstřeďování	centrifugation
hlavonožec	cephalopod
keramika	ceramics
průmysl keramický	ceramics industry
cer	cerium
certifikát	certification
velryba ; velryba [Cetacea] ; Cetacea	cetacean
židle	chair
křída	chalk
změna hodnoty	change in value
tvorba kanálů	channelling
teorie chaosu	chaos theory
uhlí dřevěné	charcoal
schéma organizační	chart
mapa námořní	chart ; nautical chart
děkuji	cheers ; thank you ; thanks
Artropoda	chelicerate
chemikálie	chemical
chemická přísada	chemical addition
analýza chemická	chemical analysis
složení chemické	chemical composition
chemické znečištění	chemical contamination
korozivita v důsledku působení chemikálií	chemical corrosivity
dekontaminace chemická	chemical decontamination
prvek chemický	chemical element ; element
spad chemický	chemical fallout
hnojivo chemické	chemical fertiliser
chemikálie v životním prostředí	chemical in the environment
chemický průmysl	chemical industry
chemický provoz	chemical installation
měření znečištění chemické	chemical measurement of pollution
spotřeba kyslíku chemická	chemical oxygen demand
ochrana proti škůdcům chemická	chemical pest control
chemický závod	chemical plant
politika chemická	chemical policy
znečišťující chemická látka	chemical pollutant
chemické znečištění	chemical pollution
chemický proces	chemical process
chemický výrobek	chemical product
vlastnost chemická	chemical property
chemická reakce	chemical reaction
chemická redukce	chemical reduction
riziko chemické	chemical risk
struktura chemická	chemical structure
chemické zpracování	chemical treatment
odpady chemické	chemical waste
zbraň chemická	chemical weapon
zákon o chemikáliích	chemicals act
adsorpce chemická	chemisorption
lékárník	chemist ; pharmacist
chemie	chemistry
třešně	cherry
šachy	chess
kaštan	chestnut
dítě	child
komín	chimney
výška komínu	chimney height
šimpanz	chimpanzee
veverka	chipmunk
netopýři	chiropteran
chlorid	chloride
chlorovaný uhlovodík	chlorinated hydrocarbon
chlorace	chlorination
chlór	chlorine
chlorfenol	chlorophenol
chlorofyl	chlorophyll
chloróza	chlorosis
čokoláda	chocolate
cholesterol	cholesterol
strunatec	chordate
chorologie	chorology
analýza chromatografická	chromatographic analysis
chromatografie	chromatography
chrom	chromium
chromozom	chromosome
řasy žlutohnědé	chrysophyta
kostel	church
doutník	cigar
cigareta	cigarette
dílo kinematografické	cinematographic film
oběžník	circular mail
občan	citizen
vědomí občanské	citizen awareness
iniciativa občanská	citizen initiative
práva občanská	citizen rights
město	city
centrum města	city centre
civilní letecká doprava	civil air traffic
inženýrství stavební	civil engineering
právo občanské	civil law
civilní ochrana	civil safety
ochrana občanů	civilian protection
nárok na náhradu	claim for restitution
třídění	classification
jíl	clay
oblast s ovzduším čistým	clean air area
ekologické vozidlo	clean air car
čistá technologie	clean technology
rekultivace	cleaning up
čistota	cleanliness
služby komunální	cleansing department
kal z čištění	clearing sludge
útes	cliff
podnebí	climate
ochrana klimatu	climate protection
klimatický zdroj	climate resource
typ klimatu	climate type
změna klimatu	climatic alteration
klimatická změna	climatic change ; climate change
klimatický vliv	climatic effect
klimatický experiment	climatic experiment
podnební pásmo	climatic zone
klimatologie	climatology
klimax	climax
rostlina popínavá	climbing plant (wall) ; climbing plant
příznak klinický	clinical symptom
klonování	cloning
ukončení [činnosti] ; ukončení	closing down
uzavření podniku	closing down of firm
oděvy	clothing ; apparel
průmysl oděvní	clothing industry
oblak	cloud
spalování společné	co-incineration
spolupráce	co-operation
politika spolupráce	co-operation policy
princip spolupráce	co-operation principle
systém koordinační	co-ordinate system
koordinace	co-ordination
koagulace	coagulation
uhlí	coal
průmysl uhelný	coal industry
zkapalňování uhlí	coal liquefaction
těžba uhlí	coal mining
úprava uhlí	coal refining
technologie uhelná	coal technology
energie vyrobená z uhlí	coal-based energy
elektrárna uhelná	coal-fired power plant
pobřeží	coast
ochrana pobřeží	coast protection
zóna pobřežní	coastal area
vývoj pobřeží	coastal development
ekosystém pobřežní	coastal ecosystem
prostředí pobřežní	coastal environment
rybolov pobřežní	coastal fishing
znečištění pobřeží	coastal pollution
voda pobřežní	coastal water
plánování zóny pobřežní	coastal zone planning
pobřežní hlídka	coastguard
povrchová úprava	coating
kobalt	cobalt
pavucina	cobweb
kokain	cocaine
šváb	cockroach
zákoník	code
kodex	code of practice
kodifikace	codification
bezobratlí [Coelenterate] ; bezobratlí (Coelenterate) ; bezobratlí	coelenterate
káva	coffee
kogenerace	cogeneration
mince	coin ; money
koks	coke
zima	cold
bakterie koliformní	coliform bacterium
kopec	colina ; hill ; loma
společné čištění odpadních vod	collective wastewater treatment
koloid	colloid
stav koloidní	colloidal state
kolonizace	colonisation
barva ; barva ; barva	colour ; colour ; colo(u)r
kompozice barevná	colour composition
kolorimetrie	colourimetry
had rodu Colubridae	colubrid
účinek kombinovaný	combination effect
elektrárna kombinovaná	combined cycle-power station
jednotná kanalizační síť	combined sewer system
kombinovaná doprava	combined transport
vody odpadní kombinované	combined waste water
hořlavost	combustibility
motor spalovací	combustion engine
odpadní plyn	combustion gas
rezidua ze spalování	combustion residue
přijít	come
kometa	comet
rybářství komerční	commercial fishery
právo obchodní	commercial law
hluk z obchodní činnosti	commercial noise
doprava zboží	commercial traffic
obchodní jednání	commercial transaction
vozidlo pro přepravu zboží	commercial vehicle
komercializace	commercialisation
úmluva všeobecná	common agreement
politika zemědělská společná	common agricultural policy ; common agricultural policy of the EU
politika obchodní společná	common commercial policy
politika celní společná	common tariff policy
komunikace	communications
oblast sdělovací techniky	communications industry
politika v oblasti techniky sdělovací	communications policy
komunikační systém	communications system
komunismus	communism
zařízení veřejné	community facility ; public facility
princip "společnost platí"	community-pays principle
doprava do zaměstnání	commuter traffic
zhutňování	compaction
politika společnosti	company policy
struktura podniku	company structure
právo srovnávací	comparative law
test srovnávací	comparative test
srovnání	comparison
kompenzace	compensation
odškodnění	compensation for damage
opatření kompenzační	compensatory measure
kompenzační daň	compensatory tax
konkurence	competition
legislativa k soutěži hospodářské	competition law
řízení konkurzní	competitive examination
konkurenceschopnost	competitiveness
tvorba komplexu	complex formation
komplexotvorné činidlo	complexing agent
znečištění kombinované	composite pollution
složení obyvatelstva	composition of population
kompost	compost
odpady kompostovatelné	compostable waste
kompostování	composting
kompostování výrobcem	composting by producer
chemická sloučenina	compound ; chemical compound
komprese	compression
kompresor	compressor
koncentrace	concentration
koncepce prostředí životního	concept of environment
koncese	concession
beton	concrete
průmysl prvků betonových	concrete products industry
srážení	condensation (process) ; condensation
kondom	condom ; prophylactic ; rubber ; safe ; safety
vodivost	conductivity ; electrical conductivity
konference	conference
střet	conflict
střet cílů	conflict of aims
střet zájmů	conflict of interests
využití konfliktní	conflicting use
kongres	congress
jehličnan	conifer
les jehličnatý	coniferous forest
strom jehličnatý	coniferous tree
ochrana	conservation
památková péče	conservation of monuments
politika ochrany	conservation policy
uvažování	consideration
souhláska	consonant
souhvězdí	constellation
ústava	constitution
právo ústavní	constitutional law
stavební technika	construction equipment
stavební hluk	construction noise
politika stavební	construction policy
stavební technologie	construction technology
výstavba využívající recyklované materiály	construction with recycled material
stavební práce	construction work
poradenství	consultancy
konzultace	consultation
jíst	consume ; eat ; swallow
konzumní chování	consumer behaviour
zboží spotřební	consumer goods
skupina spotřebitelů	consumer group
informace pro spotřebitele	consumer information
výrobek spotřební	consumer product
ochrana spotřebitele	consumer protection
odpady spotřební	consumer waste
spotřeba	consumption
vzorec spotřeby	consumption pattern
obal	container
ochranný plášť jaderného reaktoru	containment (nuclear industry) ; containment
půda kontaminovaná	contaminated soil
kontaminace	contamination
kontinent	continent
podnebí kontinentální	continental climate
pevninský šelf	continental shelf
vzdělávání kontinuální	continuing education
zatížení trvalé	continuous load
obhospodařování půdy po vrstevnicích	contour farming
smlouva	contract
opatření regulační	control measure
spalování řízené	controlled burning
revír kontrolovaný	controlled hunting zone
orgán kontrolní	controlling authority
aglomerace městská	conurbation
úmluva	convention
energie konvenční	conventional energy
chlazení	cooling
chladicí olej	cooling oil
chladicí věž	cooling tower
voda chladicí	cooling water
měď	copper
mlází	coppice
les smíšený s mlázím	coppice with standards
korál	coral
útes korálový	coral reef
laguna v útesu korálovém	coral reef lagoon
roztavení jádra reaktoru	core meltdown
korek	cork
koridor	corridor
koroze	corrosion
inhibitor koroze	corrosion inhibitor
kosmetický průmysl	cosmetic industry
záření kosmické	cosmic radiation
kosmologie	cosmology
náklady	cost
zvýšení nákladů	cost increase
snížení nákladů	cost reduction
náklady a přínosy	cost-benefit
analýza nákladů a přínosů	cost-benefit analysis
bavlna	cotton
stát	country ; nation ; state
stavení venkovské	country lodge
okres	county
soud	court
dvůr soudní	court of justice
zátoka	cove
obal	covering ; roofing
kráva	cow
řemeslo	craft ; arts and crafts
kreativita	creativity ; inventiveness
úvěr	credit
pomoc úvěrová	credit assistance
politika úvěrová	credit policy
záliv	creek
zločin	crime
právo trestní	criminal law
řízení trestní	criminal law procedure
zodpovědnost trestná	criminal liability
kriminalita	criminality
štáb krizový	crisis management
hladina kritická	critical level
zatížení kritické	critical load
krokodýl	crocodile
sklízení úrody	crop production
ochrana sklizně	crop protection
rotace plodin	crop rotation
ošetření plodin	crop treatment
křižovatka	crossing place
přechod pro živočichy migrující	crossing place for animals
krucifix	crucifix
nafta surová	crude oil
plavba zábavní	cruising
korýš	crustacean
rostlina tajnosnubná	cryptogam
krystal	crystal
krystalizace	crystallisation
krystalografie	crystallography
okurka	cucumber
rostlina šlechtěná	cultivated plant
pěstování	cultivation ; tillage
metoda pěstební	cultivation method
kultivace půdy zemědělské	cultivation of agricultural land
systém kultivační	cultivation system
vývoj kulturní	cultural development
kulturní zařízení	cultural facility
dědictví kulturní	cultural heritage
indikátor kulturní	cultural indicator
politika kulturní	cultural policy
kultura	culture
curium	curium
měna	currency
plán učební	curriculum
clo	customs
předpis celní	customs regulation
sazebník celní	customs tariff
těžba dřeva	cutting
řízek [rozmnožování vegetativní] ; řízek	cutting ; cutting (vegetative propagation)
kyanat	cyanate
kyanid	cyanide
stezka cyklistická	cycle path
cyklón	cyclone
cytologie	cytology
cytotoxicita	cytotoxicity
farma mléčná	dairy farm
průmysl mlékárenský	dairy industry
výrobek mléčný	dairy product
přehrada	dam
systém pro vypouštění přehrady	dam draining
škoda	damage
odhad škody	damage assessment
škoda způsobená vojenskými manévry	damage from military manoeuvres
pojištění proti škodám	damage insurance
prevence škod	damage prevention
podběl	dandelion
analýza riziková	danger analysis
zboží nebezpečné	dangerous goods
zákon o zboží nebezpečném	dangerous goods law
předpis o manipulaci s látkami nebezpečnými	dangerous goods regulation
nebezpečné zařízení	dangerous installation
přeprava materiálů nebezpečných	dangerous materials transport
darmstadtium	darmstadtium
sběr dat	data acquisition
analýza dat	data analysis
nosič dat	data carrier
informační středisko	data centre
výměna dat	data exchange
informace o stavu životního prostředí	data on the state of the environment
zpracování dat	data processing
zákon o zpracování dat	data processing law
systém zpracování dat	data processing system
ochrana dat	data protection
zařízení pro záznam dat	data recording technique
databáze	database
stanovení epochy	dating
oslnit	dazzle
odstraňování tiskařských barev	de-inking
hluchý	deaf
trest smrti	death penalty ; capital punishment ; death sentence
dluh	debt
placení úroků z dluhu	debt service
produkt rozpadu	decay product
decentralizace	decentralisation
dechlorace	dechlorination
decibel	decibel
les listnatý	deciduous forest ; deciduous wood
strom listnatý	deciduous tree
rozhodnutí	decision
podpora rozhodování	decision making support
proces rozhodovací	decision process
systém podporování rozhodnutí	decision-support system
deklarace	declaration ; statement
prohlášení o využití majetku soukromého v zájmu veřejnosti	declaration of public utility
rozklad	decomposition
dekontaminace	decontamination
nařízení	decree
moře volné	deep sea
rybolov na moři volném	deep sea fishing
těžba na moři volném	deep sea mining
ukládání odpadu v moři volném	deep-sea disposal
zvěř vysoká	deer
obhajoba	defence
deflace	deflation
odlistění	defoliation
odlesňování	deforestation
odbouratelnost	degradability
degradace	degradation
ničení zdrojů přírodních	degradation of natural resources
znehodnocení prostředí životního	degradation of the environment
produkt rozkladu	degradation product
odmašťování	degreasing
kal odvodněný	dehydrated sludge
pravomoc delegovaná	delegated management
porodit	deliver
delta	delta
poptávka	demand
voda na pozemku veřejném	demesnial water
demokracie	democracy
vývoj demografický	demographic development
evoluce demografická	demographic evolution
demografie	demography
demolice	demolition business
odpady z demolic	demolition waste
prokazatelnost	demonstrability
dendrochronologie	dendrochronology ; tree-ring dating
dendrometrie	dendrometry
denitrifikace	denitrification
denitrifikace odpadního plynu	denitrification of waste gas
hustota	density
zubní lékař	dentist
stomatologie	dentistry
spad	deposition
deregulace	deregulation
dermatologie	dermatology
odsolování	desalination
zařízení odsolovací	desalination plant
poušť	desert
podnebí pouštní	desert climate
kobylka stěhovavá	desert locust
desertifikace	desertification
regulace desertifikace	desertification control
projekce	design (project) ; design ; project design
studie teoretická	desk study
desorpce	desorption
místo určení při dopravě	destination of transport
odsiřování	desulphurisation
odsiřování paliv	desulphurisation of fuel
detekce	detection
detektor	detector
povrchově aktivní látka	detergent
způsob stanovení	determination method
odstrašování	deterrence
prostředek odstrašující	deterrent
detoxifikace	detoxification
deuterium	deuterium
země vyspělá	developed country
země rozvojové	developing country
pomoc zemím rozvojovým	development aid
oblast rozvoje	development area
spolupráce rozvojová	development co-operation
model vývoje	development model
model vývoje společnosti	development pattern
projekt územní	development plan
postoupení pravomoci	devolution
dialýza	dialysis
prùjem	diarrhea
deník	diary
rozsivka	diatom
kostka	dice ; die ; die ; die
slovník	dictionary
didaktika	didactics
motor naftový	diesel engine
nafta motorová	diesel fuel ; diesel
diferenciace	differentiation
obtížný	difficult
znečištění rozptýlené	diffuse pollution
zdroj znečištění rozptýlený	diffuse source
rozptyl	diffusion
kal vyhnilý	digested sludge
vyhnívací nádrž	digester
trávení	digestion
vyhnívání kalu	digestion
technika zpracování digitálního obrazu	digital image processing technique
model územní digitální	digital land model
digitalizace	digitising
kyselina zředěná	diluted acid
dioxin	dioxin
hmyz dvoukřídlý	dipteran
přímý znečišťovatel	direct discharger
směrnice	directive
osoba postižená tělesně	disabled person
katastrofa	disaster
akce na vyčištění oblasti postižené katastrofou	disaster cleanup operation
plán postupu při nepředvídaných katastrofách	disaster contingency plan
orgán k řešení situace v případě katastrofy	disaster control service
připravenost na katastrofu	disaster preparedness
prevence katastrofy	disaster prevention
pomoc obětem neštěstí	disaster relief
oblast postižená katastrofou	disaster zone
režim vypouštění	discharge regime
diskriminace	discrimination
nemoc	disease ; illness ; affliction
příčina onemocnění	disease cause
dezinfekční přípravek	disinfectant
dezinfekce	disinfection
průvodka	dispatch note
rozptyl	dispersion
výpočet rozptylu	dispersion calculation
utečenec	displaced person
služba pohřební	disposal of the dead
zneškodňování bojových prostředků	disposal of warfare materials
rozpouštění	dissolution
rozpuštěný organický uhlík	dissolved organic carbon
kyslík rozpuštěný	dissolved oxygen
destilace	distillation
narušení soutěže hospodářské	distortion of competition
prodej	distribution
území osídlené	distribution area
distribuce zboží	distributive trade
vytápění dálkové	district heating
teplárna centrální	district heating plant
prostor vojenský bývalý	disused military site
příkop	ditch
dělení	division
rozvod	divorce
doktrína	doctrine
dokument	document
půjčování dokumentů	document lending
typ dokumentu	document type
film dokumentární	documentary film
dokumentační systém	documentary system
dokumentace	documentation
dokumentační středisko	documentation centre
pes	dog
panenka	doll
delfín	dolphin
domácí spotřebič	domestic appliance
palivo pro domácnosti	domestic fuel
olej topný	domestic fuel oil
hluk z domácností	domestic noise
znečištění z domácností	domestic pollution
obchod tuzemský	domestic trade
odpady domovní	domestic waste
skládka odpadů domovních	domestic waste landfill
vody odpadní domovní	domestic waste water
zvíře domestikované	domesticated animal
dar	donation
dveře	door
dávkování	dosage
dávka	dose
vztah dávka-účinek	dose-effect relationship
návrh legislativní	draft legislation
vážka	dragonfly
odvodňování	drainage
systém odvodňovací	drainage system
odtok povrchový	drainage water
odvodňování	draining
zvíře tažné	draught animal
materiál vybagrovaný	dredged material
bagrování	dredging
lov ryb do sítí tenatových	drift net fishing
vrtání	drilling
vrt ropný	drilling for oil
vrtací souprava	drilling installation
pít	drink ; gulp ; quaff ; sip
voda pitná	drinking water
pásmo ochranné zdroje vody pitné	drinking water protection area
zásobování vodou pitnou	drinking water supply
úprava vody pitné	drinking water treatment
dromedár	dromedary
sucho	drought
opatření v období sucha	drought control
lék	drug
bicí	drum kit
čištění chemické	dry cleaning
nánosy	dry deposition
hospodaření bezzávlahové	dry farming
trávník suchý	dry lawn
sušení	drying
vysoušení	drying out
duální ekonomika	dual economy
duální odpadové hospodářství	dual waste management
dubnium	dubnium
kachna	duck
nìmý	dumb
skládkování	dumping
duna	dune
zboží trvanlivé	durable goods
délka záření slunečního	duration of sunshine
prach	dust
odstraňování prachu	dust removal
obydlí	dwelling
barva	dye
hráz	dyke
zpevnění hráze	dyke reinforcement
dyslexie	dyslexia
dysprosium	dysprosium
ucho	ear
brzký	early
systém včasné výstrahy	early warning system
Země	earth ; Earth ; the world ; Blue Planet
vědy o Zemi	earth science
zemská kůra	earth's crust ; crust ; Earth's crust
zemětřesení	earthquake
žížala	earthworm
škvor	earwig
právo průchodu přes majetek cizí	easement
jísti	eat
ostnokožec	echinoderm
ekologický pediatrie	eco-paediatrics
katastrofa ekologická	ecocatastrophe
rozvoj ekologický	ecodevelopment
značka ekologická	ecolabel
značení ekologické	ecolabelling
četnost výskytu v přírodě	ecological abundance
adaptace ekologická	ecological adaptation
ekologické hodnocení	ecological assessment
ekologická rovnováha	ecological balance
ekologické účetnictví	ecological bookkeeping
ekologická únosnost	ecological carrying capacity
společenství ekologické	ecological community
ekologický faktor	ecological factor
nerovnost ekologická	ecological inequality
ekologická nika	ecological niche
ekologický parametr	ecological parameter
ekologická inventarizace	ecological stocktaking
oblast citlivá ekologicky	ecologically sensitive area
hnutí ekologické	ecologist movement
ekologie	ecology
ekologický trh	ecomarketing
muzeum přírodovědné	ecomuseum
hospodářská činnost	economic activity
ekonomická analýza	economic analysis
konkurence ekonomická	economic competition
koncentrace ekonomická	economic concentration
ekonomické údaje	economic data
ekonomický rozvoj	economic development
ekonomická předpověď	economic forecasting
geografie ekonomická ; ekonomická geografie	economic geography
ekonomický růst	economic growth
ekonomický stimul	economic incentive
ekonomický nástroj	economic instrument
nástroj ekonomického řízení	economic management instrument
ekonomický plán	economic plan
plánování ekonomické	economic planning
ekonomická politika	economic policy
region ekonomický	economic region
práva hospodářská	economic rights
ekonomie	economic science ; economics
hospodářský sektor	economic sector
ekonomická situace	economic situation
ekonomická struktura	economic structure
ekonomická podpora	economic support
ekonomický systém	economic system
teorie ekonomická	economic theory
ekonomický trend	economic trend
ekonomická realizovatelnost	economic viability
ekonomicko-ekologická efektivnost	economical-ecological efficiency
ekonomika	economy
fyziologie ekologická	ecophysiology
ekosystém	ecosystem
analýza ekosystému	ecosystem analysis
zhoršení ekosystému	ecosystem degradation
výzkum ekosystémů	ecosystem research
typ ekosystému	ecosystem type
turistika ekologická	ecotourism
ekotoxicita	ecotoxicity
ekotoxikologické vyhodnocení	ecotoxicological evaluation
ekotoxikologie	ecotoxicology
ekotyp	ecotype
ekoregion	ecozone
edafologie	edaphology
jedlý	edible
tuk jedlý	edible fat
vzdělávání	education
politika v oblasti vzdělávání	education policy
instituce vzdělávací	educational institution
stezka naučná	educational path
plánování vzdělávací	educational planning
systém vzdělávací	educational system
vliv	effect
vliv na zdraví	effect on health
vliv na člověka	effect on man
dopad na životní prostředí ; vliv na prostředí životní	effect on the environment ; environmental consequence
kritérium účinnosti	efficiency criterion
rozsah účinnosti	efficiency level
splašky	effluent
úsilí	effort ; exertion
vejce	egg
einsteinium	einsteinium
elasticita	elasticity
loket	elbow
bez	elder ; elderberry
osoba starší	elderly person
baterie elektrická	electric battery
vedení elektrické	electric line ; power line
výkon elektrický	electric power
elektrárna	electric power plant
zásobování energií elektrickou	electric power supply
vozidlo elektrické	electric vehicle
elektrotechnika	electrical engineering
průmysl elektromateriálu	electrical goods industry
průmysl elektrárenský	electrical industry
elektřina	electricity
společnost elektrárenská	electricity company
spotřeba elektřiny	electricity consumption
výroba elektřiny	electricity generation
náklady na výrobu elektřiny	electricity generation cost
odvětví pro dodávku a rozvod elektřiny	electricity supply industry
elektrokinetika	electrokinetics
elektrolýza	electrolysis
elektřina a magnetismus	electromagnetism
síť informační elektronická	electronic information network
pošta elektronická	electronic mail ; email ; e-mail
elektronický materiál	electronic material
odpady elektronické	electronic scrap
předpis o odpadech elektronických	electronic scrap regulation
elektronika	electronics
elektrosmog	electrosmog
elektrotechnické zařízení	electrotechnical equipment
průmysl elektrotechnický	electrotechnical industry
prvky skupiny 0	element of group 0 ; noble gas
prvky skupiny II [kovy zemin alkalických] ; prvky skupiny II	element of group II (alkaline earth metals) ; alkaline earth metal ; element of group II
prvky skupiny III	element of group III
prvky skupiny IV	element of group IV
prvky skupiny V	element of group V
prvky skupiny VI	element of group VI
prvky skupiny VII	element of group VII ; halogen
emancipace	emancipation
embryo	embryo
embryogenéza	embryogenesis
legislativa k řešení událostí mimořádných	emergency law
plán pro stav nouze	emergency plan
pomoc v nouzi	emergency relief
přístřeší nouzové	emergency shelter
emise	emission
kontrola emisí	emission control
emisní data	emission data
faktor emisní	emission factor
předpověď emisí	emission forecast
snižování emisí	emission reduction
bankovnictví pro snižování emisí	emission reduction banking
registr znečištění emisemi	emission register
situace emisní	emission situation
zdroj emisí	emission source
norma emisní	emission standard
emise znečišťující vodu	emission to water
zaměstnání	employment
povolání	employment ; employment ; job ; job ; occupation ; work ; work
zaměstnání a prostředí životní	employment and environment
vliv na zaměstnanost	employment level effect
struktura zaměstnanosti	employment structure
emulgace	emulsification
emulze	emulsion
zapouzdření	encapsulation
encyklopedie	encyclopaedia
technologie předčištění vod odpadních před vypouštěním	end-of-pipe technology
druhy ohrožené živočišné	endangered animal species
druhy ohrožené rostlinné	endangered plant species
druhy endemické	endemic species
endokrinní systém	endocrine system
endokrinologie	endocrinology
nepřítel	enemy
energie	energy
energetická bilance	energy balance
spotřeba energie	energy consumption
přeměna energie	energy conversion
potřeba energie	energy demand
ztráta energie	energy dissipation
systém rozvodu energetického	energy distribution system
ekonomika energetiky	energy economics
účinnost energetická	energy efficiency
průmysl energetický	energy industry
legislativa energetická	energy legislation
hospodaření s energií	energy management
trh s energiemi	energy market
politika energetická	energy policy
proces energetický	energy process
výroba energie	energy production
zdroj energie	energy resource
úspora energie	energy saving
zdroj energie	energy source
suroviny energetické	energy source material
akumulace energie	energy storage
zásobování energiemi	energy supply
technologie energetická	energy technology
druh energie	energy type
využití energie	energy utilisation ; energy use
vymáhání práva	enforcement
motor	engine
inženýrství	engineering
strojírenský závod	engineering work
dobrou chuť	enjoy your meal ; have a nice meal
politika rozšiřování	enlargement policy
program rozšíření	enlargement programme
uran obohacený	enriched uranium
obohacování	enrichment
enterovirus	enterovirus
podnikatel	entrepreneur
prostředí životní	environment
příznivý pro prostředí životní	environment friendly
environmentální trh	environment market
havárie ekologická	environmental accident
ekologické účetnictví	environmental accounting
agentura pro ochranu prostředí životního	environmental administration institution
analýza životního prostředí	environmental analysis
napětí pro prostředí životní	environmental anxiety
ekologický aspekt lidských sídel	environmental aspect of human settlements
hodnocení životního prostředí	environmental assessment
kritérium hodnocení životního prostředí	environmental assessment criterion
environmentální audit	environmental auditing
vědomí odpovědnosti za prostředí životní	environmental awareness
změna prostředí životního	environmental change
legislativa k chemikáliím v prostředí životním	environmental chemicals legislation
chemie životního prostředí	environmental chemistry
práva a povinnosti občanů v oblasti prostředí životního	environmental citizenship
slučitelnost s životním prostředím	environmental compatibility
dopad na životní prostředí	environmental consequence
ochrana životního prostředí	environmental conservation
plán pro stav ohrožení životního prostředí	environmental contingency planning
péče o prostředí životní	environmental control
náklady na prostředí životní	environmental cost
čin trestný proti prostředí životnímu	environmental crime
právo trestné pro ochranu prostředí životního	environmental criminal law
kriminalita ekologická	environmental criminality
kritérium životního prostředí	environmental criterion
kultura environmentální	environmental culture
škoda ekologická	environmental damage
data z oblasti životního prostředí	environmental data
rozvoj prostředí životního	environmental development
vymáhání práva životního prostředí	environmental economic valuation
ekonomika prostředí životního	environmental economics
ekonomika podniků v oblasti životního prostředí	environmental economics of firms
problematika ekonomiky životního prostředí	environmental economy issue
výchova ekologická	environmental education
inženýrství environmentální	environmental engineering
ekologický podnik	environmental enterprise
etika prostředí životního	environmental ethics
zneškodňování příznivé pro životní prostředí	environmental friendly procurement
fond životního prostředí	environmental fund
nebezpečí pro prostředí životní	environmental hazard
hygiena prostředí životního	environmental health
riziko pro hygienu životního prostředí	environmental health hazard
posuzování vlivů na hygienu prostředí životního	environmental health impact assessment
ochrana hygieny prostředí životního	environmental health protection
historie životního prostředí	environmental history
vliv na prostředí životní	environmental impact
vliv zemědělství na prostředí životní	environmental impact of agriculture
vliv chovu ryb na prostředí životní	environmental impact of aquaculture
vliv energetiky na prostředí životní	environmental impact of energy
vliv rybolovu na prostředí životní	environmental impact of fishing
vliv lesnictví na prostředí životní	environmental impact of forestry
vliv domácností na prostředí životní	environmental impact of households
vliv průmyslu na prostředí	environmental impact of industry
vliv rekreace na prostředí životní	environmental impact of recreation
vliv turistiky na prostředí životní	environmental impact of tourism
vliv dopravy na prostředí životní	environmental impact of transport
analýza vlivů na prostředí životní	environmental impact statement
studie vlivů na prostředí životní	environmental impact study
ekonomický stimul	environmental incentive
index environmentální	environmental index
indikátor prostředí životního	environmental indicator
ekologický průmysl	environmental industry
informatika o prostředí životním	environmental informatics
informace o životním prostředí	environmental information
síť informací o prostředí životním	environmental information network
informační systém o životním prostředí	environmental information system
investice na ochranu životního prostředí	environmental investment
právo prostředí životního	environmental law
vymáhání práva životního prostředí	environmental law enforcement
legislativa ekologická	environmental legislation
legislativa ekologická k zemědělství	environmental legislation on agriculture
proces ekologický legislativní	environmental legislative process
odpovědnost za poškození prostředí životního	environmental liability
licence v oblasti prostředí životního	environmental licence
environmentální management	environmental management
environmentální lékařství	environmental medicine
zneužívání pravomoci v oblasti prostředí životního	environmental misconduct
monitorování životního prostředí	environmental monitoring
hluk v životním prostředí	environmental noise
povolání v oblasti životního prostředí	environmental occupation
vnímání ekologické	environmental perception
plán prostředí životního	environmental plan
plánování prostředí životního	environmental planning
ekologická politika	environmental policy
nástroj politiky ekologické	environmental policy instrument
znečištění prostředí životního	environmental pollution
priorita v oblasti prostředí životního	environmental priority
řešení problémů v oblasti prostředí životního	environmental problem solving
program ochrany prostředí životního	environmental programme
ochrana životního prostředí	environmental protection
agentura pro ochranu prostředí životního	environmental protection agency
sdružení pro ochranu prostředí životního	environmental protection association
náklady na ochranu prostředí životního	environmental protection cost
ochrana životního prostředí v podniku	environmental protection in the enterprise
nařízení pro ochranu prostředí životního	environmental protection order
organizace pro ochranu prostředí životního	environmental protection organisation
směrnice na ochranu prostředí životního	environmental protection regulation
technologie na ochranu životního prostředí	environmental protection technology
environmentální psychologie	environmental psychology
kvalita životního prostředí	environmental quality
kritérium kvality životního prostředí	environmental quality criterion
cíl kvality životního prostředí	environmental quality objective
norma kvality prostředí životního	environmental quality standard
správa o životním prostředí	environmental report
výzkum životního prostředí	environmental research
riziko ekologické	environmental risk
hodnocení ekologických rizik	environmental risk assessment
nauka o životním prostředí	environmental science
ekologická bezpečnost	environmental security
banka vzorků životního prostředí	environmental specimen bank
ekologický audit	environmental statement (eco-audit) ; environmental statement ; eco-audit
statistika prostředí životního	environmental statistics
burza ekologických komodit	environmental stock exchange
ekologická studie	environmental study
dotace na ochranu životního prostředí	environmental subsidy
architektura udržitelná ekologicky	environmental sustainable architecture
zelená daň	environmental tax
výuka ekologická	environmental teaching
ekologická technologie	environmental technology
terminologie v oblasti prostředí životního	environmental terminology
vzdělávání ekologické	environmental training
ekologický boj	environmental warfare
environmentalistika [ekologie] ; environmentalistika (ekologie)	environmentalism
látka nebezpečná pro prostředí životní	environmentally dangerous substance
environmentální management	environmentally friendly management
výrobek příznivý pro prostředí životní	environmentally friendly product
choroba v důsledku znečištění životního prostředí	environmentally related disease
ekologické chování	environmentally responsible behaviour
podnik neekologický	environmentally unfriendly firm
enzym	enzyme
epicentrum	epicentre
epidemie	epidemic
epidemiologie	epidemiology
epigram	epigram
epilepsie	epilepsy
rovnice	equation
rovník	equator
podnebí rovníkové	equatorial climate
koně [Equidae] ; koně (Equidae)	equine
vybavení	equipment
dávka ekvivalentní	equivalent dose
erbium	erbium
ergonomie	ergonomics
eroze	erosion
ochrana protierozní	erosion control
pronájem nemovitosti	estate rental
biologie v ústí řeky	estuarine biology
oblast v ústí řeky chráněná	estuarine conservation area
ústí řeky	estuary
znečištění v ústí řeky	estuary pollution
leptání	etching
leptací látka	etching substance
etanol	ethanol
éter	ether
etika	ethics
etnografie	ethnography
etnologie	ethnology
etologie	ethology
europium	europium
eutrofizace	eutrophication
vyhodnocení	evaluation
kritérium hodnocení	evaluation criterion
metoda hodnocení	evaluation method
hodnocení technologie	evaluation of technology
výpar	evaporation
evapotranspirace	evapotranspiration
evoluce	evolution
exaktní vědy	exact science
jáma vyhloubená	excavated hole
proces hloubení	excavation (process) ; excavation ; earthworks ; digging
halda vyhloubeného materiálu	excavation heap
svah výkopu	excavation side
místo hloubení	excavation site
mimořádná daň	exceptional tax
výška komína nadměrná	excessive height of chimney stacks
politika obchodní	exchange policy
popravèí	executioner
nařízení vládní	executive order
zařízení k odvádění odpadních látek	exhaust device
výfukový plyn	exhaust gas
výstava	exhibit
existující chemikálie	existing chemical
druhy exotické	exotic species
náklady	expenditure
experiment	experiment
studie experimentální	experimental study
systém expertní	expert system
explicitní	explicit
odběr vody podzemní	exploitation of underground water
geologický průzkum	exploration
exploze	explosion
výbušná látka	explosive
vývoz	export
povolení vývozní	export licence
vývoz odpadů nebezpečných	export of hazardous wastes
vystavení	exposure
znárodnění	expropriation
extenzivní chov dobytka	extensive cattle farming
externalita	externality
vyhynulé druhy	extinct species
vyhynutí	extinction (ecological) ; extinction
těžba	extraction
průmysl těžební	extractive industry
oko	eye
obočí	eyebrow
tkanina	fabric
vybavení	facility
faktory tržní	factor market
velkochov	factory farming
bakterie fekální	faecal bacterium
spad	fallout
oblast půdy neobdělávané	fallow area
rodina	family
právo rodinné	family law
rodičovství plánované	family planning
hladomor	famine
farma	farm
zvíře hospodářské	farm animal
zemědělská budova	farm building
zemědělská cena	farm price
praxe zemědělská	farming technique
reaktor rychlý	fast reactor
rychlá doprava	fast traffic
otec	father
zlom	fault
fauna	fauna
obnova fauny	fauna restoration
úřad federální	federal authority
vláda federální	federal government
právo federální	federal law
poplatek	fee
krmení zvířat	feeding of animals
cit pro přírodu	feeling for nature
šelma kočkovitá	felid
žena	female ; woman
slatina	fen
fermentace	fermentation
fermium	fermium
kapradina	fern
přívoz	ferry
oplodnění	fertilisation ; fecundation
hnojivo	fertiliser
zákon o hnojivech	fertiliser law
vlákno	fibre
skleněné vlákno	fibreglass
pole	field ; land ; land ; acre ; patch
škoda na poli	field damage
experiment v terénu	field experiment
průzkum v terénu	field study
plnivo	filling material
stanice čerpací hmot pohonných	filling station
film	film
filtr	filter
koláč filtrační	filter cake
filtrace	filtration
uskladnění konečné	final storage
prostředky finanční	finances
pomoc finanční	financial aid
podpora finanční	financial assistance
náhrada finanční	financial compensation
příspěvek finanční	financial contribution
fond finanční	financial fund
nástroj finanční	financial instrument
právo finanční	financial law
řízení finanční	financial management
trh finanční	financial market
financování	financing
pokuta	fine
prach jemný	fine dust
prst ; prst	finger
požár	fire
prevence proti požáru	fire precaution
ochrana proti požáru	fire protection
předpisy protipožární	fire safety requirement
ochrana proti požáru	fire service
ohnivzdorná látka	fireproofing agent
vypalování	firing
firma	firm ; corporation ; enterprise ; company ; venture
první	first
ryba	fish
choroba ryb	fish disease
chov ryb	fish farming
úhyn ryb	fish kill
zásoby ryb	fish stock
toxicita ryb	fish toxicity
řízení rybolovu a zpracování ryb	fisheries management
struktura rybářství	fisheries structure
rybářství	fishery
ekonomika rybářství	fishery economics
politika rybářská	fishery policy
zdroj ryb	fishery resource
chytání ryb	fishing
oblast rybolovná	fishing ground
průmysl rybářský	fishing industry
právo rybářské	fishing law
lístek rybářský	fishing licence
rezervace rybářská	fishing preserve
loď rybářská	fishing vessel
potrubní armatura	fitting (plumbing) ; fitting ; plumbing equipment ; plumbing fixtures
registrace pod vlajkou cizí	flag of convenience
hořlavina	flammable product
dodatečné spalování	flaring
koření	flavouring
blecha	flea
přístup k ochraně prostředí životního flexibilní	flexible approach to environmental protection
flokulant	flocculant
flokuace	flocculation
povodeň	flood
ochrana před povodněmi	flood control
předpověď povodní	flood forecast
ochrana před povodněmi	flood protection
odtok povrchový při povodni	flood runoff
záplava	flooding
flóra	flora (biology) ; flora
atlas rostlin	flora (document) ; flora
obnova flóry	flora restoration
flotace	flotation
průtok	flow
proudění	flow field
květina	flower ; bloom ; blossom
rostlina kvetoucí	flowering plant
voda tekoucí	flowing water
spaliny	flue gas
fluidika	fluidics
fluidizace	fluidisation
lože fluidizované	fluidised bed
fluorizace	fluoridation
fluór	fluorine
vyplavování	flushing
zdroj říční	fluvial resource
popílek polétavý	fly ash
pěnotvorné prostředky	foaming agent
píce	fodder ; provender ; forage
pícnina	fodder plant
mlha	fog
listoví	foliage
tradice lidová	folk tradition
folklór	folklore
potrava	food
přísada do potravin	food additive
řetězec potravní	food chain
obchodování s potravinami	food commerce
kontaminace potravin	food contamination
hygiena potravin	food hygiene
průmysl potravinářský	food industry
ozařování potravin	food irradiation
látka znečišťující potraviny	food pollutant
konzervace potravin	food preservation
průmysl potravinářský zpracovatelský	food processing industry
produkce potravin [zemědělství] ; produkce potravin (zemědělství) ; produkce potravin	food production (agriculture) ; food production
kvalita potravin	food quality
potřeba potravin	food requirement
nauka o výživě	food science
skladování potravin	food storage
technologie potravinářská	food technology
přeprava potravin	food transport
potraviny	foodstuff
chodidlo	foot
fotbal	football
stezka	footpath
kontaminace krmiv	forage contamination
plodina krmná	forage crop
zákon o krmivech	forage law
brod	ford
předpověď	forecast
prekluze	foreclosure
mezinárodní ekonomické vztahy	foreign economic relations
politika zahraniční	foreign policy
zahraniční obchod	foreign trade
les	forest
rezervace lesní biologická	forest biological reserve
poškození porostu lesního	forest cover destruction
poškození lesa	forest damage
zhoršení kvality lesů	forest deterioration
ekologie lesa	forest ecology
ekosystém lesní	forest ecosystem
těžba dřeva	forest exploitation
požár lesní	forest fire
odvětví lesní a dřevozpracující	forest industry
hospodářství lesní	forest management
škůdce lesní	forest pest
politika lesnická	forest policy
lesní produkt	forest product
lesnická produkce	forest production
ochrana lesa	forest protection
rezervace lesní	forest reserve
lesní zdroj	forest resource
lesnictví	forestry
ekonomika lesnictví	forestry economics
zákon o lesích	forestry law
legislativa lesnická	forestry legislation
praxe lesnická	forestry practice
pracovníci lesní	forestry unit
forma vlády	form of government
dopravce	forwarding agent
fosilie ; zkamenělina	fossil
fosilní palivo	fossil fuel
nárůsty živočichů mořských	fouling growth
fontána	fountain
motor čtyřtaktní	four stroke engine
fraktura	fracture
legislativa rámcová	framework legislation
francium	francium
podvod	fraud
pohyb kapitálu volný	free movement of capital
obchod volný	free trade
svoboda	freedom
svoboda	freedom ; liberty
svoboda projevu	freedom of speech ; freedom of speech
nákladní doprava	freight transport
freon	freon
voda sladká	freshwater
zhoršení kvality vody sladké	freshwater degradation
ekosystém sladkovodní	freshwater ecosystem
organismus sladkovodní	freshwater organism
znečištění vody sladké	freshwater pollution
zdroj vody sladké	freshwater resource
žába	frog
mráz	frost
ovoce	fruit
pěstování ovoce	fruit cultivation
strom ovocný	fruit tree
palivo	fuel
přísada do paliva	fuel additive
topný alkohol	fuel alcohol
palivový článek	fuel cell
složení paliva	fuel composition
spotřeba paliva	fuel consumption
olej topný	fuel oil
nádrž palivová	fuel tank installation
palivové dřevo	fuel wood
pln	full
kouř	fume
vykuřování	fumigation
látka funkční	functional substance
fungicid	fungicide
houba	fungus
kožešina	fur
zvíře kožešinové	fur animal
furan	furan
pec	furnace
nábytek	furniture
průmysl nábytkářský	furniture industry
kožešnictví	furriery
gadolinium	gadolinium
žlučník	gallbladder
pták hrabavý	gallinacean
gallium	gallium
galvanizace	galvanisation
hra	game
zvěř lovná	game
záření gama	gamma radiation
gangréna	gangrene
zahrada	garden
odpady zahradní	garden waste
zahradník	gardener
plyn	gas
chromatografie plynová	gas chromatography
společnost plynárenská	gas company
motor plynový	gas engine
zkapalňování plynů	gas liquefaction
směs plynů	gas mixture
síť plynárenská	gas network
plynovod	gas pipeline
elektrárna plynová	gas powered plant
čištění plynu	gas purification
zásobník plynu	gas reservoir
zásobování plynem	gas supply
plynná látka znečišťující ovzduší	gaseous air pollutant
stav plynný	gaseous state
zplyňování	gasification
směs palivová	gasohol
motor benzinová	gasoline engine
trávicí soustava	gastrointestinal tract ; alimentary canal
měkkýši rodu Gastropoda	gastropod
plynárna	gaswork
gen	gene
genealogie	genealogy
nařízení obecné orgánů správních	general administrative order
obecná chemie	general chemistry
vzdělání obecné	general education
genetická diverzita	genetic diversity
genetický vliv	genetic effect
inženýrství genetické	genetic engineering
legislativa k inženýrství genetickému	genetic engineering legislation
informace genetická	genetic information
modifikace genetická	genetic modification
genofond	genetic pool ; gene pool
genový zdroj	genetic resource
genetická odchylka	genetic variation
geneticky modifikovaný organizmus	genetically modified organism
genetika	genetics
genocida	genocide
genom	genome
genotoxicita	genotoxicity
genotyp	genotype
georeferenční údaje	geo-referenced data
georeferenční informace	geo-referenced information
geodézie	geodesy
faktor geogenní	geogenic factor
geografický informační systém	geographic information system
rozložení obyvatelstva geografické	geographical distribution of population
projekce geografická	geographical projection
geografie	geography
katastrofa geologická	geological disaster
proces geologický	geological process
geologie	geology
geometrická korekce	geometric correction
proces geomorfologický	geomorphic process
geomorfologie	geomorphology
prostředí geofyzikální	geophysical environment
geofyzika	geophysics
geotechnika	geotechnics
geotechnologie	geotechnology
energie geotermální	geothermal energy
zárodek	germ
plazma zárodečná	germ plasm
germanium	germanium
klíčení	germination
gejzír	geyser
žirafa	giraffe
děvče ; dívka	girl
ledovec	glacier
glaciologie	glaciology
žláza	gland
sklo	glass
průmysl sklářský	glass industry
brýle	glasses ; spectacles
námraza	glaze
globální aspekt	global aspect
úmluva globální	global convention
globální model	global model
globální oteplování	global warming
glosář	glossary
klih	glue
glykolýza	glycolysis
cíl individuálních ekonomických aktivit	goal of individual economic business
zlato	gold
golf	golf
kapavka	gonorrhea
řízení správné	good management
zboží	goods
zboží a služby	goods and services
husa	goose
gorila	gorilla
vláda	government (cabinet)
orgán vládní poradní	government advisory body
vládní budova	government building
odpovědnost vládní	government liability
politika vládní	government policy
obilí	grain
obilnina	graminaceous plant
gramatika	grammer ; grammar
žula	granite
granulometrie	granulometry
tráva	grass
vypalování trávy	grass fire
saranče	grasshopper
porost travní	grassland
štěrkopísek	gravel
těžba štěrkopísku	gravel extraction
štěrkovna	gravel pit
graviton	graviton
pastvina	grazing
dům ekologický	green building
koridor ekologický	green corridor
hnojivo zelené	green manure
revoluce zelená	green revolution
prostor pro zeleň	green space
plankton zelený	green tide
zelenina listová	green vegetable
pěstování ve skleníku	greenhouse cultivation
skleníkový efekt	greenhouse effect
skleníkový plyn	greenhouse gas
souřadnice zeměpisné	gridding
mletí	grinding
produkt hrubý národní	gross national product
voda podzemní	groundwater
ohrožení vod podzemních	groundwater endangering
jímání vody podzemní	groundwater extraction
znečištění vody podzemní	groundwater pollution
ochrana vody podzemní	groundwater protection
kvalita vody podzemní	groundwater quality
skupinové chování	group behaviour
gilotina ; gilotina ; gilotina	guillotine ; guillotine ; guillotine
morče domácí	guinea pig
záliv	gulf
racek	gull
rostlina nahosemenná	gymnosperm
sádra	gypsum
stanoviště	habitat
zničení biotopu	habitat destruction
hematologie	haematology
hafnium	hafnium
haiku	haiku
krupobití	hail
srst	hair
kadeřník	hairdresser ; barber
poločas rozpadu	half-life
haloform	haloform
halogenovaný bifenyl	halogenated biphenyl
halogenovaná sloučenina	halogenated compound
halogenovaný uhlovodík	halogenated hydrocarbon
fenol halogenovaný	halogenated phenol
halogenovaná znečišťující látka	halogenated pollutant
řemeslo umělecké	handicraft
výroba rukodělná	handicraft business
kapesník	handkerchief
přístav	harbour
pevný disk	hard disk drive ; hard disk ; HD
odpady obtížně zneškodnitelné	hard-to-dispose-of waste
tvrdost	hardness
harém	harem
harmonizace předpisů právních	harmonisation of law
sklizeň	harvest
hassium	hassium
nenávist	hate ; hatred
riziko	hazard
oblast riziková	hazard area
riziko ze znečišťujících látek	hazard of pollutants
vývoz chemikálií nebezpečných	hazardous chemical export
látka nebezpečná	hazardous substance
legislativa k látkám nebezpečným	hazardous substances legislation
odpady nebezpečné	hazardous waste
skládka odpadů nebezpečných	hazardous waste dump
materiál provozní rizikový	hazardous working material
opar mlžný	haze
hlava	head
mys	headland
souvrať	headland
zdraví	health
zdravotní péče	health care
zdravotnické povolání	health care profession
dopad hluku na zdraví	health effect of noise
zdravotnické zařízení	health facility
zdravotní riziko	health hazard
zdravotní legislativa	health legislation
zdravotnická směrnice	health regulation
zdravotnictví	health service
vztah zdraví-životní prostředí	health-environment relationship
biotechnologie týkající se zdraví	health-related biotechnology
sluch	hearing
ostrost sluchu	hearing acuity
poškození sluchu	hearing impairment
postup při projednávání	hearing procedure
ochrana sluchu	hearing protection
sluchový orgán	hearing system
teplo	heat
elektrárna s výrobou tepla	heat and power station
tepelné čerpadlo	heat pump
akumulace tepla	heat storage
zásobování teplem	heat supply
topné těleso	heater
pohan	heathen ; infidel ; pagan
vřesoviště	heathland
vytápění	heating
teplárna	heating plant
nebe	heaven ; sky
přeprava nákladů těžkých	heavy goods vehicle traffic
kov těžký	heavy metal
zatížení kovy těžkými	heavy metal load
plot živý	hedge
ježkové	hedgehog
hegemonie	hegemony
helikoptéra	helicopter
helium	helium
herbicid	herbicide
býložravec	herbivore ; plant eater
heroin	heroin
volavka	heron
heterocyklická sloučenina	heterocyclic compound
velehory	high mountain
vrchol přílivu	high tide water
vedení napětí vysokého	high voltage line
výšková budova	high-rise building
železnice vysokorychlostní	high-speed railway
rychlovlak	high-speed train
vzdělávání vysokoškolské	higher education
dálnice	highway
stezka turistická	hiking trail
historické centrum	historic centre
vývoj historický	historical evolution
historická památka	historical monument
historický výzkum	historical research
historické místo	historical site
historie	history
prázdniny	holiday ; opor-garai
tábor prázdninový	holiday camp
holmium	holmium
zahrada u domu	home garden
homeostáza	homeostasis
stránka webová	homepage
homologace	homologation
homonymum	homonym
med	honey
naděje	hope
horizont	horizon
hormon	hormone
kůň	horse
zahradnictví	horticulture
nemocnice	hospital ; clinic
odpady nemocniční	hospital waste
voda teplá	hot water
služby hotelové	hotel industry
domácnost	household
chemikálie používané v domácnostech	household chemical
výdaje domácnosti	household expenditure
potřeby domácí	household goods
bydlení	housing
hustota obydlení	housing density
zlepšení bydlení	housing improvement
legislativa k bydlení	housing legislation
program bydlení	housing programme
normy kvality bydlení	housing quality standard
lidské tělo	human body
lidská choroba	human disease
ekologie člověka	human ecology
prostor člověka životní	human habitat
lidské zdraví	human health
migrace osob	human migration
fyziologie člověka	human physiology
populace lidská	human population
práva lidská	human rights
společenské vědy	human science
sídlo lidské	human settlement
management sídel lidských	human settlement management
katastrofa v důsledku lidské činnosti	human-made disaster
pomoc humanitární	humanitarian aid
humus	humus
hlad	hunger ; hunger ; hunger
lov	hunting
lístek lovecký	hunting licence
rezervace lovecká	hunting reserve
hurikán	hurricane
manžel	husband ; spouse
křížení	hybridisation
dílo vodní	hydraulic construction
stavitelství vodní	hydraulic engineering
hydraulika	hydraulics
hydrobiologie	hydrobiology
uhlovodík	hydrocarbon
nádrž pro uhlovodíky akumulační	hydrocarbon storage tank
kyselina chlorovodíková	hydrochloric acid ; muriatic acid
hydroponie	hydroculture
energie vodní	hydroelectric energy
elektrárna vodní	hydroelectric power plant
vodík	hydrogen
sirovodík	hydrogen sulphide
hydrogeologie	hydrogeology
povodí hydrografické	hydrographic basin
síť říční	hydrographic network
hydrografie	hydrography
hydrologická bilance	hydrologic balance
hydrologický cyklus	hydrologic cycle
katastrofa hydrologická	hydrologic disaster
režim hydrologický	hydrologic flow
hydrologie	hydrology
hydrolýza	hydrolysis
hydrometeorologie	hydrometeorology
hydrometrie	hydrometry
hydrosféra	hydrosphere
hyena	hyena
hygiena	hygiene
hmyz blanokřídlý	hymenopteran
hypertext	hypertext
hyponymum ; podřazené výrazy	hyponym ; narrower terms ; narrower term
led	ice
zmrzlina	ice cream
nahromadění ker ledových	ice pack
kra ledová	iceberg
ideologie	ideology
klasifikace dat obrazových	image classification
zlepšení obrazových dat	image enhancement
filtrace obrazových dat	image filtering
digitální systém pro zpracování obrazových dat	image processing digital system
záznam dat obrazových	image registration
imise	immission
kontrola imisí	immission control
zákon o kontrole imisí	immission control law
škoda způsobená imisemi	immission damage
předpověď imisí	immission forecast
limit imisní	immission limit
zátěž imisní	immission load
imunitní systém	immune system
imunita	immunity
imunotest	immunoassay
imunologická choroba	immunological disease
imunologie	immunology
hodnocení dopadů	impact assessment
minimalizace dopadů	impact minimisation
prevence dopadů negativních	impact prevention
zvrat dopadů	impact reversal
zdroj dopadů negativních	impact source
přístroj pro měření dopadů	impactor
implementace zákona	implementation law
dovoz	import
licence dovozní	import licence
zbídačení	impoverishment
impregnační látka	impregnating agent
impregnace	impregnation
zvýšení účinnosti	improvement of efficiency
šum impulsní	impulsive noise
in situ [na místě] ; na místě ; in situ	in situ
test in vitro	in vitro assay
test in vivo	in vivo assay
fond stimulační	incentive fund
stimulační daň	incentive tax
znečištění náhodné	incidental pollution
spalování	incineration
spalování odpadů	incineration of waste
zbytky ze spalování	incineration residue
zařízení spalovací	incinerator
příjem	income
daň z příjmu	income tax
sloučení	incorporation
koncepce právní neomezená	indefinite legal concept
náhrada škody	indemnity
nezávislost	independence
index	index
indexace dokumentace	indexing of documentation
indikátor	indicator
indikátor kvality prostředí životního	indicator of environmental quality
vědomosti obyvatelstva domorodého	indigenous knowledge
původní technologie	indigenous technology
nepřímý zdroj vypouštění odpadních vod	indirect discharger
indium	indium
decentralizované čištění odpadních vod	individual wastewater treatment
znečištění ovzduší vnitřního	indoor air pollution
vnitřní prostředí	indoor environment
činnost průmyslová	industrial activity
oblast průmyslová	industrial area
sdružení průmyslové	industrial association
průmyslová budova	industrial building
plodina průmyslová	industrial crop
rozvoj průmyslový	industrial development
skládkování odpadů průmyslových	industrial dumping
ekonomika průmyslu	industrial economics
vody odpadní průmyslové	industrial effluent
průmyslové emise	industrial emission
prostředí průmyslové	industrial environment
politika průmyslu ekologická	industrial environmental policy
průmyslové zařízení	industrial equipment
průmyslové zařízení	industrial installation
legislativa k průmyslu	industrial legislation
výroba průmyslová	industrial manufacturing
průmyslový materiál	industrial material
průmyslové lékařství	industrial medicine
průmyslový hluk	industrial noise
plánování průmyslové	industrial planning
závod průmyslový [budova] ; závod průmyslový	industrial plant (building) ; industrial plant
podnik průmyslový	industrial plant (organism) ; industrial plant
politika průmyslová	industrial policy
průmyslové znečištění	industrial pollution
průmyslový proces	industrial process
průmyslový výrobek	industrial product
výroba průmyslová	industrial production
statistika výroby průmyslové	industrial production statistics
právo k vlastnictví průmyslovému	industrial property right
průmyslová bezpečnost	industrial safety
průmyslová zóna	industrial site
kal průmyslový	industrial sludge
společnost průmyslová	industrial society
struktura průmyslu	industrial structure
odpady průmyslové	industrial waste
průmyslový odpadní plyn	industrial waste gas
vody odpadní průmyslové	industrial waste water
úhor v důsledku činnosti průmyslové předchozí	industrial wasteland
zónování průmyslové	industrial zoning
industrializace	industrialisation
průmysl	industry
odpady inertní	inert waste
inertizace	inertisation
nemluvně	infant
úmrtnost dětská	infant mortality
infekce	infection
nemoc infekční	infectious disease
zamoření plodin	infestation of crops
zamoření potravin	infestation of food
infiltrace	infiltration
látka hořlavá	inflammable substance
inflace	inflation
přítok	inflow
chřipka	influenza ; flu
informace	info ; information
jednání neformální	informal negotiation
informatika	informatics ; computer science ; information science
informační středisko	information centre
informační databanka	information clearing-house
výměna informací	information exchange
informační infrastruktura	information infrastructure
soubor informací	information kit
informační síť	information network
zpracování informací	information processing
informační služba	information service
informační zdroj	information source
informační systém	information system
technologie informační	information technology ; IT
průmysl technologií informačních	information technology industry
přenos informací	information transfer
porušení	infraction
záření infračervené	infrared radiation
infrazvuk	infrasound
infrastruktura	infrastructure
obyvatel	inhabitant
školení úvodní	initial training
úraz	injury
inkoust	ink
rybářství sladkovodní	inland fishery
plavba vnitrozemská	inland navigation
vody vnitrozemské	inland water
vodní vnitrozemská doprava	inland waterways transport
inovace	innovation
anorganická chemie	inorganic chemistry
hnojivo anorganické	inorganic fertiliser
anorganická znečišťující látka	inorganic pollutant
látka anorganická	inorganic substance
hmyz	insect
insekticid	insecticide
hmyzožravec	insectivore
látka nerozpustná	insoluble substance
inspekce	inspection
kontrola dokladů	inspection of records
inspekční služba	inspection service
optimalizace zařízení	installation optimisation
instalace vyžadující schválení	installation requiring approval
obnova zařízení	installation restoration
nárt	instep
institucionální aktivita	institutional activity
institucionální struktura	institutional structure
institucionalizace	institutionalisation
hudební nástroj	instrument ; musical instrument
výroba nástrojů	instrument manufacture
přístrojová technika	instrumentation
izolace	insulation
pojištění	insurance
pojišťovna	insurance business
krytí pojistné	insurance coverage
rezervace přírodní integrální	integral natural reserve
integrované technologie ochrany životního prostředí	integrated environmental protection technology
řízení integrované	integrated management
ochrana proti škůdcům integrovaná	integrated pest control
řízení znečištění integrované	integrated pollution control
výroba živočišná integrovaná	intensive animal husbandry
zemědělství intenzivní	intensive farming
meziknihovní výpůjčka	inter-library loan
interakce pesticidů	interaction of pesticides
výměna dat elektronických	interchange of electronic data
výzkum mezioborový	interdisciplinary research
úrok	interest
skupina zájmová	interest group
rozhodnutí prozatimní	interim decision
test mezilaboratorní	interlaboratory comparison
polotovar	intermediate goods
hluk přerušovaný	intermittent noise
trh evropský vnitřní	internal European market
migrace vnitrostátní	internal migration
internalizace nákladů vnějších	internalisation of external costs
mezinárodní dohoda	international agreement
mezinárodní pomoc	international assistance
mezinárodní rovnováha	international balance
mezinárodní spolupráce	international co-operation
konkurenceschopnost mezinárodní	international competitiveness
mezinárodní konflikt	international conflict
úmluva mezinárodní	international convention
distribuce celosvětová [rozložení celosvětové?] ; distribuce celosvětová (rozložení celosvětové?)	international distribution
dělba práce mezinárodní	international division of labour
právo ekonomické mezinárodní	international economic law
mezinárodní ekologické vztahy	international environmental relations
mezinárodní harmonizace	international harmonisation
právo mezinárodní	international law
mezinárodní organizace	international organisation
politika mezinárodní	international politics
mezinárodní vztahy	international relations
mezinárodní bezpečnost	international safety
normalizace mezinárodní	international standardisation
mezinárodní obchod	international trade
mezinárodní jednání	international transaction
tok vodní mezinárodní	international watercourse
ekosystém mezinárodně významný	internationally important ecosystem
vyhledávací služba na internetu	internet search service
poskytovatel služeb na internetu	internet service provider ; ISP ; Internet access provider ; Internet service provider
interpolace	interpolation
metoda výkladu	interpretation method
tlumočník	interpreter
zóna odlivu pobřežní	intertidal zone
fond intervenční	intervention fund
zásah do přírody a krajiny	intervention in nature and landscape
opatření ochrany krajiny	intervention on land
intoxikace	intoxication
introdukce druhů živočišných	introduction of animal species
introdukce druhů rostlinných	introduction of plant species
inventarizace	inventory
inventarizace poškození lesů	inventory of forest damage
inverze	inversion
inverzní vrstva	inversion layer
bezobratlovec	invertebrate
investice	investment
jód	iodine
iont	ion
výměna iontů	ion exchange
měnič iontů	ion exchanger
záření ionizující	ionising radiation
ionosféra	ionosphere
iridium	iridium
železo	iron
průmysl hutnictví železa a oceli	iron and steel industry
průmysl železářský	iron industry
šrot železný	iron scrap
průmysl hutnictví železa	ironwork industry
ozáření	irradiation
nevratnost  jevu	irreversibility of the phenomenon
zavlažování	irrigation
hospodářství závlahové	irrigation farming
systém zavlažovací	irrigation system
ostrov	island ; isle
ekosystém ostrovní	island ecosystem
izomer	isomer
izotop	isotope
slonovina	ivory
jaguár	jaguar
jazz	jazz
kloub	joint ; articulation
spoludlužníci	joint debtor
implementace společná	joint implementation
časopis	journal ; mag ; magazine ; periodical
žurnalistika	journalism
novinář	journalist
rozsudek	judgement (sentence) ; sentence ; judgement
podpora soudní	judicial assistance
soudní orgán	judicial body
systém soudní	judicial system
nařízení soudní	judiciary rule
judo	judo
skutek právní	juridical act
jurisdikce	jurisdiction
právní věda	jurisprudence
systém právní	justice
karate	karate
kras	karst
petrolej	kerosene
klávesnice	keyboard
ledvina	kidney
nůž	knife
jezdec	knight ; knight
kokosový ořech	kokosnoot ; coconut
krypton	krypton
značení	labelling
laboratoř	laboratory
experiment laboratorní	laboratory experiment
výzkum laboratorní	laboratory research
metoda laboratorní	laboratory technique ; laboratory techniques
test laboratorní	laboratory test
odpady z laboratoří	laboratory waste
práce	labour
síla pracovní	labour force
právo pracovní	labour law
trh práce	labour market
vztahy pracovní	labour relations
lak	lacquer
laguna	lagoon
čištění vod odpadních v lagunách	lagooning
jezero	lake
povodí jezera	lake basin
znečištění jezera	lake pollution
lampa	lamp ; light
pozemek ; pozemek	land
přidělování půdy	land allotment
čištění pozemku	land clearing
ochrana půdy	land conservation
slučování pozemků	land consolidation
pokryv krajiny	land cover
rozvoj územní	land development
zneškodňování odpadů v půdě	land disposal
ekologie půdy	land ecology
tvorba krajiny	land forming
savec suchozemský	land mammal
ŘÍZENÍ A ÚZEMNÍ PLÁNOVÁNÍ	land management and planning
držba pozemku	land occupation
plánování územní	land planning
znečištění pozemku	land pollution
rekultivace půdy	land reclamation
kniha pozemková	land register
rekultivace půdy	land restoration
rekultivace půdy v oblastech horských	land restoration in mountain areas
sktruktura krajiny	land setup
pozemková daň	land tax
přeprava pozemní	land transportation
využití půdy	land use
klasifikace využití půdy	land use classification
plán územní	land use plan
plánování využití půdy	land use planning
režim využití území	land use regime
hodnota pozemku	land value
aktivita na pevnině	land-based activity
znečištění moře z pevniny	land-based marine pollution
řízení nároků na půdu v oblasti zájmové	land-management intervention area
skládka	landfill
těsnění tělesa skládky	landfill base sealing
zastřešení skládky	landfill covering
odplyňování skládky	landfill degasification
skládkový plyn	landfill gas
voda průsaková ze skládky	landfill leachate
charakter terénu	landform
krajina	landscape
krajina po těžbě důlní	landscape after mining
změna krajiny	landscape alteration
architektura krajinná	landscape architecture
prvek krajinný	landscape component
zachování krajiny	landscape conservation
politika ochrany krajiny	landscape conservation policy
využívání krajiny	landscape consumption
krajinná ekologie	landscape ecology
hospodaření v krajině	landscape management
plánování krajinné	landscape planning
ochrana krajiny	landscape protection
oblast chráněná krajinná	landscape protection area
využití krajiny	landscape utilisation
sesuv	landslide
jazyk ; jazyk	language
lucerna ; svítilna	lantern
lanthan	lanthanum
závod spalovací velký	large combustion plant
laser	laser ; Light Amplification by Stimulated Emission of Radiation
šířka zeměpisná	latitude
praní prádla	laundering
levandule	lavender ; lavander
zákon	law
právo	law
právní věda	law ; law (science)
návrh zákona pozměňovací	law amendment
odvětví právní	law branch
návrh zákona	law draft
vymáhání práva	law enforcement
legislativa ke službě vězeňské	law relating to prisons
lawrencium	lawrencium
vyluhování	leaching
olovo	lead
sloučenina olova	lead compound
hladina olova v krvi	lead level in blood
zákon o obsahu olova v benzínu	lead-in-petrol law
list	leaf
únik náhodný	leakage
přestupný rok	leap year
smlouva o pronájmu	lease
kůže	leather
průmysl kožedělný	leather industry
noga	leg
základ právní	legal basis
forma organizací právní	legal form of organisations
řízení soudní	legal procedure
povolání právnické	legal profession
předpis právní	legal regulation
prostředek nápravný	legal remedy
systém právní	legal system
listina právní	legal text
právo zákonem chráněné	legally protected right
legislativa	legislation
legislativa ke znečišťování	legislation on pollution
orgán legislativní	legislative authority
kompetence legislativní	legislative competence
informace legislativní	legislative information
procedura legislativní	legislative procedure
sbor zákonodárný	legislature
aktivity v čase volném	leisure activity
středisko času volného	leisure centre
čas volný	leisure time
citron	lemon
čočka	lens
motýli	lepidopteran
země méně rozvinuté	less developed country
leukémie	leukaemia
úroveň vzdělání	level of education
poplatek	levy
slovník	lexicon
odpovědnost	liability
legislativa k odpovědnosti	liability legislation
liberalismus	liberalism
knihovna	library
knihovní služba	library service
postup udělování licencí	licencing procedure
lišejník	lichen
životní cyklus	life cycle
biologie	life science
řízení životního cyklu	life-cycle management
plavèík	lifeguard
styl životní	lifestyle
světlo	light
osvětlení	lighting
lignit	lignite
těžba lignitu	lignite mining
vápno	lime
vápenec	limestone
mezní hodnota	limit value
limnologie	limnology
linie	line
zdroj přímý	line source
zdroj zvuku lineární	linear source of sound
materiál těsnicí	liner material
ingvistika ; lingvistika ; jazykověda	linguistics
lev	lion
ret	lip
lipid	lipid
látka lipofilická	lipophilic substance
rtěnka	lipstick
plyn zkapalněný	liquefied gas
kapalina ; tekutina	liquid
močůvka	liquid manure
stav kapalný	liquid state
odpady kapalné	liquid waste
literatura	literature
databanka literatury	literature data bank
vyhodnocení literatury	literature evaluation
studium literatury	literature study
lithium	lithium
kamenotisk	lithography
litosféra	lithosphere
proces soudní	litigation
stelivo	litter
pásmo pobřežní	littoral
játra	liver
skot	livestock
šlechtění skotu	livestock breeding
chov skotu	livestock farming
podmínky životní	living condition
prostor životní	living environment
prostor životní	living space
úroveň životní	living standard
ještěrka	lizard
únosnost zátěže	load bearing capacity
zalesňování místní	local afforestation
orgán správy místní	local authority
rozvoj místní	local development
finance komunální	local finance
správa místní	local government
politika komunální	local government policy
zásobování teplem místní	local heat supply
místní osobní doprava	local passenger service
rekreace místní	local recreation
využití zdrojů místních	local resource utilisation
místní doprava	local traffic
lokalizace průmyslu	location of industries
lokomotiva	locomotive
přechodné ubytování	lodging
logika	logic
dlouhý	long
dálková doprava	long-distance traffic
přeprava dálková	long-distance transport
účinek dlouhodobý	long-term effect
experiment dlouhodobý	long-term experiment
délka zeměpisná	longitude
nákladní auto	lorry
ztráta	loss
úbytek biotopů	loss of biotope
loterie	lottery
hlasitost	loudness
milovat	love
průtok minimální	low flow
sociální bydlení	low-cost housing
let ve velmi nízké nadmořské výšce	low-level flight
technologie s nízkou úrovní	low-level technology
mazadlo	lubricant
zářivost	luminosity
lutecium	lutetium
louh	lye
lymfatický systém	lymphatic system
rys	lynx
lysimetrie	lysimetry
kulomet	machine gun
výroba strojní	machine manufacture
strojní zařízení	machinery ; mechanism
makrela	mackerel
makroekonomický cíl	macroeconomic goal
makroekonomika	macroeconomics
makrofyt	macrophyte
hořčík	magnesium
páska magnetická	magnetic tape
magnetismus	magnetism
údržba	maintenance (technical) ; maintenance
péče o prostředí životní	maintenance of environment
havárie závažnější	major accident
riziko závažné	major risk
zařízení představující závažné riziko	major risk installation
malárie	malaria
porucha strukturní	malformation
podvýživa	malnutrition
savec	mammal
člověk	man
klimatická změna v důsledku lidské činnosti	man-made climate change
management	management
účetnictví podnikové	management accounting
smlouva s vedením podniku	management contract
management zdrojů přírodních	management of natural resources
plán řízení	management plan
technika řízení	management technique
oprávnění oficiální	mandate
mangan	manganese
mango	mango
mangle	mangrove
síla pracovní	manpower
činnost výrobní	manufacturing activity
výroba řemeslná	manufacturing trade
hnůj	manure
produkce hnoje	manure production
mapa	map
mapa navigační	map chart
mapování	mapping
mapování lišejníků	mapping of lichens
křoviska hustá v oblasti Středozemního moře	maquis
mramor	marble
půda okrajová	marginal land
pěstování a chov živočichů a rostlin mořských v prostředí přírodním	mariculture
přístav malý	marina
mořská biologie	marine biology
mořská ekologie	marine ecology
ekosystém mořský	marine ecosystem
stavitelství lodní	marine engineering
prostředí životní mořské	marine environment
fauna mořská	marine fauna
rybářství mořské	marine fishery
mořská geologie	marine geology
savec mořský	marine mammal
monitorování mořské	marine monitoring
organismus mořský	marine organism
park mořský	marine park
znečištění mořské	marine pollution
rezervace mořská	marine reserve
stav [manželský] ; stav (manželský)	marital status
právo námořní	maritime law
plavba námořní	maritime navigation
námořní doprava	maritime transport
látka značkovací ; značkovací látka	marker
trh	market ; marketplace
tržní hospodářství	market economy
forma trhu	market form
pěstování ovoce a zeleniny na prodej	market gardening
tržní cena	market price
průzkum trhu	market research
studie trhu	market study
marketing	marketing
mokřina	marsh
vačnatec	marsupial
zdivo	masonry
hromadné sdělovací prostředky ; masmédia	mass media
rekreace skupinová	mass recreation
přenos hmoty	mass transport
materiál	material ; materials
životní cyklus látek	material life cycle
nauka o materiálech	materials science
analýza matematická	mathematical analysis
metoda matematická	mathematical method
matematika	mathematics
mauzoleum	mausoleum
maximální přípustná koncentrace	maximum admissible concentration
maximální koncentrace imisí	maximum immission concentration
louka	meadow
prostředky výroby zemědělské	means of agricultural production
komunikační prostředky	means of communication
měření	measuring
měřící přístroj	measuring instrument
metoda měřicí	measuring method
program měření	measuring programme
maso	meat
mechanické zařízení	mechanical equipment
průmysl strojní	mechanical industry
vibrace mechanické	mechanical vibration
lékařská věda	medical science
rostlina léčivá	medicinal plant
lékařství	medicine ; medicine (practice)
meitnerium	meitnerium
melodie	melody ; tune
tavení	melting
membrána	membrane
mendelevium	mendelevium
meningitida	meningitis
obchodní lodní doprava	merchant shipping
rtuť	mercury
metabolismus	metabolism
metabolit	metabolite
metainformace	metainformation
kov	metal
oxid kovu	metal oxide
kovový výrobek	metal product
kovoprůmysl	metal products industry
odpady kovové	metal waste
suroviny rudní	metallic mineral
průmysl hutnický	metallurgical industry
metalurgie	metallurgy
metafyzika	metaphysics
meteor ; meteor ; meteor ; meteor ; meteor	meteor ; meteor ; meteor ; meteor ; meteor ; shooting star ; falling star
meteorit	meteorite
katastrofa v důsledku vlivů povětrnostních	meteorological disaster
parametr meteorologický	meteorological parameter
meteorologický jev	meteorological phenomenon
výzkum meteorologický	meteorological research
meteorologie	meteorology
metan	methane ; marsh gas ; methyl hydride
metanizace	methanisation
methanol	methanol
metoda	method
metodologie	methodology
metrologie	metrology
metronom	metronome
metropole	metropolis
mikroorganismus	micro-organism
analýza mikrobiologická ; mikrobiologická analýza	microbiological analysis
mikrobiologie	microbiology
mikroklima	microclimate
mikroklimatologie	microclimatology
mikropočítač	microcomputer
mikroekosystém	microecosystem
mikroelektronika	microelectronics ; microminiaturization ; microsystem electronics
mikrofiltrace	microfiltration
mikrofon	microphone
mikroznečišťující látka	micropollutant
mikroskopie	microscopy
mikrovlna	microwave
práce vykonávaná migranty	migrant labour
pták stěhovavý	migratory bird
ryba migrující	migratory fish
vojenské aktivity	military activities
vojenská letecká doprava	military air traffic
vojenské aspekty	military aspects
vojenská výzbroj	military equipment
pásmo vojenské	military zone
mléko	milk
mlýn	mill
důl	mine
skládkování v dolech bývalých	mine filling
nerost	mineral
stabilizátor minerální	mineral conditioner
ložisko nerostných surovin	mineral deposit
těžba surovin nerostných	mineral extraction
minerální vlákno	mineral fibre
průmysl surovin nerostných	mineral industry
minerální látka	mineral matter
olej ropný	mineral oil
znečištění látkami minerálními	mineral pollution
nerostné suroviny	mineral resource
odpady minerální	mineral waste
voda minerální	mineral water
mineralizace	mineralisation
mineralogie	mineralogy
plánování nákladů minimálních	minimal cost planning
minimalizace škod	minimisation of damage
oblast těžby důlní	mining district
průmysl báňský	mining industry
zákon báňský	mining law
produkt získaný těžbou	mining product
právo horní	mining regulation
obnova místa těžby	mining site restoration ; mine reclamation
odpady z těžby	mining waste
kompetence ministerské	minister competence
nařízení ministerské	ministerial decree
ministerstvo	ministry
budova ministerstva	ministry ; ministry building
menšina	minority
zboží smíšené	miscellaneous product
mísitelnost	miscibility
opar	mist
mistrál	mistral
roztoč	mite
opatření ke zmírnění důsledků	mitigation measure
mitóza	mitosis
zemědělství smíšené	mixed farming
les smíšený	mixed forest
oblast s využitím různorodým	mixed use area
míchání	mixing
přívěs obytný	mobile home
druh dopravy	mode of transportation
model	model
modelování	modelling
vlhkost	moisture
molekulární biologie	molecular biology
měkkýš	mollusc
molybden	molybdenum
hodnocení finanční	monetary assessment
ekonomika měnová	monetary economics
vztahy měnové	monetary relations
trh peněžní	money market
monitoring	monitoring
kritérium monitoringu	monitoring criterion
monitorovací data	monitoring data
monitorovací zařízení	monitoring equipment
síť monitorovací	monitoring network
monitorovací stanice	monitoring station
technika monitorovací	monitoring technique
monopol	monopoly
měsíc	month
památka	monument
Měsíc	moon ; Luna ; Moon
měsíc	moon ; moon ; satelite ; satelite
morfin	morphine
morfologie	morphology
úmrtnost	mortality
mozaika	mosaic
mešita	mosque
mech	moss
Moteto ; moteto	motet
palivo motorové	motor fuel
motorové vozidlo	motor vehicle
výfukový plyn z motorových vozidel	motor vehicle exhaust gas
průmysl vozidel motorových	motor vehicle industry
znečišťení zapříčiněné motorovými vozidly	motor vehicle pollution
motocykl	motorcycle ; motorbike
dálnice	motorway ; pike ; expressway ; freeway ; state highway ; superhighway ; throughway ; thruway
hora	mountain
podnebí horské	mountain climate
les horský	mountain forest
řízení horských oblastí	mountain management
ochrana horských oblastí	mountain protection
pásmo horské	mountain range
oblast rekreační horská	mountain resort
oblast hornatá	mountainous area
myš	mouse
žatva	mowing
bahno	mud
mělčina bahnitá	mud flat
mulč	mulch
multilaterální dohoda	multilateral agreement
technologie multimediální	multimedia technology
firma nadnárodní	multinational firm
multispektrální snímač	multispectral scanner
služby technické komunální	municipal cleansing service
skládka komunální	municipal dumping
plán prostředí městského	municipal environment plan
politika ekologická komunální	municipal environmental policy
právo komunální	municipal law
úroveň komunální	municipal level
odpady komunální	municipal waste
systém vodovodní rozvodný komunální	municipal water distribution system
hospodářství vodní komunální	municipal water management
obec	municipality
svalový systém	muscular system
muzeum	museum
houba	mushroom
hudba	music
muzikál	musical
hudebník	musician
komár ; moskyt	musquito ; mosquito
chov slávek	mussel farming
savec rodu lasicovitých	mustelid
mutagen	mutagen
mutagenita	mutagenicity
testování mutagenity	mutagenicity testing
mutant	mutant
uvolnění zmutovaných mikroorganizmů	mutated micro-organisms release
mutace	mutation
mycety	mycete
mykologie	mycology
mykorrhiza	mycorrhiza
tajemný	mysterious
mýtus	myth
jméno	name ; proper name ; proper noun
plenka	nappy
účetnictví národohospodářské	national accounting
hranice státní	national boundary
národní hospodářství	national economy
národní ekologické účetnictví	national environmental accounting
rezervace rybářská národní	national fishing reserve
legislativa národní	national legislation
park národní	national park
plánování státní	national planning
zestátnění	nationalisation
oblast přírodní	natural area
ochrana přírodních oblastí	natural areas protection
katastrofa přírodní	natural disaster
prostředí přírodní	natural environment
hnojivo přírodní	natural fertiliser
přírodní materiál	natural fibre
les přirozený	natural forest
plyn zemní	natural gas
průzkum ložisek plynu zemního	natural gas exploration
těžba plynu zemního	natural gas extraction
riziko přírodní	natural hazard
dědictví přírodní	natural heritage
hodnocení přírodního dědictví	natural heritage assessment
přírodní materiál	natural material
památka přírodní	natural monument
park přírodní	natural park
radioaktivita přirozená	natural radioactivity
regenerace přirozená ; přirozená regenerace	natural regeneration
přírodní zdroj	natural resource
zachování zdrojů přírodních	natural resource conservation
riziko přírodní	natural risk
analýza rizik přírodních	natural risk analysis
prevence přírodních rizik	natural risks prevention
scenérie přírodní	natural scenery
přírodní vědy	natural science
přírodní kámen	natural stone
přírodní hodnota	natural value
ochrana přírody	nature conservation
legislativa k ochraně přírody	nature conservation legislation
organizace ochrany přírody	nature conservation organisation
program ochrany přírody	nature conservation programme
ochrana přírody	nature protection
přírodní rezervace	nature reserve
nevolnost	nausea
navigace	navigation
riziko navigační	navigational hazard
odumření	necrosis
potřeba	need
hluk z blízkého okolí	neighbourhood noise
červi	nematode
neodym	neodymium
neologismus	neologism
neon	neon
nádor	neoplasm ; tumour
nepotismus	nepotism
neptunium	neptunium
nervová soustava	nervous system
hnízdění	nesting
oblast hnízdění	nesting area
politika slučování [povolení emisní obchodovatelná] ; politika slučování (povolení emisní obchodovatelná)	netting policy (emissions trading) ; netting policy
neurologie	neurology
neurotoxicita	neurotoxicity
neutralizace	neutralisation
nový	new ; novel
komunita nová	new community
nové zařízení	new installation
materiál nový	new material
technologie nová	new technology
skupina diskusní	newsgroup
bulletin	newsletter
nikl	nickel
niob	niobium
dusičnan	nitrate
nitrifikace	nitrification
dusíkatá sloučenina	nitro compound
dusík	nitrogen
cyklus dusíku	nitrogen cycle
oxid dusičitý	nitrogen dioxide
fixace dusíku	nitrogen fixation
oxid dusný	nitrogen monoxide
oxid dusíku	nitrogen oxide
oxidy dusíku	nitrogen oxides
hnojivo dusíkaté	nitrogenous fertiliser
nitrosamin	nitrosamine
ne	no
nobelium	nobelium
hluk	noise
hluk	noise ; noise, vibrations ; racket
snižování hluku	noise abatement
analýza hluku	noise analysis
bariéra protihluková	noise barrier
ochrana proti hluku	noise control
porucha zapříčiněná hlukem	noise disturbance ; noise pollution
hlukové emise	noise emission
poplatek za hlukové emise	noise emission levy
plán působení hluku	noise exposure plan
hlukové imise	noise immission
legislativa ke hluku	noise legislation
hladina hluku	noise level
měření hluku	noise measurement
hluková znečišťující látka	noise pollutant
hlukové znečištění	noise pollution
ochrana proti hluku	noise protection
snižování hlučnosti	noise reduction
spektrum hluku	noise spectrum
bezhlučná technologie	noise-free technology
kočovník	nomad
terminologie	nomenclature
biologicky neodbouratelná znečišťující látka	non-biodegradable pollutant
území nezastavěné	non-built-up area
energie netradiční	non-conventional energy
voda na pozemku soukromém	non-demesnial water
zboží netrvanlivé	non-durable goods
kov barevný	non-ferrous metal
průmysl kovů barevných	non-ferrous metal industry
nevládní organizace	non-governmental organisation
záření neionizující	non-ionising radiation
nekovy	non-metal
suroviny nerudní	non-metallic mineral
zdroj energie neznečišťující	non-polluting energy source
palivo neznečišťující	non-polluting fuel
neobnovitelný zdroj energie	non-renewable energy resource
neobnovitelný zdroj	non-renewable resource
výstavba nebytová	non-residential building
obal nevratný	non-returnable container
organismus necílový	non-target organism
látka  netěkavá	non-volatile substance
norma	norm
nos	nose
nozdra, ; nozdra	nostril
nota	note
nic	nothing
oznámení	notice
sdělení	notification
podstatné jméno	noun ; substantive
havárie jaderná	nuclear accident
diskuse o energii jaderné	nuclear debate
energie jaderná	nuclear energy
legislativa k energii jaderné	nuclear energy legislation
využití energie jaderné	nuclear energy use
výbuch jaderný [havárie] ; výbuch jaderný	nuclear explosion (accident) ; nuclear explosion
jaderné zařízení	nuclear facility
štěpení jaderné	nuclear fission
palivo jaderné	nuclear fuel
článek palivový	nuclear fuel element
syntéza termonukleární	nuclear fusion
nebezpečí jaderné	nuclear hazard
jaderná fyzika	nuclear physics
elektrárna jaderná	nuclear power plant
reakce jaderná	nuclear reaction
reaktor jaderný	nuclear reactor
středisko jaderného výzkumu	nuclear research centre
riziko jaderné	nuclear risk
jaderná bezpečnost	nuclear safety
zkouška jaderná	nuclear test
zbraň jaderná	nuclear weapon
kyselina nukleová	nucleic acid
školka ; školka [pěstování rostlin]	nursery (plant breeding) ; nursery ; plant nursery
živina	nutrient
bilance živin	nutrient balance
obsah živin	nutrient content
koloběh živin	nutrient cycle
médium živné	nutrient medium
odstraňování živin	nutrient removal
výživa	nutrition
hodnota potravy výživná	nutritive value of food
dub	oak
obezita	obesity
poslouchat	obey
námitka	objection
povinnost informovat	obligation to inform
povinnost značení	obligation to label
pozorovací družice	observation satellite
zastaralý	obsolete
překážka	obstacle ; obstruction
choroba z povolání	occupational disease
pracovní hygiena	occupational health
péče o pracovní hygienu	occupational health care
pracovní lékařství	occupational medicine
bezpečnost práce	occupational safety
směrnice o bezpečnosti práce	occupational safety regulation
postavení v zaměstnání	occupational status
oceán	ocean ; sea ; body of water ; bounding main
cirkulace vody v oceánu	ocean circulation
proud mořský	ocean current
ukládání odpadů do moře	ocean dumping
využití oceánu	ocean exploitation
teplota oceánu	ocean temperature
rozhraní oceán-ovzduší	ocean-air interface
podnebí oceánské	oceanic climate
oceánografie	oceanography
oktáva	octave
chobotnice	octopus
zápach	odour
cestování mimo špičku	off-peak travelling
mimo lokalitu	off-site
přestupek proti prostředí životnímu	offence against the environment
úřad	office
povinnost služební	official duty
projednávání úřední	official hearing
státní jazyk ; úřední jazyk	official language
politika kompenzační [povolení emisní obchodovatelná] ; politika kompenzační (povolení emisní obchodovatelná)	offset policy (emissions trading)
těžba ve vodách pobřežních	offshore mining
ohm	ohm
průmysl tukový	oil and fat industry
látka adsorbující ropu	oil binding agent
norná stěna	oil boom
ropná havárie	oil disaster
průzkum ložisek ropy	oil exploration
těžba ropy	oil extraction
ropovod	oil pipeline
znečištění ropné	oil pollution
snížení znečištění ropného	oil pollution abatement
proces zpracování ropy	oil production (chain)
loď ke sběru ropy	oil recovery vessel
rafinérie ropy	oil refinery
znovuzískávání ropy z havárií	oil residue recuperation
skvrna ropná	oil slick
ropná havárie	oil spill
tanker ropný	oil tanker
energie z ropy	oil-based energy
lokalita nebezpečná bývalá	old hazardous site
lokalita skládky staré	old landfill site
znečištění látkami pachovými	olfactory pollution
oligarchie	oligarchy
oligopol	oligopoly
vody odpadní z lisovny oleje olivového	olive oil mill wastewater
služba on-line	on-line service
čištění odpadních vod u zdroje	on-site wastewater treatment
onkologie	oncology
jedna	one
cibule	onion
ontogeneze ; ontogeneze	ontogenesis ; ontogenesis ; ontogeny
ontologie	ontology
trávník volný	open lawn
moře volné	open sea
rybolov na moři volném	open sea fishing
těžba povrchová	opencast mining ; open-pit mining
opera	opera
provozní údaje	operating data
názor	opinion ; stance
průzkum mínění	opinion survey
opium	opium
optika	optics
optimismus ; optimismus ; optimismus	optimism ; optimism ; optimism ; optimism ; optimism ; optimism ; optimism
nebo	or
orální sex	oral sex
pomeranč	orange
orchestr	orchestra
orchidea	orchid
nařízení	order
vyhláška	ordinance
ruda	ore
orgán	organ
organický uhlík	organic carbon
organická chemie	organic chemistry
zemědělství ekologické	organic farming
organická látka	organic matter
organický dusík	organic nitrogen
znečišťující organická látka	organic pollutant
organické znečištění	organic pollution
rozpouštědlo organické	organic solvent
organická látka	organic substance
odpady organické	organic waste
organizace	organisation (law)
organizace školská	organisation of teaching
organizace systému právního	organisation of the legal system
organismus	organism
organická sloučenina chlóru	organochlorine compound
organická sloučenina halogenu	organohalogen compound
vlastnost organoleptická	organoleptic property
organická sloučenina kovu	organometallic compound
organická sloučenina dusíku	organonitrogen compound
organická sloučenina kyslíku	organooxygen compound
organická sloučenina fosforu	organophosphorous compound
organická sloučenina síry	organosulphur compound
ornitologie	ornithology
orografie	orography
sirotek	orphan
pravopis	orthography
hmyz rovnokřídlý	orthopteran
osmium	osmium
osmóza	osmosis
pštros	ostrich
prostranství vnější [plán alokační] ; prostranství vnější (plán alokační) ; prostranství vnější	outer space (allocation plan) ; outer space
vaječník	ovary
pec	oven
odkrývka	overburden
využívání nadměrné	overexploitation
hnojení nadměrné	overfertilisation
lov ryb nadměrný	overfishing
přepad kanalizační	overflow (outlet)
spásání pastvin nadměrné	overgrazing
vedení elektrické nadzemní	overhead power line
přelidněnost	overpopulation
změna [limnologie] ; změna (limnologie)	overturn (limnology)
přezimování	overwintering
ovce	ovine
vlastník	owner
vlastnictví	ownership
oxidace	oxidation
oxidačně redukční proces	oxidation-reduction
oxidace	oxide
materiál oxidovatelný	oxidisable material
oxidační činidlo	oxidising agent
kyslík	oxygen
obsah kyslíku	oxygen content
oxygenace	oxygenation
ústřice	oyster
chov ústřic	oyster farming
ozón	ozone
potenciál poškození ozónové vrstvy	ozone depletion potential
ozónová vrstva	ozone layer
poškození ozónové vrstvy	ozone layer depletion
ozonizace	ozonisation
pacifista	pacifist
obal	packaging
odpady z obalů	packaging waste
průmysl obalový	packing industry
pediatr	paediatrician
strana	page
hmota nátěrová	paint
lakovna	paint room
obchod s barvami a laky	paint shop
malířství	painting business
paleoklimatologie	palaeoclimatology
paleoekologie	palaeoecology
paleontologie	palaeontology
palindrom	palindrome
palladium	palladium
papír	paper
průmysl papírenský	paper industry
parabola	parabola
padák	parachute
parametr	parameter
parazit	parasite
parazitologie	parasitology
zajištění parkování	parking provision
parlamentní diskuze	parliamentary debate
zpráva parlamentní	parliamentary report
papoušci	parrot
slovní druh ; slovní druh ; slovní druh	part of speech ; lexical category
částečně halogenovaný chlorfluorovaný uhlovodík	partially halogenated chlorofluorohydrocarbon
účast	participation
částice	particle
separátor částic	particle separator
strana politická ; strana	party ; political party
osobní doprava	passenger transport
odpady pastovité	paste-like waste
pastvina	pasture
patent	patent
cesta	path
patogen	pathogen
organismus patogenní	pathogenic organism
patologický vliv	pathologic effect
patologie	pathology
dědická správa	patrimonial management
rozpoznání vzorce	pattern recognition
politika mzdová	pay policy
mír	peace
zachování míru	peacekeeping
hruška	pear
rašelina	peat
těžba rašeliny	peat extraction
pedagogika	pedagogy
zóna pěší	pedestrian zone ; pedestrian area ; car-free zone ; auto-free zone ; pedestrianised zone
pedosféra	pedosphere
pokuta	penalty
pokuta za škody na prostředí životním	penalty for environmental damage
tužka	pencil
tučňák	penguin
poloostrov	peninsula
pentachlorfenol	pentachlorophenol
údaje na jednoho obyvatele	per capita data
voda prosakující	percolating water
hráz	perineum
periodická tabulka	periodic table
oblast parku okrajová	peripheral park area
perifyton	periphyton
část města okrajová	periurban space
propustnost	permeability
limit přípustného vystavení	permissible exposure limit
povolení	permission
peroxyacetyldusičnan	peroxyacetylnitrate
nerozložitelná organická látka	persistant organic pollutant
stálost	persistence
stálost pesticidů	persistence of pesticides
zodpovědnost osobní	personal responsibility
pesimismus	pessmism
škůdce	pest
ochrana proti škůdcům	pest control
zamoření škůdci	pest infestation
pesticid	pesticide
norma ochrany proti škůdcům	pesticide control standard
zvíře domácí	pet
petice	petition
právo petiční	petition right
petrochemikálie	petrochemical
petrochemický průmysl	petrochemical industry
benzín	petrol
ropa	petroleum
spotřeba ropy	petroleum consumption
průmysl ropný	petroleum industry
rostlina jevnosnubná	phanerogam ; spermatophyte
farmaceutický průmysl	pharmaceutical industry
odpady farmaceutické	pharmaceutical waste
farmakokinetika	pharmacokinetics
farmakologie	pharmacology
bažant	pheasant
fenol	phenol
feromon	pheromone
filologie	philology
filozofie	philosophy
phishing	phishing
telefon	phone ; telephone
fonetika	phonetics
fosforečnan	phosphate
odstraňování fosforečnanů	phosphate removal
náhražka fosforečnanů	phosphate substitute
hnojivo fosforečné	phosphatic fertiliser
fosfor	phosphorus
fotografie	photo ; photograph
fotochemické činidlo	photochemical agent
fotochemický oxidant	photochemical oxidant
fotochemické znečištění	photochemical pollution
fotochemický produkt	photochemical product
fotochemická reakce	photochemical reaction
fotochemický smog	photochemical smog
degradace pomocí světla	photodegradation
fotogrammetrie	photogrammetry
fotografování	photography
fotosyntéza	photosynthesis
změna fyzikální	physical alteration
fyzikální chemie	physical chemistry
podmínky fyzikální	physical conditions
geografie fyzikální	physical geography
měření znečištění fyzikální	physical measurement of pollution
plánování prostorové	physical planning
fyzikální znečišťující látka	physical pollutant
fyzikální znečištění	physical pollution
proces fyzikální	physical process
vlastnost fyzikální	physical property
fyzikální věda	physical science
fyzikální čištění	physical treatment
analýza fyzikálně chemická	physicochemical analysis
proces fyzikálně chemický	physicochemical process
fyzikálně chemické čištění	physicochemical purification
fyzikálně chemické čištění	physicochemical treatment
fyzika	physics
fyziologie	physiology
fytomasa	phytomass
fytopatologie	phytopathology
fytoplankton	phytoplankton
čištění kořenové	phytosanitary treatment
fytosociologie	phytosociology
fytotoxicita	phytotoxicity
provoz s lázněmi mořicími	pickling plant
holub	pigeon ; dove
vepřín	piggery
kopí	pike ; spear
provoz zkušební	pilot plant
projekt pilotní	pilot project
řízení letadel a lodí	pilotage
ploutvonožec	pinniped
borovice	pino ; pine
potrubí	pipe
síť trubní	pipeline
hypofýza	pituitary gland
soucit	pity ; compassion
pixel	pixel
místo	place ; location
placenta	placenta
planina	plain
plán	plan
zdroj znečištění rozptýlený	plane source
planeta	planet
plankton	plankton
plánování	planning
legislativa k plánování územnímu	planning law
opatření plánovací	planning measure
rozhodnutí územní	planning permission
rostlina	plant
biologie rostlin	plant biology
šlechtění rostlin	plant breeding
společenství rostlinné	plant community
část rostliny	plant component
choroba rostlin	plant disease
ekologie rostlin	plant ecology
strojně technologické zařízení podniku	plant equipment
dědictví rostlin	plant heritage
fyziologie rostlin	plant physiology
počet druhů rostlin	plant population
výroba rostlinná	plant production
ochrana rostlin	plant protection
prostředek na ochranu rostlin	plant protection product
rozmnožování rostlin	plant reproduction
rostlinný zdroj	plant resource
výběr rostlin	plant selection
druhy rostlinné	plant species
reintrodukce druhů rostlinných	plant species reintroduction
rostlinné textilní vlákno	plant textile fibre
obchod s rostlinami	plant trade
výsadba	planting
technologie plazmová	plasma technology
plast	plastic
odpady plastové	plastic waste
platina	platinum
plavba výletní	pleasure cruising
pluh	plough
plutonium ; plutonium ; plutonium	plutonium ; plutonium ; plutonium
bod	point
zdroj znečištění bodový	point source
jed	poison
otrava	poisoning
polární oblast	polar region
poldr	polder
policie	police
zákon o policii	police law
moc policejní	police power
politika	policy
linie politiky	policy guideline
nástroj politiky	policy instrument
integrace politiky	policy integration
plánování politiky	policy planning
poradenství politické	political counselling
politická doktrína	political doctrine
politická ekologie	political ecology
geografie politická	political geography
ideologie politická	political ideology
organizace politická	political organisation
moc politická	political power
politologie	politics
pyl	pollen
znečišťující látka	pollutant
absorpce látky znečišťující	pollutant absorption
akumulace látky znečišťující	pollutant accumulation
analýza látek znečišťujících	pollutant analysis
hodnocení znečišťující látky	pollutant assessment
koncentrace látky znečišťující	pollutant concentration
odbourávání látky znečišťující	pollutant degradation
ukládání látky znečišťující	pollutant deposition
rozptyl látky znečišťující	pollutant dispersion
rozložení látky znečišťující prostorové	pollutant distribution
odstraňování znečišťující látky	pollutant elimination
emise látky znečišťující	pollutant emission
vývoj látky znečišťující	pollutant evolution
působení látky znečišťující	pollutant exposure
tok látky znečišťující	pollutant flow
tvorba látky znečišťující	pollutant formation
imise látky znečišťující	pollutant immission
imobilizace znečišťující látky	pollutant immobilisation
migrace látky znečišťující	pollutant migration
monitorování látky znečišťující	pollutant monitoring
dráha látky znečišťující	pollutant pathway
redukce znečišťující látky	pollutant reduction
remobilizace látky znečišťující	pollutant remobilisation
látka znečištěná	polluted matter
místo znečištěné	polluted site
princip "znečišťovatel platí"	polluter-pays principle
znečištění	pollution
omezování znečištění	pollution abatement
zařízení na snižování znečištění	pollution abatement equipment
odpady z procesu čištění	pollution abatement waste
snižování znečištění	pollution control
zařízení na snižování znečištění	pollution control equipment
investice ke snižování znečištění	pollution control investment
opatření ke snižování znečištění	pollution control measure
technologie ke snižování znečištění	pollution control technology
náklady na odstranění znečištění	pollution cost
vliv znečištění	pollution effect
indikátor znečištění	pollution indicator
pojištění proti riziku znečištění	pollution insurance
zodpovědnost za znečištění	pollution liability
rozsah znečištění	pollution load
měření znečištění	pollution measurement
monitorování znečištění	pollution monitoring
norma znečištění přípustného	pollution norm
prevence znečištění	pollution prevention
riziko znečištění	pollution risk
typ znečištění	pollution type
polonium	polonium
polybromovaný bifenyl	polybrominated biphenyl
dibenzodioxin polychlorovaný	polychlordibenzo-p-dioxin
polychlorovaný bifenyl	polychlorinated biphenyl
dibenzofuran polychlorovaný	polychlorinated dibenzofuran
polychlorovaný terfenyl	polychlorinated terphenyl
uhlovodík polycyklický aromatický	polycyclic aromatic hydrocarbon
uhlovodík polycyklický	polycyclic hydrocarbon
polyethylentereftalát	polyethylene terephtalate
polygon	polygon
polymer	polymer
polymerizace	polymerisation
polyvinylchlorid	polyvinyl chloride
rybník	pond
tůň	pool ; puddle ; puddle
papež	pope
populace	population
hustota obyvatelstva	population density
dynamika populace	population dynamics
ekologie populace	population ecology
růst obyvatelstva	population growth
pohyb obyvatel	population movement
struktura obyvatelstva	population structure
trend populační	population trend
porcelán	porcelain
houba mořská	poriferan
druh rostlinný Posidonia	posidonia ; neptunegrass
pozitron	positron
majetek	possession
pošta	post office
doúprava vody, dočištění vod odpadních	post-treatment
potomstvo	posterity
listonoš	postman
uhličitan draselný	potash
draslík	potassium
hnojivo draselné	potassium fertiliser
brambor	potato ; patato
drůbež	poultry
chov drůbeže	poultry farming
chudoba	poverty
výkon	power (physics) ; power
podnik elektrárenský	power company
elektrárna	power station
vyřazení elektrárny z provozu	power station derating
vztah energie-teplo	power-heat relation
praseodym	praseodymium
právo předkupní	pre-emption
oblast, v níž je uplatňováno právo předkupní	pre-emption zone
zásady prevence	precautionary principle
srážení ; srážení [chemické] ; srážení (chemické)	precipitation ; precipitation (chemical)
zvýšení množství srážek	precipitation enhancement
přesné strojírenství	precision engineering
predátor	predator
panelák ; panelový dům	prefabricated building
těhotenství	pregnancy
prelát	prelate
jednání přípravné	preliminary proceedings
pojistné	premium
příprava výrobků pro trh	preparation for market
předložka	preposition
právo užívání veřejného	prescription
zachování důkazů	preservation of evidence
konzervační prostředek	preservative
potraviny konzervované	preserve
prezident	president
tisk	press
lisování	pressing
tlak	pressure
přetlakové zařízení	pressure equipment
skupina nátlaková	pressure group
preventivní opatření	prevention measure
prevence požárů lesních	prevention of forest fires
preventivní péče o zdraví	preventive health measure
preventivní informace	preventive information
cena	price
politika cenová	prices policy
politika zdrojů cenová	pricing policy of resources
vzdělání základní	primary education
spotřeba energie primární	primary energy consumption
les původní	primary forest
primární sektor	primary sector
čištění primární	primary treatment
primát	primate
zásady udržitelnosti trvalé	principle of sustainability
tiskárna	printing work
soukromý automobil	private car
sféra soukromá	private domain
les soukromý	private forest
společná domácnost	private household
právo soukromé mezinárodní	private international law
právo soukromé	private law
sektor soukromý	private sector
individuální doprava	private transport
privatizace	privatisation
problém	problem
chobotnatec	proboscidean
organismus bezjaderný	procaryote
právo procesní	procedural law
analýza procesu	process analysis
technologie procesu	process technology
voda provozní	process water
výrobek zemědělský zpracovaný	processed agricultural produce
potraviny zpracované	processed foodstuff
zpracování	processing
zodpovědnost výrobce	producer liability
výrobek	product
propagace výrobku	product advertising
porovnání výrobku	product comparison
hodnocení výrobku	product evaluation
identifikace výrobku	product identification
informace o výrobku	product information
zodpovědnost za výrobek	product liability
životní cyklus výrobku	product life cycle
norma výrobku	product standard
politika výrobní	production policy
produktivita	productivity
trend produktivity	productivity trend
zisk	profit
údaje prognostické	prognostic data
program	programme
čára stavu hladiny vody	progress line
zákaz	prohibition
projekt	project
promethium	promethium
podpora obchodu a průmyslu	promotion of trade and industry
výslovnost	pronunciation
proces šíření	propagation process
hmota pohonná	propellant
vlastnosti látek	properties of materials
vlastnictví	property ; asset
ochrana vlastnictví	property protection
technika pohonu	propulsion technique
řízení trestní	prosecution
blahobyt	prosperity
prostata	prostate
prostituce	prostitution
protaktinium	protactinium
území chráněné	protected area
krajina chráněná	protected landscape
oblast chráněná mořská	protected marine zone
chráněné druhy	protected species
ochrana před okolím blízkým	protection from neighbours
ochrana zvířat	protection of animals
ochrana ptactva	protection of birds
ochrana druhů	protection of species
ochranný systém	protection system
ochranné opatření	protective measure
bílkovina	protein ; poly peptide
výrobek bílkovinový	protein product
protokol	protocol
prvok	protozoan
rčení	proverb ; saying ; maxim
oblast venkovská	province
úřad provinční/ regionální ; úřad provinční ; úřad regionální	provincial/regional authority (D) ; regional authority ; provincial authority
právo provinční/ regionální	provincial/regional law (D) ; regional legislation
prořezávání	pruning
psychiatr	psychiatrist
účinek psychický	psychic effect
účinek psychologický	psychological effect
vyčerpání psychické	psychological stress
psychologie	psychology
účinek psychosomatický	psychosomatic effect
nemoc psychosomatická	psychosomatic illness
veřejnost	public
přístup veřejný na pozemky	public access to land
činnost veřejná	public action
sociální pomoc	public aid
účast veřejnosti	public attendance
kampaň k osvětě veřejné	public awareness campaign
lázně veřejné	public bath
průzkum prospěchu pro veřejnost	public benefit inquiry
veřejná budova	public building
zakázka veřejná	public contract
dluh státní	public debt
diskuse veřejná	public discussion
sféra veřejná	public domain
výdaje z prostředků veřejných	public expenditure
finance veřejné	public finance
financování veřejné ; veřejné financování	public financing
funkce veřejná	public function
zdravotnictví veřejné	public health
jednání veřejné	public hearing
informace pro veřejnost	public information
průzkum veřejnosti	public inquiry
instituce veřejná	public institution
instituce veřejná povahy administrativní	public institution of administrative nature
instituce veřejná pro obchod a průmysl	public institution of industrial and commercial nature
právo veřejné mezinárodní	public international law
právo občanské	public law
využití oblasti mořské společné	public maritime domain
mínění veřejné	public opinion
průzkum mínění veřejného	public opinion polling
park veřejný	public park
účast veřejnosti	public participation
zásobování orgánů a vládních podniků	public procurement
kancelář státního žalobce	public prosecutor's office
styk s veřejností	public relations
sektor veřejný	public sector
veřejná doprava	public transport
vozidlo veřejné dopravy	public transport vehicle
podnik veřejných služeb	public utility
vlastnictví cest vodních veřejné	public waterways domain
veřejné stavby	public works
spolupráce organizací soukromých s veřejností	public-private partnership
plicní choroba	pulmonary disease
čerpadlo	pump
čerpání	pumping
purifikace	purification
čistící zařízení	purification facility
čistírna odpadních vod	purification plant
čištění filtrací půdní	purification through the soil
schopnost samočisticí	purifying power
purin	purin
státní převrat ; puč ; převrat	putsch ; coup d'état
pyralen	pyralene
pyrolýza	pyrolysis
čtyřúhelník	quadrilateral
zajištění kvality	quality assurance
osvědčení o kvalitě	quality certification
kontrola kvality	quality control
cíl kvality	quality objective
kvalita života	quality of life
norma kvality	quality standard
kamenolom	quarry
dobývání nerostů	quarrying
čtvrcení	quartering
králík	rabbit
vztahy rasové	race relations
dekantace	racking
radar	radar
záření	radiation ; radiations
škoda způsobená zářením	radiation damage
dávka záření	radiation dose
účinek záření	radiation effect
vystavení účinkům záření	radiation exposure
fyzika radiační	radiation physics
ochrana před zářením	radiation protection
legislativa k ochraně před zářením	radiation protection law
choroba z ozáření	radiation sickness
radio ; rozhlas	radio
rozhlasový program	radio programme
znečištění radioaktivní	radioactive contamination
dekontaminace radioaktivní	radioactive decontamination
ukládání odpadů radioaktivních	radioactive dumping
emise radioaktivní	radioactive emission
radioaktivní spad	radioactive fallout
radioaktivní znečišťující látka	radioactive pollutant
látka radioaktivní	radioactive substance
látka stopovací radioaktivní ; radioaktivní stopovací látka	radioactive tracer
odpady radioaktivní	radioactive waste ; nuclear waste
radioaktivita	radioactivity ; radioactive decay
prvek radioaktivní	radioelement
radionuklid	radionuclide
radium	radium
radon	radon
textil starý	rag
železniční doprava	rail traffic
železniční doprava	rail transport
vůz železniční	railroad vehicle ; carriage ; wagon
železnice	railway
síť železniční	railway network
nádraží	railway station
déšť	rain
les deštný	rain forest
voda dešťová	rain water
oddílná kanalizační síť	rain water sewer system
duha	rainbow
spad látek znečišťujících při dešti	rainout
budova na vyvýšeném místě	raising a site
test nahodilý	random test
řepka olejná	rape
test rychlý	rapid test
rychlovlak	rapid transit train
vzácné druhy	rare species
rastr	raster
rastr na vektor	raster to vector
rychlost změny	rate
surovina	raw material
spotřeba surovin	raw material consumption
zabezpečení surovinových zdrojů	raw material securing
voda surová	raw water
kinetika reakce	reaction kinetics
reaktor	reactor
bezpečnost reaktoru	reactor safety
soudnost	reasonableness
recept	recipe
průmysl recyklační	reclamation industry
technologie rekombinace DNA	recombinant DNA technology
doporučení	recommendation
zobcová flétna	recorder
registrace látek	recording of substances
regenerace krajiny	recovery of landscape
plán regenerace	recovery plan
rekreace	recreation
oblast rekreační	recreational area
recyklovatelnost	recyclability
plast recyklovatelný	recyclable plastic
materiál recyklovaný	recycled material
papír recyklovaný	recycled paper
recyklace	recycling
legislativa k řízení recyklace a odpadům	recycling management and waste law
potenciál recyklační	recycling potential
procento recyklace	recycling ratio
luňák červený	red kite
příliv červený	red tide
náprava	redress
rákos	reed
útes	reef
referenční služba	reference service
referendum	referendum ; plebiscite
referenční informace	referral information
referenční informační systém	referral information system
rafinérie	refinery
rafinace	refining
odraz	reflection
reflektometrie	reflectometry
zalesňování	reforestation
chladicí látka	refrigerant
chlazení	refrigeration
průmysl chladírenský	refrigeration industry
chladnička	refrigerator
lednice	refrigerator ; fridge
útočiště	refuge
uprchlík	refugee
vůz na odvoz odpadků	refuse collection vehicle
palivo z odpadků	refuse derived fuel
drtič odpadů	refuse shredder
kompost z odpadků a kalu	refuse-sludge compost
regenerace krajiny	regeneration
region	region
orgán správní oblastní	regional authority
úmluva regionální	regional convention
rozvoj regionální	regional development
právo regionální	regional law
park národní regionální	regional natural park
plán regionální	regional plan
plánování regionální	regional planning
legislativa regionální	regional regulation
statistika regionální	regional statistics
struktura regionální	regional structure
území registrované	registered site
evidence	registration
povinnost ohlašovací	registration obligation
postup při evidenci	registration proceeding
směrnice	regulation
směrnice k výrobě zemědělské	regulation of agricultural production
legislativa k limitům maximálním přípustným	regulation on maximum permissible limits
právo regulativní	regulative law
stěhování	rehousing
reintrodukce	reintroduction
relační databáze	relational database
vypouštění organismů	release of organisms
reliéf	relief (land)
náboženství	religion
dálkové monitorování	remote sensing
středisko dálkového průzkumu	remote sensing centre
odstraňování	removal
renesance	renaissance
renaturace	renaturation
zdroj energie obnovitelný	renewable energy source
zdroj surovin obnovitelný	renewable raw material
zdroj obnovitelný	renewable resource
opravářské služby	repair business
výměna	replacement
náklady na výměnu	replacement cost
zpráva o stavu životního prostředí	report on the state of the environment
zpráva pro ministra	report to the minister
postup při podávání zpráv	reporting process
zastupitelství	representation
represe	repression
přepracování paliva jaderného	reprocessing
rozmnožování	reproduction
manipulace reprodukční	reproductive manipulation
plaz ; plaz ; plaz	reptile ; reptile ; reptile
záchranná služba	rescue service
záchranný systém	rescue system
výzkum	research
výzkumné středisko	research centre
výzkum vlivů	research of the effects
politika výzkumná	research policy
výzkumný projekt	research project
rezervace	reserve
nádrž	reservoir
oblast obytná	residential area
oblast obytná s dopravou omezenou	residential area with traffic calmings
obytná budova	residential building
průtok minimální	residual amount of water
pesticid reziduální	residual pesticide
riziko z látek reziduálních	residual risk
odpady reziduální	residual waste
kal odpadní zbytkový	residual waste sludge
analýza látek reziduálních	residue analysis
zbytky z drcení	residue of grinding
recyklace látek reziduálních	residue recycling
pryskyřice	resin
rostlina pryskyřičná	resinous plant
rezistence	resistance (biological) ; resistance
usnesení	resolution
rozlišení	resolution ; resolution (parameter)
resorpce	resorption
zdroj	resource ; resources
ocenění zdrojů	resource appraisal
ochrana zdrojů	resource conservation
využívání zdrojů	resource exploitation
zásoby zdrojů	resource reserve
využití zdrojů	resource utilisation
hospodaření se zdroji	resources management
respirace	respiration
vzduch vdechovaný	respiratory air
respirační choroba	respiratory disease
dýchací ústrojí	respiratory system
nádrž záchytná	retaining reservoir
osmóza reverzní	reverse osmosis
rhenium	rhenium
nosorožec	rhino ; rhinoceros
rhodium	rhodium
kosočtverec	rhombus ; rhomb
rýže	rice
zvyšování hladiny moře	rising sea level
výměna informací ohledně rizika	risk communication
řeka	river
koryto říční	river bed
voda říční	river water
silnice	road
síť silniční	road network
posypová sůl	road salt
hornina	rock
hlodavec	rodent
roentgenium	roentgenium
hluk z dopravy silniční	rolling noise
střecha ; střecha ; střecha ; střecha ; střecha ; střecha ; střecha	roof ; roof ; roof
kořen	root
růženec	rosary
rotační pec	rotary furnace
cesta	route
pryž	rubber
rubidium	rubidium
rubín	ruby
oblast venkovská	rural area
ruthenium	ruthenium
rutherfordium	rutherfordium
bezpečnost	safety ; security
bezpečnostní opatření	safety measure
sahara	sahara
plachetnice	sailing ship
mlok	salamander
losos	salmon
sůl	salt
voda slaná	salt water
samarium	samarium
písek	sand
duna písečná	sand dune
sanitární technika	sanitary fitting
sardinka	sardine
družice	satellite
piliny	sawdust
říci	say
skandium	scandium
škola	school
věda	science
spolupráce vědecká	scientific co-operation
diskuse vědecká	scientific dispute
vědecký výzkum	scientific research
šroub	screw
šroubovák	screwdriver
sochař	sculptor
moře ; moře	sea
hladina moře	sea level
voda mořská	sea water
seaborgium	seaborgium
břeh mořský	seashore
období roční	season
vzdělávání středoškolské	secondary education
sediment	sediment
sedimentace [geologie] ; sedimentace	sedimentation (geology) ; sedimentation
sedimentologie	sedimentology
vidět	see
semeno	seed
osivo	seed
aktivita seismická	seismic activity
vlna přílivová vysoká	seismic sea wave ; tsunami
selen	selenium
sémantika	semantics
polokov	semi-metal
polovodič	semiconductor
sémiotika	semiotics ; semiology
separátor	separator
server	server
umělý mokřad nebo kořenové čištění odpadních vod	sewage farm
pohlaví	sex ; gender
sextant	sextant
žralok	shark
ovce	sheep
měkkýš vodní	shellfish ; shellfish
pastýř	shepherd
loď	ship
obchod	shop
středisko nákupní	shopping centre
keř	shrub
účinek vedlejší	side effect
siemens	siemens
křemík	silicon
hedvábí	silk
naplavenina	silt
stříbro	silver
simulace	simulation
dráha lyžařská	ski run
lyžování	skiing
pokožka	skin
lebka	skull
škvára	slag
porážet	slaughter
jatky	slaughter-house
jatka	slaughterhouse ; slaughter-house ; abattoir ; butchery ; shambles
spánek	sleep
porucha spánku	sleep disturbance
bačkora ; pantofle	slipper
svah	slope
pomalu	slow
kal	sludge
neštovice	smallpox
úsměv	smile
smog	smog
smogový varovný systém	smog warning
kouř	smoke
kouření	smoking
had	snake
sníh	snow
lavina sněhová	snowslide
vsakování	soaking
mýdlo	soap
sociální chování	social behaviour
skupina společenská	social group
péče sociální	social protection
psychologie sociální	social psychology
sociologie	social science
průzkum společenský	social survey
péče sociální	social welfare
společnost	society
aspekt socioekonomický sídel lidských	socioeconomic aspect of human settlements
sociologie jazyka	sociolinguistics ; sociology of language
sociologie	sociology
ponožka	sock
sodík	sodium
software	software
vývoj programu počítačového	software development
půda	soil
hnojení půdy	soil fertilisation
úrodnost půdy	soil fertility
půdoznalství	soil science
sluneční článek	solar cell
sluneční kolektor	solar collector
energie sluneční	solar energy
technologie sluneční energie	solar energy technology
elektrárna solární	solar power station
záření sluneční	solar radiation
rozpustnost	solubility
rozpouštědlo	solvent
pták zpěvný	songbird
saze	soot
sorpce	sorption
zvuk	sound
měření zvuku	sound measurement
vesmír [meziplanetární]	space ; space ; space (interplanetary) ; interplanetary space
let kosmický	space travel
záškrt	spasmodic croup
druh	species
řeč	speech
rychlost	speed
pavouk	spider
lžíce	spoon
sport	sport
jaro	spring
pramen	spring ; spring (hydrology, land)
voda pramenitá	spring water
náměstí	square
norma	standard
potraviny základní	staple food
hvězda	star
škrob	starch
stanice	station
statistika	statistics
parní generátor	steam generator
ocel	steel
sterilizace	sterilisation
steroid	steroid
zásoby	stocking
žaludek	stomach
kámen	stone
čáp	stork
bouře	storm ; tempest
příběh	story
kamna	stove
strategický	strategic
stres	stress
stroncium	strontium
subjekt	subject ; topic
ponorka	submarine
sedání	subsidence
dotace	subsidy
předměstí	suburb
cukr	sugar
sebevražda	suicide
síra	sulphur
koncentrace síry	sulphur concentration
oxid siřičitý	sulphur dioxide
léto	summer
samoobsluha ; supermarket	supermarket
supernova	supernova
dodávka	supply
nabídka a poptávka	supply and demand
napětí povrchové	surface tension
chirurg	surgeon
chirurgie	surgery
vodní ptactvo	swans, geese and ducks
sladký	sweet
sladidlo	sweetener
bazén	swimming pool
meč	sword
symbióza	symbiosis
symfonie	symphony
synagoga	synagogue
syndrom	syndrome
ekologie společenstev	synecology
syntax	syntax
syfilis	syphilis
stůl	table
krejčí	tailor
převzetí	takeover
cisternové vozidlo	tanker
loď cisternová	tanker ; tanker (ship)
tanin	tannin
tantal	tantalum
skupina cílová	target group
daň	tax
taxonomie	taxonomy
čaj	tea
učitel	teacher
výuka	teaching
technecium	technetium
technologie	technology
přenos technologie	technology transfer
telekomunikace	telecommunications ; telecommunication
telemetrie	telemetry
televizor	television
televize	television
program televizní	television programme
tellur	tellurium
teplota	temperature
deset	ten
teratogen	teratogen
terbium	terbium
terminologie	terminology
termit	termite
terakota	terracotta ; terracotta ; terracotta ; terra cotta
území	territory
terorismus	terrorism
terorista	terrorist
terciární sektor	tertiary sector
test	test
testosteron	testosterone
průmysl textilní	textile industry
rostlina textilní	textile plant
thallium	thallium
poděkování	thank you
terapie	therapy
tepelné zařízení	thermal equipment
elektrárna tepelná	thermal power plant
termodynamika	thermodynamics
práce diplomová/ dizertační	thesis
thorium	thorium
tisíc	thousand
thulium	thulium
hrom	thunder
bouřka	thunderstorm
štítná žláza	thyroid
elektrárna přílivová	tidal power station
voda přílivová	tidal water
tygr	tiger
les vysoký	timber forest
čas	time
časové pásmo	timezone
cín	tin
tkáň	tissue
titan	titanium
oxid titaničitý	titanium dioxide
ropucha	toad
tabák	tobacco
rajče	tomato
zítřek	tomorrow
topografie	topography
topologie	topology
tornádo	tornado
torpédo	torpedo
želva	tortoise
turistika	tourism
kov toxický	toxic metal
látka toxická	toxic substance
toxicita	toxicity
toxikologie	toxicology
toxin	toxin
prvek stopový	trace element
rostlina cévnatá	tracheophyte ; vascular plant
obchod ; povolání	trade
obchod	trade
obchod a spotřeba	trade and consumption
odbory zaměstnanecké	trades union
tradicní	traditional
provoz silniční	traffic
hluk z dopravy	traffic noise
vlak	train
školení	training
školící středisko	training centre
dráha	trajectory
prvek přechodný	transition element ; transition metal
překládání ; pøeklad	translation
transpirace	transpiration
přenos	transport
přeprava	transport ; transportation
cestování	travel
smlouva	treaty
strom	tree
trojúhelník	triangle
tritium	tritium
trolejbus	trolley bus ; trolleybus
pozoun	trombone
hladina trofická	trophic level
les tropický	tropical forest
rostlina tropická	tropical plant
les tropický deštný	tropical rain forest
tropy	tropics ; torrid zone
kalhoty	trousers
pstruh	trout
tundra	tundra
wolfram	tungsten
tunel	tunnel
zákal	turbidity
turbína	turbine
View lemma information ; krocan	turkey
dvojče	twin
tajfun	typhoon
pneumatika	tyre
záření ultrafialové	ultraviolet radiation
dráha podzemní	underground railway
dráha podzemní	underground train
nezaměstnanost	unemployment
kopytnatec	ungulate
ununbium	ununbium
ununhexium	ununhexium
ununoctium	ununoctium
ununpentium	ununpentium
ununquadium	ununquadium
ununseptium	ununseptium
ununtrium	ununtrium
výchova	upbringing
uran	uranium
urbanizace	urbanisation
moč	urine
medvěd	ursid
užitečný	useful
očkování	vaccination
vysavač	vacuum cleaner
údolí	valley
vzácný	valuable
upír ; vampýr	vampire
vanad	vanadium
vandalismus	vandalism
tlak par vodních	vapour pressure
vektor	vector
zelenina	vegetable
olej rostlinný	vegetable oil
vozidlo	vehicle
větrání	ventilation
sloveso	verb
obratlovec	vertebrate
veterán	veteran
veterináø	veterinarian
veterináø ; zvìrolékaø	veterinarian ; veterinary
proveditelný	viable ; viable ; feasible
vesnice	village
vináza	vinasse
ocet	vinegar
virologie	virology
virus	virus
viskozita	viscosity
vitamín	vitamin
slovník	vocabulary
látka těkavá	volatile substance
těkavost	volatility
erupce sopečná	volcanic eruption
činnost sopečná	volcanism
sopka	volcano
volejbal	volleyball
napětí	voltage
volby	voting
samohláska ; vokála ; vokál	vowel
vulkanizace	vulcanisation
stěna	wall
mrož	walrus
válka	war
živočich teplokrevný	warm-blooded animal
vosa	wasp
odpady	waste
popelnice	waste bin
zákon o odpadech	waste disposal act
halda	waste dump
papír odpadový	waste paper
vody odpadní	waste water
čištění odpadních vod	waste water purification
voda	water
vodstvo	water ; body of water
provzdušňování vody	water aeration
náklady na zajištění vody	water cost
odsolování vody	water desalination
blecha vodní	water flea
hladina vodní	water level
mlýn vodní	water mill
vodní pólo	water polo
legislativa k ochraně vod	water protection legislation
čerpadlo vodní	water pump
nádrž vodní	water reservoir
zdroj vody	water resource
zasolování vody	water salination
zásobování vodou	water supply
úprava vody	water treatment
studna	water well
vodopád	waterfall
vodní ptactvo	waterfowl
rozvodí	watershed
zbraň	weapon
počasí	weather
pavucina	web ; spider web
plevel	weed
víkend	weekend
hmotnost	weight
sváření	welding
studna	well
velryba	whale
lov velryb	whaling
pšenice	wheat
invalidní vozík	wheelchair
syrovátka	whey
bílý	white
zvíře žijící volně	wild animal
živočich žijící volně	wild fauna ; wildlife ; wild animals
rostlina planě rostoucí	wild plant
volná příroda	wildlife ; 野生生物
vrba	willow
vítr	wind
energie větrná	wind power
mlýn větrný	windmill
okno	window
víno	wine
zima	winter
čarodějnice	witch
svědek	witness
čaroděj	wizard ; sorcerer ; magician
vlk	wolf
les	wood
dřevěný výrobek	wood product
vlna	wool
slovo	word
úraz pracovní	work accident
pracoviště	workplace
svět	world
místo dědictví světového	world heritage site
světová válka	world war
čin protiprávní	wrongful act
xenon	xenon
kvasinky	yeast
žlutá	yellow
úroda	yield
výnos	yield
mládež	young
yterbium	ytterbium
yttrium	yttrium
zebra	zebra
nula	zero ; null
zinek	zinc
zirkonium	zirconium
zvěrokruh	zodiac
zoologická zahrada	zoological garden
zoologie	zoology
choroba přenosná ze zvířete na člověka ; zoonóza	zoonosis
Ålandy	Åland Islands
renovace	återställande ; rehabilitation
