English	Estonian
AIDS	aids ; AIDS
AOX value	AOX-väärtus
ASEAN ; Association of Southeast Asian Nations	ASEAN
Abidjan	Abidjan
Abkhaz ; Abkhazian ; Abkhazian	abhaasi keel
Abkhazia	Abhaasia
Abuja	Abuja
Aegean Sea	Egeuse meri
Afar ; Afar	afari keel ; danakili keel
Africa	Aafrika
Afrikaans	afrikaani keel
Albania ; Republic of Albania	Albaania
Algeria ; People's Democratic Republic of Algeria	Alžeeria Demokraatlik Rahvavabariik ; Alžeeria
American Samoa	Ameerika Samoa
Americas	Ameerika
Ames test	Ames'i katse (test)
Amsterdam	Amsterdam
Andorra ; Principality of Andorra	Andorra
Angola ; Republic of Angola	Angola
Anguilla	Anguilla
Antarctic Ocean ; Southern Ocean	Lõunapolaarmeri
Antarctic ecosystem	antarktiline ökosüsteem
Antarctica	Antarktis ; Antártida
Antigua and Barbuda	Antigua ja Barbuda
April	aprill
Arabic ; Standard Arabic	araabia keel
Arctic Ocean	Põhjajäämeri
Arctic ecosystem	arktiline ökosüsteem
Argentina ; Argentine Republic	Argentina
Arizona	Arizona
Armenia	Armeenia
Armenian	armeenia keel
Articulata	lüliloomad
Aruba	Aruba
Asia	Aasia
August	august
Australia ; Commonwealth of Australia	Austraalia
Austria ; Republic of Austria	Austria
Austria-Hungary ; Austro-Hungarian Empire	Austria-Ungari
Azerbaijan ; Republic of Azerbaijan	Aserbaidžaan
Azerbaijani ; Azeri ; Azerbaijani Cluster	Aserbaidžaani ; aserbaidžaani ; aserbaidžaani keel
BBS ; bulletin board system	teatetahvel (Internet)
Bahamas ; Commonwealth of the Bahamas ; Bahama Islands	Bahama
Bahrain	Bahrein
Balearic Islands	Baleaarid
Bangladesh ; People's Republic of Bangladesh	Bangladesh
Basque ; Basque	baski keel
Beijing	Peking
Belarus ; Republic of Belarus	Valgevene
Belarusan ; Belarusan ; Belarusian ; Belorussian ; Byelorussian	valgevene keel
Belgium ; Kingdom of Belgium	Belgia
Belgrade	Belgrad
Belize	Belize
Belmopan	Belmopan
Bengali ; Bengali	bengali keel
Berlin	Berliin
Bermuda	Bermuda
Berne	Bern
Bhutan ; Kingdom of Bhutan	Bhutan
Birmingham	Birmingham
Black Sea	Must meri
Bokmål	bokmål
Bolivia ; Republic of Bolivia	Boliivia
Bonn	Bonn
Bosnia and Herzegovina ; Republic of Bosnia and Herzegovina	Bosnia ja Hertsegoviina
Bosnian ; Bosnian	bosnia keel
Botswana ; Republic of Botswana	Botswana
Brazil	Brasiilia
Breton ; Breton	bretooni
Brunei ; Negara Brunei Darussalam	Brunei
Brussels	Brüssel
Bucharest	Bukarest
Bulgaria ; Republic of Bulgaria	Bulgaaria
Bulgarian ; Bulgarian	Bulgaaria ; bulgaaria keel
Burmese	birma keel
Burundi ; Republic of Burundi	Burundi
CD-ROM	laserketas, CD-ROM
CD-ROM search service	CD-ROM-otsiteenindus ; CD-ROM-otsiteenus
CFC ; chlorofluorocarbon	klorofluorosüsivesinik, freoon
CFC and halons prohibition	CFC-de ja haloonide keelustamine
Cambodia ; Kingdom of Cambodia	Kambodža
Cameroon ; Republic of Cameroon	Kamerun
Canada	Kanada
Caribbean Area ; Caribbean	Kariibid
Caribbean Sea	Kariibi meri
Caspian Sea	Kaspia meri
Castilian ; Spanish ; Spanish	hispaania ; hispaania keel
Catalan ; Catalan	katalaani
Cayman Islands	Kaimanisaared
Central Africa	Kesk-Aafrika
Central America	Kesk-Ameerika
Central Asia	Kesk-Aasia
Chad ; Republic of Chad	Tšaad
Chile ; Republic of Chile	Tšiili
Christmas	Jõulud
Christmas Island	Jõulusaar
Christmas tree	jõulupuu
Chuvash ; Chuvash ; Chuwash ; Chovash ; Chavash ; Chttash	tšuvaši
Colombia ; Republic of Colombia	Colombia
Community act	Euroopa Ühenduse õigusakt
Community budget	Euroopa Ühenduse eelarve
Community finance	Euroopa Üheduse finantsid
Community law	Euroopa Ühenduse õigus
Community legal system	Euroopa Ühenduse õigussüsteem
Community ruling	Euroopa Ühenduse määrus
Copenhagen	Kopenhaagen
Court of Justice of the European Communities	Euroopa Kohus
Croatia ; Republic of Croatia	Horvaatia
Croatian ; Croation	horvaadi keel
Czech ; Czech	tšehhi keel
Czech Republic ; Czechia	Tšehhi
DDT ; dichloro-diphenyl-trichloroethane	DDT
DNA ; deoxyribonucleic acid	DNA
Dakar	Dakar
Danish	taani keel
December	detsember
Democratic Republic of the Congo ; Congo-Kinshasa	Kongo Demokraatlik Vabariik
Denmark ; Kingdom of Denmark	Taani
Dominican Republic	Dominikaani Vabariik
Dutch	hollandi keel
EC Council of Ministers	EÜ ministrite nõukogu
EC Treaty	EÜ leping
EC directive	EÜ direktiiv
EC directive on biocides	EÜ biotsiididirektiiv
EC directive on waste disposal	EÜ jäätmedirektiiv
EC directive on water protection	EÜ veekaitsedirektiiv
EC ecolabel	EÜ ökomärgis, EÜ keskkonnamärgis
EC policy	EÜ poliitika, EÜ strateegia
EC regulation	EÜ määrus
EC regulation on eco-management and audit	EÜ määrus keskkonnajuhtimise ja auditi kohta
EC regulation on existing chemicals	EÜ määrus olemasolevate kemikaalide kohta
EIA (local)	keskkonnamõju hindamine ; KMH
EIA ; environmental impact assessment	keskkonnamõju hindamine ; KMH
EIA directive	KMH direktiiv
EIA law	KMH seadus
EU ; European Union	Euroopa Liit
EU Council	Euroopa Nõukogu
Earth-Sun relationship	Päikese mõju Maale
East Africa	Ida-Aafrika
East Timor ; Democratic Republic of Timor-Leste	Ida-Timor
East-West relations	Ida ja Lääne suhted
East-West trade	Ida ja Lääne vaheline kaubandus
Eastern Asia ; East Asia	Ida-Aasia
Eastern Europe	Ida-Euroopa
Egypt ; Arab Republic of Egypt	Egiptus
El Salvador ; Republic of El Salvador	El Salvador
England	Inglismaa
English	inglise keel
English garden	inglise park
Erevan ; Yerevan	Jerevan
Eritrea	Eritrea
Esperanto ; Esperanto	esperanto keel ; esperanto
Estonia ; Republic of Estonia	Eesti ; Eesti Vabariik ; إيستوني
Estonian	eesti ; eesti keel
Ethiopia ; Federal Democratic Republic of Ethiopia	Etioopia
Euratom	Euroopa Aaatomienergiaühendus
Europe	Euroopa
European Commission	Euroopa Komisjon
European Communities	Euroopa Ühendused
European Court of Justice	Euroopa Kohus
European Environment Agency	Euroopa Keskkonnaagentuur
European Environmental Council	Euroopa Keskkonnanõukogu
European Monetary Fund	Euroopa Valuutafond
European Monetary System ; EMS	Euroopa valuutasüsteem
European Parliament	Euroopa Parlament
European nature reserve	hoiuala (Natura 2000 võrgustiku ala)
European standard	Euroopa standard
Falkland Islands	Falklandi saared
Faroe Islands	Fääri saared
Faroese ; Faeroese	fääri keel
February	veebruar
Finland ; Republic of Finland	Soome
Finnish	soome ; soome keel
Flanders ; Flemish region	Flaaminaa
Flevoland	Flevoland
France	Prantsusmaa
French ; French	prantsuse keel
French Guiana	Prantsuse Guajaana
French Polynesia	Prantsuse Polüneesia
French formal garden	prantsuse park
Friday	reede
Frisian ; Western Frisian	frisa ; friisi
GDP ; gross domestic product	sisemajanduse kogutoodang ; SKT
GDR ; German Democratic Republic	Saksa Demokraatlik Vabariik ; Saksa DV
GIS digital format	kaugseireandmevorming
GIS digital system	geoinfosüsteem
GIS digital technique	digiteerimistehnika
GIS laboratory	GIS-laboratoorium
Gabon ; Gabonese Republic	Gabon
Galician ; Galician	galeegi keel
Gambia ; Gambia ; Gambia ; Gambia ; The Gambia ; Republic of The Gambia	Gambia
Gaza Strip	Gaza tsoon
Georgia	Gruusia
Georgia	Georgia
Georgian ; Georgian	gruusia keel ; georgia keel
German	saksa keel
Germany ; Federal Republic of Germany	Saksamaa
Gibraltar	Gibraltar
Global Environment Facility ; GEF	Ülemaailmne Keskkonnafond
Great Britain ; Britain	Suurbritannia
Greece ; Hellenic Republic	Kreeka
Greek ; Greek	kreeka ; kreeka keel
Greenland	Gröönimaa
Grenada	Grenada
Guadeloupe	Guadeloupe
Guam ; Guam ; Guam	Guam
Haiti ; Republic of Haiti	Haiti
Hanover	Hannover
Happy New Year	õnnelikku uut aastat
Hebrew	Heebrea ; heebrea keel ; ivriit
Hindi ; Hindi	hindi ; hindi keel
Holland ; Kingdom of the Netherlands ; The Netherlands	Madalmaade Kuningriik
Honduras ; Republic of Honduras	Honduras
Hungarian	ungari keel
Hungary ; Republic of Hungary	Ungari
IMCO code	IMCO kood
IMF ; International Monetary Fund	Rahvusvaheline Valuutafond
ISO standard	ISO-standard
Iceland ; Republic of Iceland	Island
Icelandic	islandi keel
Iliad	Ilias
India ; Republic of India	India
Indian Ocean	India ookean
Indonesia ; Republic of Indonesia	Indoneesia
Indonesian	indoneesia keel
International Court of Justice	Rahvusvaheline Kohus
Internet	Internet
Iran ; Islamic Republic of Iran	Iraan
Iraq ; Republic of Iraq	Iraak
Ireland ; Republic of Ireland	Iirimaa
Irish ; Irish ; Irish Gaelic ; Irish	iiri ; iiri keel
Isle of Man ; Isle of Mann ; Mann	Man
Israel ; State of Israel	Iisrael
Italian ; Italian	itaalia keel
Italian Republic ; Italy	Itaalia
Ivory Coast ; Cote d'Ivoire ; Republic of Cote d'Ivoire	Elevandiluurannik
Jakarta ; Djakarta ; DKI Jakarta	Jakarta
Jamaica	Jamaica
Japan ; State of Japan	Jaapan
Japanese ; Japanese	jaapani keel
Jordan ; Hashemite Kingdom of Jordan	Jordaania
Judaism	judaism ; juutlus
July	juuli
June	juuni
Karelian	karjala
Kazakh ; Kazakh	kasahhi keel
Kazakhstan ; Republic of Kazakhstan	Kasahstan
Kenya ; Republic of Kenya	Kenya
Khartoum	Hartum
Kiribati ; Republic of Kiribati	Kiribati
Korean ; Korean	korea keel
Kosovo	Kosovo ja Metohija ; Kosovo
Kyrgyzstan ; Kyrgyz Republic	Kõrgõzstan
Laos ; Lao People's Democratic Republic	Laos
Latin ; Latin	ladina keel
Latvia ; Republic of Latvia	Läti
Latvian ; Latvian	läti keel
Lesotho ; Kingdom of Lesotho	Lesotho
Liberia ; Republic of Liberia	Libeeria
Liechtenstein ; Principality of Liechtenstein	Liechtensteini Vürstiriik
Lithuania ; Republic of Lithuania	Leedu
Lithuanian ; Lithuanian	leedu keel
Lower House	esindajatekoda
Lower Saxony	Alam-Saksi
Macedonian ; Macedonian	makedoonia keel
Malawi ; Republic of Malaŵi	Malawi
Malta ; Republic of Malta	Malta
Maltese	malta keel
Maori	Maoori
March	märts
Markov chain ; Markoff chain	Markovi ahel
Marshall Islands ; Republic of the Marshall Islands	Marshalli Saared
Martinique	Martinique
May	mai
Mayotte	Mayotte
Mecca	Meka
Mediterranean Area	Vahemerepiirkond
Mediterranean Sea	Vahemeri
Mediterranean climate	vahemerekliima, mediterraanne kliima
Mediterranean forest	mediterraanne mets
Mediterranean wood	früügana, gariig, makja, mediterraanne võsa
Mercury	Merkuur
Merry Christmas	häid jõule
Merry Christmas and a happy New Year	Häid Jõule ja õnnelikku uut aastat
Mexico ; United Mexican States	Mehhiko
Milan	Milano
Milky Way ; Galaxy	Linnutee ; Galaktika
Monaco	Monaco
Monday	esmaspäev
Montenegro	Montenegro
Montserrat	Montserrat
Morocco ; Kingdom of Morocco	Maroko
Moscow	Moskva
Mount Fuji	Fuji
Munich	München
Myanmar	Birma
NIMBY aptitude ; NIMBY attitude	mitte-minu-naabrusse-suhtumine
NOEL	täheldatavat toimet mitteavaldav tase
Namibia	Namiibia
Neapolitan ; Neapolitan	napoli keel
Nepal	Nepal
Nepali ; Nepali	nepali keel
Neptune	Neptuun
New Caledonia	Uus-Kaledoonia
New Zealand	Uus-Meremaa
Nicaragua	Nicaragua
North Africa	Põhja-Aafrika
North America	Põhja-Ameerika
North Atlantic Ocean	Atlandi ookeani põhjaosa
North-South relationship	Põhja ja Lõuna suhted
Northern Ireland	Põhja-Iirimaa
Norway ; Kingdom of Norway	Norra
November	november
Novial	noviaal
Oceania	Okeaania
Oslo	Oslo
Pakistan ; Islamic Republic of Pakistan	Pakistan
Papua New Guinea	Paapua Uus-Guinea
Paris	Pariis
Parliament	parlament, esinduskogu
People's Republic of China ; China	Hiina
Persian ; Western Farsi ; Farsi	pärsia keel ; iraani keel
Peru ; Republic of Peru	Peruu
Poland	Poola
Polish ; Polish	poola ; poola keel
Portugal	Portugal
Portuguese ; Portuguese	Portugali ; portugali keel
Puerto Rico	Puerto Rico
Punjabi ; Panjabi	pandžabi keel
Republic of the Congo ; Congo-Brazzaville	Kongo Vabariik
Romania	Rumania
Romanian ; Romanaian	rumeenia keel
Russia ; Russian Federation	Venemaa ; Venemaa Föderatsioon
Russian ; Russian	vene keel
Saint-Pierre and Miquelon	Saint-Pierre ja Miquelon
Sakhalin ; Saghalien	Sahhalin
Saturday	laupäev
Saturn	Saturn
Saxony	Saksimaa
Scotland	Šotimaa
Seine	Seine
Senegal	Senegal
Serbia	Serbia
Serbia and Montenegro	Serbia ja Montenegro ; Serbia ja Tšernogooria
Serbian ; Serbian	serbia keel
Sindhi ; Sindhi	sindhi keel
Slovak ; Slovak	Slovaki ; slovaki keel
Slovakia	Slovakkia
Slovene ; Slovenian ; Slovenian	sloveeni keel
Sochi	Sotši
South America	Lõuna-Ameerika
Southeast Asia	Kagu-Aasia
Southern Asia ; South Asia	Lõuna-Aasia
Spain	Hispaania
Sri Lanka	Sri Lanka
Sudan	Sudaan
Sunday	pühapäev
Suriname	Suriname
Swahili	suahiili keel
Sweden	Rootsi
Swedish	rootsi keel
Switzerland	Šveits
Syria ; Syrian Arab Republic	Süüria
Tagalog	tagalogi keel ; pilipino keel
Tamil ; Tamil	tamili keel
Tanzania	Tansaania
Telugu ; Telugu	telugu keel
Tennessee	Tennessee
Thai ; Thai	tai keel
Thailand	Tai
Thuringia	Tüüringi
Thursday	neljapäev
Togo	Togo
Tonga	Tonga
Tuesday	teisipäev
Turkey	Türgi
Turkish ; Turkish	Türgi ; türgi keel
UN ; United Nations	Ühinenud Rahvaste Organisatsioon
Uganda ; Republic of Uganda	Uganda
Ukrainian ; Ukrainian	ukraina keel
United Kingdom ; United Kingdom of Great Britain and Northern Ireland ; UK	Suurbritannia ja Põhja-Iiri Ühendkuningriik ; Suurbritannia ; Ühendkuningriik
United States ; United States of America ; America ; US ; U.S. ; U.S.A. ; U.S. of A. ; States	Ameerika Ühendriigid
Uranus	Uraan
Urdu ; Urdu	urdu keel
Utah	Utah
Vaduz	Vaduz
Venezuela	Venezuela
Venice	Venezia
Venus	Veenus
Vienna	Viin
Vietnamese ; Vietnamese	vietnami ; vietnami keel
Volapük	volapük
Wales	Wales
Wednesday ; quarta-feira	kolmapäev
Welsh ; Welsh	uelsi ; kõmri keel
Western Asia ; Southwest Asia	Lääne-Aasia
Western Europe	Lääne-Euroopa
Wiktionary	Vikisõnaraamat
World Wide Web ; WWW	veeb, WWW ; veeb ; WWW
Wyoming	Wyoming
Xhosa	koosa keel
Yiddish	jidiši keel ; jidiš
Yugoslavia	Jugoslaavia
Zambia ; Republic of Zambia	Sambia
Zanzibar	Sansibar
Zimbabwe ; Republic of Zimbabwe	Zimbabwe
Zulu	suulu keel
aback	jahmunud
abacus	abakus
abandoned industrial site	vanareostusobjekt, vanasaastusobjekt
abandoned vehicle ; car wreck	mahajäetud sõiduk
abbreviation	lühend
abiotic environment	elutu keskkond ; elutu ümbruskond
abiotic factor	abiootiline tegur
abortive	äpardunud
abridge	lühendama
abscess	abstsess
absorption	absorptsioon
acceptable daily intake	lubatud ööpäevaannus
acceptable risk level	talutav riskitase
access road	juurdepääsutee
access to administrative documents	juurdepääsuõigus haldusdokumentidele
access to culture	juurdepääs kultuuriväärtustele
access to information	juurdepääs teabele (informatsioonile)
access to the courts	juurdepääs õigusmõistmisele
accident	õnnetus
accident source ; cause of the accident	õnnetusallikas
accidental release of organisms	organismide ettekavatsemata vabakslaskmine
accordion ; squeeze box ; piano accordion	akordion ; lõõtspill
account	konto
accountancy	raamatupidamine
accounting	arvepidamine
accounting system	arvepidamissüsteem, raamatupidamissüsteem ; arvepidamissüsteem ; raamatupidamissüsteem
accumulator	akumulaator
acid	hape
acid deposition	happesadenemine
acid rain	happevihm
acidification	hapestumine
acidity	happesus
acidity degree	happesusaste
acorn	tammetõru
acoustic comfort	akustiline mugavus
acoustic filter ; audio filter	akustiline filter ; helifilter
acoustic insulation	heliisolatsioon
acoustic level ; sound pressure level	helivaljus, helitase ; helivaljus ; helitase
acoustic property	heliomadus
acoustical quality	helikvaliteet
acoustics	akustika
acrid	kibe
act ; deed	akt ; seadus ; tegu ; toiming
actinide	aktinoid
actinium	aktiinium
action group ; action committee	huvirühm
activated carbon	aktiivsüsi
activated sludge	aktiivmuda
active participation	aktiivne osalemine
active population	tööjõuline elanikkond
adaptation period	kohanemisaeg
addition	liitmine
additional packaging	lisapakend
additive	lisand
adequate food supply	toidu piisavus
adhesive	liim ; liim[aine] ; liim(aine) ; liimaine
adjective ; describing word	omadussõna
administration ; direction ; management	juhtimine ; juhtimine, haldamine ; haldamine
administrative body ; administrative organ	haldusorgan
administrative boundary	halduspiir
administrative competence ; administrative ability	halduspädevus
administrative deed	haldusakt
administrative fiat	halduskäsk, halduskorraldus ; halduskäsk ; halduskorraldus
administrative instructions	halduskoolitus
administrative law	haldusõigus
administrative occupation	haldustöö
administrative organisation	haldusorganisatsioon
administrative procedure	halduskohtumenetlus
administrative sanction	haldussanktsioon
adsorption	adsorptsioon
adult	täisealine
adult education	täisealisekoolitus
adventure	seiklus
advertisement ; promotion	kuulutus ; reklaam
advice	nõuanne
aeration	õhustamine, õhustus, aeratsioon ; õhustamine ; õhustus ; aeratsioon
aerial	antenn
aerial photograph	aerofoto
aerial photography	aerofotomõõdistamine, aerofotomõõdistus ; aerofotomõõdistamine ; aerofotomõõdistus
aerobic process	aeroobne protsess
aerobic treatment	aeroobne puhastus
aerobiology	aerobioloogia
aerodynamic noise	aerodünaamiline müra
aeroplane ; bird ; plane	lennuk ; aeroplaan
aerosol	aerosool
aesthetics	esteetika
afforestation ; tree planting ; afforestment	metsastamine
afterburning ; afterburning ; afterburner	järelpõletus
age	vanus
aggressive	kallaletungiv
aggressor ; assailant ; attacker ; assaulter	kimbutaja
agreement	leping
agreement	kokkulepe
agri-foodstuff	agraartööstus
agricultural biotechnology	agrobiotehnoloogia
agricultural building	põllumajandushoone
agricultural disaster	agrokatastroof
agricultural ecology ; agroecology	agroökoloogia ; põllumajandusökoloogia
agricultural economics	põllumajandusökonoomika, agraarökonoomika
agricultural effluent	põllumajandusheitmed
agricultural engineering	agrotehnoloogia
agricultural equipment	põllumajandusseadmed
agricultural equipment ; agricultural machinery ; farm machinery	põllumajandusmasinad ; põllumajandusseadmed
agricultural exploitation	põllumajanduskasutus
agricultural hydraulics	hüdromelioratsioon
agricultural land	põllumajandusmaa
agricultural landscape	põllumajandusmaastik
agricultural legislation	agraarõigus
agricultural management	põllumajandustootmise juhtimine
agricultural method	agrotehnika
agricultural pest	põllukahjur
agricultural planning	põllumajanduse planeerimine
agricultural policy	agraarpoliitika
agricultural pollution	põllumajandusreostus
agricultural product	põllumajandussaadus
agricultural production ; farm production ; agricultural output	põllumajandustoodang
agricultural real estate	põllumajanduslik kinnisvara
agricultural storage	põllumajandussaaduste hoidla
agricultural structure	põllumajandusehitis
agricultural undervaluation	põllumajandustootmise alaväärtustamine
agricultural waste	põllumajandusjäätmed
agriculture	põllumajandus
agriculture ; agriculture	põllumajandus ; põllumajandus
agriculture and cattle industry	põllumajanduslik suurtootmine
agriculture framework plan	põllumajanduse arendamise raamkava
agritourism	agroturism
agrochemical	agrokemikaal
agroforestry	agraarmetsandus
agroindustry	agrotööstus
agrometeorology	agrometeoroloogia
agronomic value	tootjahind (põllumajanduses)
agronomy	agronoomia
agrosystem	agroökosüsteem
aid policy	abistamispoliitika
air	õhk
air conditioning ; AC ; air-conditioning	õhu konditsioneerimine
air movement	õhu liikumine
air pollutant	õhusaasteaine, õhureoaine
air pollution	õhu saastamine (reostamine); õhu saastumine (reostumine) ; õhu saastamine ; õhu saastumine
air quality	õhu kvaliteet
air quality control	õhu kvaliteedikontroll
air quality management	õhu kvaliteedi ohjamine
air quality monitoring	õhu[saaste]seire ; õhu(saaste)seire
air sac ; alveolus	alveool
air safety	õhukaitse, välisõhukaitse
air temperature	õhu temperatuur
air traffic	lennuliiklus
air traffic law	lennuliiklusõigus
air transportation	õhutransport
air-water interaction	õhu ja vee vastastikune toime
airborne noise	õhulevimüra
aircraft	õhusõiduk
aircraft noise	lennumüra, õhusõidukimüra
airmail	lennupost
airport	lennujaam
airspace planning	õhuruumi planeerimine
alarm ; alert ; warning	alarm ; häiremärguanne
alarm clock	äratuskell
alchemy	alkeemia
alcohol	alkohol
alcoholism	alkoholism
alga	vetikad
algal bloom	veeõitseng, vetikavohang
algebra	algebra
algicide ; algaecide	algitsiid ; vetikatõrjeaine
alibi	alibi
alicyclic compound	alitsükliline ühend
alicyclic hydrocarbon	alitsükliline süsivesinik
alignment	teetrasside valik
aliphatic compound	alifaatne ühend
aliphatic hydrocarbon	alifaatne süsivesinik
alkali soil	leeliseline muld
alkaline ; element of group I ; alkaline metal ; alkali metal	I rühma element
alkaline battery	leelisaku
alkane ; paraffin ; methane series ; alkane series	alkaan
alkyl compound	alküülühend
all-terrain vehicle	maastur
allegory	allegooria
allergen	allergeen
allergy	allergia
allocation ; allotment ; resource allotment	paigutamine
allocation plan	ressursside paigutamiskava
allotropy	allotroopia
allowance	toetus[raha] ; toetus(raha)
alloy	sulam
alluvial plain	alluviaaltasandik
alluvion ; flood ; overflowing ; inundation	jõesetted, alluuvium ; alluuvium ; jõesetted
almond	mandel
alongside ; amongst ; with	ühes
alpha radiation	alfakiirgus
alternative material	asendusaine, asendusmaterjal ; asendusaine ; asendusmaterjal
alternative technology	alternatiivtehnoloogia
altitude	kõrgus
alumina	alumiiniumoksiid
aluminium	alumiinium
aluminium container	alumiiniumnõu
aluminium content	alumiiniumisisaldus
aluminium industry	alumiiniumitööstus
amalgam	amalgaam
ambassador	suursaadik
amber	merevaik
ambitious	auahne
ambulance	välilaatsaret
americium	ameriitsium
amethyst	ametüst
amine	amiin
amino acid	aminohape
ammonia	ammoniaak
ammonification	ammonifikatsioon
ammonium	ammoonium
amphibian	kahepaikne, amfiib ; kahepaikne ; amfiib
amphitheatre	amfiteater
amusement park	lõbustuspark
anaerobic process	anaeroobne protsess
anaerobic treatment	anaeroobne käitlus
analogy	analoogia
analysis	analüüs
analysis programme	analüüsiprogramm
analytical chemistry	analüütiline keemia
analytical equipment	analüüsiaparatuur
analytical method	analüütiline meetod
anarchism	anarhism
anatomy	anatoomia
anchor	ankur
angel	ingel
angiosperm ; flowering plant	katteseemnetaim, õistaim ; katteseemnetaim ; õistaim
angling ; fishing ; line-fishing	õngitsemine, õngepüük ; õngitsemine ; õngepüük
animal	loom
animal behaviour	loomade käitumine
animal biology	loomabioloogia
animal conservatory	loomakaitseala
animal corridor	loomakoridor
animal damage	loomkahjustus
animal disease	loomahaigus
animal displacement	loomade ränne
animal ecology	loomaökoloogia
animal excrement	loomaväljaheide
animal experiment	loomkatse
animal foodstuff	loomasööt
animal for slaughter	tapaloom
animal habitat	looma elupiirkond
animal heritage	pärandloomastik
animal husbandry	loomakasvatus
animal manure	loomasõnnik
animal migration	loomaränne
animal noise	loomakisa
animal nutrition	loomade toitumine
animal physiology	loomafüsioloogia
animal population	loomakooslus
animal product	loomakasvatussaadus
animal production	loomakasvatus
animal protection	loomakaitseala
animal reproduction	loomade paljunemine
animal resource	loomavarud
animal rights	loomaõigused
animal shelter	loomavarjualune
animal species	loomaliik
animal species reintroduction	loomaliikide reintroduktsioon
animal trade	loomakaubandus
animal waste	loomakasvatusjäätmed
anion	anioon
anise	aniis
annelid	rõngasuss
anniversary	aastapäev
ant	sipelgas
antagonism	antagonism
antelope	antiloop
anthropic activity	inimtegevus
anthropologic reserve	antropoloogiline kaitseala
antibiotic	antibiootikum
antibody	antikeha
anticipation of danger	ohuennetus
antifouling agent	pealiskasvuvastane aine (värv)
antimony	antimon
antipollution incentive	reostustõrjestiimul
antiquated plant	aegunud seade
antiseismic regulation	maavärinaohutust reguleerivad normid
antonym	antonüüm
anytime	alati
apartment block	korterelamu
apiculture ; beekeeping	mesindus
apoptosis	apoptoos
appeal	edasikaebus
appeal procedure	apellatsioonimenetlus
applied ecology	rakendusökoloogia
applied nutrition	rakenduslik toitumisteadus
applied research	rakendusuuring
applied science	rakendusteadus
appraisal	hinnang
appreciate	tunnustama
approach	lähenemine
appropriate technology	alternatiivtehnoloogia
approval ; approbation	heakskiit
approval of installations	ehitusluba
apricot	aprikoos
aquaculture	vesiviljelus, akvakultuur
aquamarine	aquamarin
aquarium	akvaarium
aquatic animal	veeloom
aquatic ecology	veekogude ökoloogia
aquatic ecosystem	veeökosüsteem, akvaatiline ökosüsteem
aquatic environment	vesikeskkond
aquatic mammal	veeimetaja
aquatic organism	veeorganism, hüdrobiont
aquatic plant	veetaim, hüdrofüüt
aqueduct	akvedukt, sildveejuhe; veejuhe ; akvedukt ; sildveejuhe ; veejuhe
aquifer	põhjaveekiht, põhjaveelade ; põhjaveekiht ; põhjaveelade
arable farming	põllundus
arboretum	arboreetum, dendraarium ; arboreetum ; dendraarium
arboriculture	puuviljelus
archaeological	arheoloogiline
archaeological site	arheoloogiline ala
archaeology ; archeology ; archæology	arheoloogia
archbishop	peapiiskop
archduke	ertshertsog
archipelago	saarestik
architecture	arhitektuur
area of potential pollution	reostuskahtlane paik
area under stress	ülekoormatud paik
argon	argoon
argument	tüli
arid land	sademetevaene paik, ariidne paik
aristocracy	aristokraatia
arithmetic ; arithmetics	aritmetiko
armament	relvastus
armament conversion	relvastuse muutmine
armed forces	relvajõud
armistice	vaherahu
armoury	relvistu
armpit	kaenlaauk
aromatic compound	aromaatne ühend
aromatic hydrocarbon	aromaatne süsivesinik
aromatic substance	lõhnaaine
arrangement for a deposit on packaging	pakenditagastuskorraldus
arrow	nool
arrowhead	nooleots
arsenic	arseen
art	kunst
artful	osav
arthritis	liigesepõletik
arthropod	lülijalgne, artropood ; lülijalgne ; artropood
artificial lake	tehisjärv
artificial reproductive technique	kunstlik viljastus
artificial satellite	tehiskaaslane
artist ; creative person	kunstnik
asbestos	asbest
asbestos cement	asbesttsement
asbestosis	asbestoos
ascendancy	ülevõim
ascent	tõus
ascent	tõusev
ascetic	askeet
ash	tuhk
ashen	tuhakarva
ashore	maal
ashtray	tuhatoos
asleep	magab
asphalt	asfalt
aspiration	pürgimus
assassin ; assassinator	salamõrvar
assay	katse ; katse, proov ; proov
assemble ; get together ; gather	kokku kutsuma
assent	nõusolek
assert	kinnitama
assign	määrama
assignment	kohustus
assimilate	omastama
assimilation	assimilatsioon
assist	abistama
association	ühing
assumption ; supposition	eeldus
astatine	astaat
asterisk	tärn
asteroid	asteroid
asthenosphere	astenosfäär
astonish	hämmastama
astonishing	hämmastav
astonishment	hämmastus
astounding	jahmatav
astride	kaksiratsi
astride	harkisjalu
astrology ; star divination	astroloogia
astronautics	astronautika
astronomy	astronoomia
asymmetric ; asymmetrical	asümmeetriline
atheist	ateist
atlas	atlas
atmosphere	atmosfäär, õhkkond ; atmosfäär ; õhkkond
atmospheric aerosol	atmosfääriaerosool
atmospheric chemistry	atmosfäärikeemia
atmospheric circulation	atmosfääriringlus
atmospheric component	atmosfääriosis
atmospheric composition	atmosfääri koostis
atmospheric correction	atmosfäärikorrektsioon
atmospheric emission	emissioon õhku, heide õhku, õhkuheide
atmospheric fallout	õhuvõõriste sadenemine, õhusaasta sadenemine ; õhuvõõriste sadenemine ; õhusaasta sadenemine
atmospheric layering	atmosfääri kihistumine
atmospheric monitoring	õhuseire
atmospheric ozone	atmosfääriosoon
atmospheric particulate	atmosfäärikübe
atmospheric physics	atmosfäärifüüsika
atmospheric pollution	õhkkonnasaaste, atmosfäärisaaste
atmospheric precipitation ; precipitation	sademed (meteorol) ; sademed
atmospheric process	atmosfääriprotsess
atmospheric science	atmosfääriteadus, õhkkonnateadus ; atmosfääriteadus ; õhkkonnateadus
atmospheric structure	atmosfääri ehitus
atoll	atoll
atom	aatom
atomic mass	aatommass
atractive	veetlev
atrazine	atrasiin
atrocity	metsikus
attached	kiindunud
attachment	kiindumus
attachment	lisaseade
attain	saavutama
attend	teenindama
attend	osa võtma
attend	tähele panema
attend	tegelema
attendant	valvur
attentive	tähelepanelik
attic	pööning
attire	riietus
attire	riietuma
attitude	asend
attract	külge ; köitma
attribute	omadus, tunnus ; omadus ; tunnus
audacious	hulljulge
audio-visual presentation	audiovisuaalesitlus
audiovisual equipment	audiovisuaalseadmed
audiovisual media	audiovisuaalmeedia
audit	audit
augment	suurendama
auspicious	paljutõotav
authorisation	luba ; volitus
authoritarian	autoritaarne
authoritative	autoriteetne
authority body	ametivõim
authorship	autorsus
autocracy	isevalitsus
autoecology	autökoloogia
automobile industry	autotööstus
autopsy	lahkamine
available	saadaval
avalanche	laviin, lumelaviin ; laviin ; lumelaviin
avalanche protection	laviinitõrje
avert	tõrjuma
aviary	linnumaja
aviation law	lennundusõigus
aviculture	linnukasvatus
avid	ablas
avifauna	avifauna ; linnustik ; ornitofauna
awe	aukartus
awhile	natuke aega
background level	tausttase
background noise	taustmüra
background radiation	taustkiirgus
bacon	peekon
bacterial bed	biofilter
bactericide	bakteritsiid
bacteriological pollution	bakterreostus, baktersaastus
bacteriology	bakterioloogia
bacterium	bakter
badminton	sulgpall
baker	pagar
baker ; bakery	pagariäri
baking powder	küpsetuspulber
balance	bilanss
balance of matter	ainebilanss
balancing of interests	huvide tasakaalustamine
ballad	ballaad
ballroom	tantsusaal
banana	banaan
bank	kallas
bank protection	kaldakindlustus; kaldakindlustis ; kaldakindlustus ; kaldakindlustis
banking	pangandus
bankruptcy	maksujõuetus
barium	baarium
baron	parun
barrier beach	vallrand
barrier reef	vallrahu, barjäärriff
base	alus
baseball ; baseball game	pesapall
baseline monitoring	taustseire
basic food requirement	põhitoidu tarve
basicity	aluselisus
basidiomycete	kandseen
basketball ; basketball game	korvpall
bassoon	fagott
bastardisation of fauna	loomastiku risustumine
bastardisation of flora	taimestiku risustumine
batch process	annusprotsess
bathing freshwater	suplusmagevesi
bathing seawater	suplusmerevesi
bathing water	suplusvesi
battery	patarei
battery disposal	patareikõrvaldus
bay	laht, merelaht ; laht
beach	lauge [mere]rand ; lauge (mere)rand
beach cleansing	rannapuhastus
bear	karu
beaver	kobras
bee	mesilane
bee conservation	mesilasekaitse
beef cattle	lihaveised
beehive	mesipuu
beer	õlu
beetle	mardikas
behaviour	käitumine
behaviour of substances	ainete käitumine
behaviour pattern	käitumislaad
behavioural science	käitumisteadus
belly button ; bellybutton ; navel ; omphalos ; omphalus ; umbilicus	naba
beneficial organism	kasur
benthic division	veekogu põhjakiht
benthos	bentos, põhjaelustik ; bentos ; põhjaelustik
benzene	benseen
benzopyrene	bensopüreen
berkelium	berkeelium
beryllium ; glucinium	berüllium
beta radiation	beetakiirgus
beverage ; drink	jook
beverage industry	joogitööstus
bibliographic information	bibliograafiline info
bibliographic information system	bibliograafilise info süsteem
bibliography	bibliograafia
bicycle ; bike ; cycle	jalgratas
big game	suurulukid
bilateral convention	kahepoolne leping
bilge oil	pilsiõli
bilge water	pilsivesi, nõruvesi ; pilsivesi ; nõruvesi
bio-availability	biosaadavus
bioaccumulation	bioakumulatsioon
bioaccumulative pollutant	bioakumuleeruv reoaine
biochemical method	biokeemiline meetod
biochemical oxygen demand	biokeemiline hapnikutarve
biochemical process	biokeemiline protsess
biochemical substance	biokeemiline aine
biochemistry	biokeemia
biocide	biotsiid
bioclimatology	bioklimatoloogia
biocoenosis	biotsönoos, elukooslus ; biotsönoos ; elukooslus
bioconcentration factor	bioakumulatsioonitegur
biodegradability	biolagundatavus
biodegradable pollutant	biolagundatav reoaine
biodegradation	biolagunemine, bioloogiline lagunemine, biodegradatsioon ; biolagunemine ; bioloogiline lagunemine ; biodegradatsioon
biodiversity	bioloogiline mitmekesisus, elustiku mitmekesisus ; biodiversiteet ; bioloogiline mitmekesisus ; elustiku mitmekesisus
bioethics	bioeetika
biofiltration	biofiltrimine
biofuel	biokütus
biogas	biogaas
biogeochemical cycle	biogeokeemiline aineringe
biogeographical region	biogeograafiline piirkond
biogeography	biogeograafia
biological analysis	bioanalüüs
biological attribute	bioloogiline omadus
biological contamination	biosaastus
biological cycle	bioloogiline aineringe
biological development	bioloogiline areng
biological effect	bioloogiline toime
biological effect of pollution	reostuse (saastuse) bioloogiline toime
biological engineering	biotehnika
biological heritage	bioloogiline pärand
biological indicator	bioindikaator ; ökoloogiline indikaator
biological monitoring	bioseire
biological pest control	bioloogiline kahjuritõrje
biological pollutant	bioloogiline reoaine (saasteaine)
biological pollution	bioloogiline reostus (saastus)
biological process	bioloogiline protsess
biological production	bioproduktsioon
biological reserve ; wildlife reserve	bioloogiline kaitseala
biological resource	bioloogilised loodusvarad
biological test	biotest
biological treatment	biopuhastus, bioloogiline puhastus
biological waste gas purification	heitgaasi biopuhastus
biological waste treatment	jäätmete biokäitlus
biological wastewater treatment	reovee biopuhastus ; reovee biopuhastus, reovee bioloogiline puhastus ; reovee bioloogiline puhastus
biological water balance	organismi veebilanss
biological weapon	biorelv
biology ; biological science	bioloogia
bioluminescence	bioluminestsents
biomarker	bioindikaator, füsioloogilis-biokeemiline tunnus
biomass	biomass, elusaine hulk ; biomass ; elusaine hulk
biomass energy	biomassist saadav energia
biophysics	biofüüsika
bioreactor	bioreaktor
biorhythm	biorütm
biosafety	bioohutus
biosphere	biosfäär, elukond
biosphere reserve	biosfäärikaitseala
biosynthesis	biosüntees
biotechnological hazard	biotehnoloogiaoht
biotechnology	biotehnoloogia
biotic factor	biootiline tegur
biotic index	biootiline indeks
biotope	biotoop
biotope network	biotoobivõrk
biotope order	biotoobijärk
biotope protection	biotoobikaitse
bird	lind
bird of prey	röövlind
bird sanctuary	linnukaitseala
bird species	linnuliik
birth control	sündimuse piiramine
bismuth	vismut
bitumen	bituumen
black	must
black coal ; black coal ; black coal ; anthracite coal	kivisüsi
blackbird	musträstas
blacksmith	sepp
blast furnace	kõrgahi
bleaching agent	pleegitusaine
bleaching clay	pleegitussavi
bleaching process	pleegitamine
blood	veri
blue	sinine
blue-green alga ; cyanobacteria	sinivetikad, sinivetiktaimed, sinikud, tsüanobakterid
boating	paadisõit ; purjetamine
bocage	hekimaastik (Põhja-Prantsusmaal) ; hekimaastik
bog	soo
bohrium	bohrium
boiler	boiler, [auru]katel, veesoojendi ; boiler, (auru)katel, veesoojendi
boiling point	keemistemperatuur
book	raamat
bookkeeping	raamatupidamine
border	piir
boron	boor
botanical conservatory	botaaniline kaitseala
botanical garden	botaanikaaed
botany	botaanika
botany ; phytology	botaanika
bottle cap	pudelikork
boundary crossing	piiri ületamine, piiriületus
boundary layer	piirkiht
bow	vibu
brackish water	riimvesi
branch of activity	tegevusala
bread	leib
breast milk	rinnapiim
breeding	aretus
breeding bird	pesitsuslind
breeding technique	aretusmeetod
brick	tellis
bridge	sild
broad-leaved tree	lehtpuu
bromine	broom
brooding	haudumine
brook	oja
brushwood	võsa
bryophyte	sammaltaim
bubble policy (emissions trading) ; bubble policy	ühiskuplistrateegia (heitekaubanduses) ; ühiskuplistrateegia
budget	eelarve
budget policy	eelarvepoliitika
bug ; põrnikas	mardikas ; mardikas, põrnikas, putukas; lutikas ; putukas ; põrnikas ; lutikas
building	ehitis ; ehitus
building area	ehitusalune pind, hoonestuspind ; ehitusalune pind ; hoonestuspind
building component	tarielement
building destruction	ehitiste lammutamine
building industry	ehitustööstus
building land	ehitusmaa
building material	ehitusmaterjal
building materials industry	ehitusmaterjalitööstus
building permit	ehitusluba
building planning	ehituse planeerimine
building regulation	ehituseeskiri
building related illness ; sick building syndrome	ruumiõhu sündroom
building restoration	ehitiste restaureerimine
building service	ehitusteenindus
building site	ehitusplats
building site preparation	ehitusplatsi ettevalmistamine
building technology	ehitustehnoloogia
building waste	ehitusjäätmed, ehituspraht ; ehitusjäätmed ; ehituspraht
built drainage system	kuivendussüsteem
built environment	tehiskeskkond
built structure	ehitis
built-up area	täisehitatud ala
bulb cultivation	sibullillekasvatus
bulky waste	suurjäätmed
bureaucracy	bürokraatia
bureaucratisation	bürokratiseerimine, bürokratiseerumine ; bürokratiseerimine ; bürokratiseerumine
bus ; coach	buss
bus station	bussijaam
bush clearing	võsakoristus
business	äri[ndus]; ettevõte ; ärindus ; ettevõte
business activity	äritegevus; ettevõtlus
business classification	ettevõtete liigitus
business economics	majandusteadus, ettevõtteökonoomika
business organisation	äriettevõtlus
business policy	ettevõtluspoliitika
butcher	lihunik
butterfly	liblikas
button-cell battery	nööppatarei
buy ; purchase	ostma
buy ; purchase	ost, ostmine ; ostmine ; ost
by-catch	kaaspüük
by-product	kõrvalsaadus
cable	kaabel
cactus	kaktus
cadmium	kaadmium
caesium	tseesium
caffeine	kofeiin
calcium	kaltsium
calcium content	kaltsiumisisaldus
calculation	arvutus, arvutamine ; arvutus ; arvutamine
calculation method	arvutusmeetod
calendar	kalender
calibration	kaliibrimine
californium	kalifornium
calligraphy	käekiri
camel	kaamel
camera	fotoaparaat ; fotokaamera
camouflage	kamuflaaž
camp ; military camp ; army camp ; campsite	laager; laagriplats ; laager ; laagriplats
camping ; camping ground	telkimine
camping site	laagrikoht
canal	kanal
canal lock	kanalilüüs
cancer	vähk[tõbi] ; vähk(tõbi)
cancer risk	vähioht; vähktõveoht
candle	küünal
canid	koerlane
canyon	kanjon
capital	pealinn
car ; automobile	auto
car park	parkla
car tyre	autorehv
carbohydrate	süsivesik
carbon	süsinik
carbon dioxide	süsinikdioksiid, süsihappegaas ; süsinikdioksiid ; süsihappegaas
carbon dioxide tax	süsinikdioksiidimaks
carbon monoxide	süsinik[mono]oksiid, vingugaas ; süsinik(mono)oksiid, vingugaas
carbonate	karbonaat
carcass disposal	korjusekäitlus
carcinogen	kantserogeen, kartsinogeen ; kartsinogeen ; kantserogeen
carcinogenicity	kartserogeensus, kartsinogeensus, kantserogeenne toime
carcinogenicity test	kantserogeensustest
cardiology	kardioloogia
cardiovascular disease	kardiovaskulaarhaigus
cardiovascular system	kardiovaskulaarsüsteem
career	karjäär
carnivore	lihasööja, karnivoor
carry-over effect	edasikandumine toitumisahelas
cartography	kartograafia
case ; lawsuit ; trial	kohtuasi, kohtulik arutamine ; kohtuasi ; kohtulik arutamine
cash crop	müügikultuur
cat	kass
catalysis	katalüüs
catalyst	katalüüt
catalytic converter	katalüüsneutralisaator, katalüüsmuundur
catastrophe	katastroof
catch yield	kalasaak
catchment	veepüüdemahuti
catchment area	valgla
category of endangered species	eriti ohustatud liigid
cation	katioon
cattle	veised
cause-effect relation	põhjuse ja tagajärje suhe
cave	koobas
celery	seller
cell ; cell	rakk ; rakk
cell ; electrochemical cell ; energy cell ; Galvanic cell ; στοιχείο	akuelement
cellulose	tselluloos
cellulose industry	tselluloositööstus
cement	tsement
cement industry	tsemenditööstus
cement manufacture	tsemendi tootmine
census survey	rahvaloendus
central government	keskvalitsus
central park area	loodusreservaat
centralisation	tsentraliseerimine
centrifugation	tsentrifuugimine
cephalopod	peajalgne, tsefalopood ; peajalgne ; tsefalopood
ceramics	keraamika
ceramics industry	keraamikatööstus
cerium	tseerium
certification	sertifitseerimine
cetacean	vaalaline
chalk	kriit
change in value	väärtuse muutumine
channelling	jaotusvõrk
charcoal	puusüsi, puidusüsi ; puusüsi ; puidusüsi
chart	harta
chart ; nautical chart	merekaart
cheers ; thank you ; thanks	aitäh
chelicerate	lõugtundlased, helitseraadid
chemical	kemikaal
chemical addition	liitumisreaktsioon
chemical analysis	keemiline analüüs
chemical composition	keemiline koostis
chemical contamination	kemikaalisaastus
chemical corrosivity	keemiline korrodeeruvus
chemical decontamination	kemikaalisaasta ärastamine
chemical element ; element	keemiline element
chemical fallout	keemilise õhusaasta sadenemine
chemical fertiliser	mineraalväetis, kunstväetis
chemical in the environment	keskkonnas olevad kemikaalid
chemical industry	keemiatööstus
chemical installation	keemiatööstushoone
chemical measurement of pollution	reoainete keemiline määramine
chemical oxygen demand	keemiline hapnikutarve
chemical pest control	keemiline kahjuritõrje
chemical plant	keemiatööstusettevõte
chemical policy	keemiapoliitika
chemical pollutant	keemiline reoaine, keemiline saasteaine
chemical pollution	kemikaalireostus, kemikaalisaastus
chemical process	keemiline protsess
chemical product	keemiasaadus
chemical property	keemiline omadus
chemical reaction	keemiline reaktsioon
chemical reduction	redutseerimine
chemical risk	keemiaoht
chemical structure	keemiline struktuur
chemical treatment	keemiline käitlus
chemical waste	kemikaalijäätmed
chemical weapon	keemiarelv
chemicals act	kemikaaliseadus
chemisorption	kemosorptsioon
chemist's ; chemist's shop ; pharmacy	apoteko ; apteek
chemistry	keemia
chess	male
chestnut	kastan
child	laps
chimney	korsten
chimney height	korstna kõrgus
chiropteran	käsitiivaline, nahkhiireline
chloride	kloriid
chlorinated hydrocarbon	klooritud süsivesinik
chlorination	kloorimine
chlorine	kloor
chlorophenol	klorofenool
chlorophyll	klorofüll
chlorosis	kloroos, haljuskadu ; kloroos ; haljuskadu
cholesterol	kolesterool
chordate	keelikloom, kordaat
chorology	levilateadus, areoloogia, koroloogia
chromatographic analysis	kromatograafiline analüüs
chromatography	kromatograafia
chromium	kroom
chrysophyta	koldvetikad
church	kirik
cinematographic film	kinofilm
circular mail	ringkiri
citizen	kodanik
citizen awareness	kodanikuteadvus
citizen initiative	kodanikualgatus
citizen rights	kodanikuõigused
city	linn
city centre	linnakeskus
civil air traffic	tsiviillennuliiklus
civil engineering	tsiviilehitus
civil law	tsiviilõigus
civil safety	elanike ohutus
civilian protection	tsiviilkaitse
claim for restitution	ennistusnõue
clarinet	klarnet
classification	liigitus, klassifikatsioon
clay	savi
clean air area	puhta õhu piirkond
clean air car	keskkonda säästev auto
clean technology	puhas tootmine
cleaning up	saneerimine
cleanliness	puhtus
cleansing department	linnapuhastusosakond
clearing sludge	settekoristus, mudakoristus
cliff	kalju ; kalju ; pank ; rannajärsak ; klint
climate	kliima
climate protection	kliimakaitse
climate resource	kliimaressursid
climate type	kliimatüüp
climatic alteration	kliima muutumine
climatic change ; climate change	kliimamuutus
climatic effect	kliima mõju
climatic experiment	kliimaeksperiment
climatic zone	kliimavööde
climatology	klimatoloogia
climax	kliimaks, püsikooslus, lõppkooslus ; kliimaks ; püsikooslus ; lõppkooslus
climbing plant (wall) ; climbing plant	ronitaim
clinical symptom	kliiniline sümptom
cloning	kloonimine
closing down	tegevuse lõpetamine; sulgemine ; tegevuse lõpetamine ; sulgemine
closing down of firm	ettevõtte tegevuse lõpetamine
clothing ; apparel	riietus
clothing industry	tekstiilitööstus
cloud	pilv
co-incineration	koospõletamine
co-operation	koostöö
co-operation policy	koostööpoliitika
co-operation principle	koostööpõhimõte
co-ordinate system	koordinaatsüsteem
co-ordination	koordineerimine, kooskõlastamine
coagulation	koagulatsioon
coal	kivisüsi ; kivisüsi, süsi ; süsi
coal industry	söetööstus
coal liquefaction	söe veeldamine
coal mining	söe kaevandamine
coal refining	söe rikastamine
coal technology	söetehnoloogia
coal-based energy	söepõhine energia
coal-fired power plant	kivisöejõujaam
coast	rannik
coast protection	rannikukaitse
coastal area	rannikupiirkond
coastal development	rannikupiirkonna arendamine
coastal ecosystem	rannikuökosüsteem
coastal environment	rannikukeskkond
coastal fishing	rannapüük
coastal pollution	rannikureostus
coastal water	rannikuvesi
coastal zone planning	rannikupiirkonna planeerimine
coastguard	rannavalve
coating	pinnakate, kattekiht ; pinnakate ; kattekiht
cobalt	koobalt
cocaine	kokaiin
cockroach	tarakan, prussakas ; tarakan ; prussakas
code	kood
code of practice	juhend
codification	kodeerimine
coelenterate	ainuõõsne
cogeneration	koostootmine, soojuse ja elektri koostootmine
coke	koks
cold	külm
coliform bacterium	kolilaadne bakter, kolilaadne, coli-laadne
colina ; hill ; loma	küngas ; mägi
collective wastewater treatment	reovee ühispuhastus
colloid	kolloid
colloidal state	kolloidolek
colonisation	asustamine
colour ; colour ; colo(u)r	värv ; värvus, värv ; värvus, värv ; värvus, värv ; värvus
colour composition	pseudokoloreerimine
colourimetry	kolorimeetria
colubrid	nastiklane
combination effect	koosmõju, koostoime
combined cycle-power station	kombijõujaam
combined sewer system	ühisvoolukanalisatsioon
combined transport	segaveod
combined waste water	segareovesi
combustibility	süttivus
combustion engine	sisepõlemismootor
combustion gas	heitgaas
combustion residue	põlemisjääk
come	tulema
comet	komeet
commercial fishery	töönduspüük
commercial law	kaubandusõigus
commercial noise	kaubandusmüra
commercial traffic	kaubaveod
commercial transaction	kaubandustehing
commercial vehicle	kaubaveok
commercialisation	kaubastamine
common agreement	taval põhinev kokkulepe
common agricultural policy ; common agricultural policy of the EU	ühine põllumajanduspoliitika
common commercial policy	ühine kaubanduspoliitika
common tariff policy	ühine tollipoliitika
communications	suhtlus, infovahetus ; suhtlus ; infovahetus
communications industry	sideala
communications policy	sidepoliitika
communications system	sidesüsteem
communism	kommunism
community facility ; public facility	üldkasutatav rajatis
community-pays principle	kogukond-maksab-põhimõte
commuter traffic	pendelliiklus
compaction	tihendamine
company policy	ettevõtte strateegia
company structure	ettevõtte struktuur
comparative law	võrdlev õigusteadus
comparative test	võrdluskatse
comparison	võrdlus
compensation	hüvitis
compensation for damage	kahju hüvitamine
compensatory measure	tasendusmeede
compensatory tax	tasendusmaks
competition	konkurents
competition law	konkurentsiõigus
competitive examination	võistluseksam
competitiveness	konkurentsivõime
complex formation	kompleksimoodustumine
complexing agent	kompleksimoodusti
composite pollution	liitreostus
composition of population	rahvastiku koostis
compost	kompost
compostable waste	kompostitavad jäätmed
composting	kompostimine
composting by producer	kompostimine omal krundil
compound ; chemical compound	keemiline aine
compression	kokkusurumine
compressor	kompressor
concentration	ainesisaldus ; kontsentratsioon
concentration	kontsentreerumine
concept of environment	keskkonnakontseptsioon
concession	kontsessioon
concrete	betoon
concrete products industry	betoontootetööstus
condensation (process) ; condensation	kondensatsioon
conductivity ; electrical conductivity	juhtivus
conflict	konflikt
conflict of aims	eesmärkide lahknemine
conflict of interests	huvide lahknemine
conflicting use	vastuolus olev kasutus
congress	kongress
conifer	okaspuu
coniferous forest	okasmets, okaspuumets
coniferous tree	okaspuu
conservation	kaitse ; kaitse, looduskaitse ; looduskaitse
conservation of monuments	mälestisekaitse
conservation policy	looduskaitsepoliitika
constellation	tähtkuju
constitution	põhiseadus ; konstitutsioon
constitutional law	riigiõigus
construction equipment	ehitusmasinad
construction noise	ehitusmüra
construction policy	ehituspoliitika
construction technology	ehitustehnoloogia
construction with recycled material	ehitamine taaskasutusmaterjalist
construction work	ehitamine, ehitustöö ; ehitamine ; ehitustöö
consultancy	nõustaja
consultation	nõustamine
consumer behaviour	tarbija käitumine, tarbimiskäitumine
consumer goods	tarbekaubad
consumer group	tarbijarühm
consumer information	tarbijateave
consumer product	tarbekaubad
consumer protection	tarbijakaitse
consumer waste	tarbimisjäätmed
consumption	kulu, tarbimine ; kulu ; tarbimine
consumption pattern	tarbimisstruktuur
container	konteiner
containment (nuclear industry) ; containment	kaitsekest
contaminated soil	saastatud pinnas
contamination	saastumine
continent	kontinent ; manner
continental climate	mandrikliima
continental shelf	mandrilava, šelf
continuing education	täiendusõpe
continuous load	püsikoormus
contour farming	terrasspõllundus
contract	leping
control measure	juhtimismeede
controlled burning	ülepõletamine
controlled hunting zone	kontrollitav jahipiirkond
controlling authority	juhtiv ametkond
conurbation	linnastu
convention	konventsioon ; rahvusvaheline kokkulepe
conventional energy	tavaenergia
cooling	jahutamine
cooling oil	jahutusõli
cooling tower	jahutustorn, gradiir
cooling water	jahutusvesi
copper	vask
coppice	võsa ; võsa, madalmets ; madalmets
coppice with standards	keskmets
coral	korall
coral reef	korallrahu
coral reef lagoon	korallrahulaguun
core meltdown	reaktori ülekuumenemine
cork	kork
corridor	koridor
corrosion	korrosioon
corrosion inhibitor	korrosiooniinhibiitor, korrosioonitõrjeaine ; korrosiooniinhibiitor ; korrosioonitõrjeaine
cosmetic industry	kosmeetikatööstus
cosmic radiation	kosmiline kiirgus
cosmology	kosmoloogia
cost	maksumus
cost increase	kulude suurenemine
cost reduction	kulude vähenemine; kulude vähendamine
cost-benefit	kulud ja tulud
cost-benefit analysis	kulude ja tulude analüüs, tasuvusanalüüs
cotton	puuvill
country ; nation ; state	riik
country lodge	suvila, puhkemaja
county	maakond
court	kohus
court of justice	kohus
cove	abajas
covering ; roofing	kate
cow	lehm
craft ; arts and crafts	käsitöö
creativity ; inventiveness	loovus
credit	krediit, laen
credit assistance	krediidiabi
credit policy	krediidipoliitika, laenupoliitika
creek	jõesopp; oja ; oja ; jõesopp
crime	kuritegu
criminal law	kriminaalõigus
criminal law procedure	kriminaalmenetlus
criminal liability	kriminaalvastutus
criminality	kuritegevus
crisis management	kriisijuhtimine
critical level	kriitiline tase
critical load	kriitiline koormus
crocodile	krokodill
crop production	taimekasvatus
crop protection	taimekaitse
crop rotation	külvikord
crop treatment	keemiline taimekaitse
crossing place	ülekäigukoht
crossing place for animals	loomaülekäigukoht
crude oil	nafta, toornafta, maaõli ; nafta ; toornafta ; maaõli
cruising	ristlus
crustacean	vähid, koorikloomad
cryptogam	eostaim, krüptogaam ; eostaim ; krüptogaam
crystal	kristall
crystallisation	kristallisatsioon
crystallography	kristallograafia
cultivated plant	kultuurtaim
cultivation ; tillage	viljelus
cultivation method	viljelusviis
cultivation of agricultural land	maaviljelus
cultivation system	maaviljelussüsteem
cultural development	kultuuri areng
cultural facility	kultuuriasutus
cultural heritage	kultuuripärand
cultural indicator	kultuuriindikaator
cultural policy	kultuuripoliitika
culture	kultuur
curium	kuurium
curriculum	õppekava
customs	toll
customs regulation	tollieeskiri
customs tariff	tollimaks
cutting	metsaraie ; raie
cutting ; cutting (vegetative propagation)	pistik
cyanate	tsüanaat
cyanide	tsüaniid
cycle path	jalgrattatee
cyclone	tsüklon, madalrõhkkond ; tsüklon ; madalrõhkkond
cytology	tsütoloogia
cytotoxicity	tsütotoksilisus
dairy farm	piimatalu
dairy industry	piimatööstus
dairy product	piimasaadus
dam	pais
dam draining	veehoidla tühjendamine
damage	kahju
damage assessment	kahju hindamine
damage from military manoeuvres	sõjaväemanöövrite tekitatud kahju
damage insurance	kahjukindlustus
damage prevention	kahju vältimine
danger analysis	ohuanalüüs
dangerous goods	ohtlikud kaubad
dangerous goods law	ohtlike kaupade seadus
dangerous goods regulation	ohtlike kaupade käitluseeskirjad
dangerous installation	ohtlik ettevõte
dangerous materials transport	ohtlike materjalide vedu
darmstadtium	Darmstadtium
data acquisition	andmehõive
data analysis	andmeanalüüs
data carrier	andmekandja
data centre	andmetöötluskeskus
data exchange	andmevahetus
data on the state of the environment	andmed keskkonna seisundi kohta
data processing	andmekäitlus ; andmetöötlus
data processing law	andmetöötlusseadus
data processing system	andmetöötlussüsteem
data protection	andmekaitse
data recording technique	andmesalvestustehnika
database	andmebaas ; andmekogu ; andmepank
dating	dateerimine, vanuse määramine ; dateerimine ; vanuse määramine
dazzle	pimestama
de-inking	trükivärvi eemaldamine
death penalty ; capital punishment ; death sentence	surmanuhtlus
debt	võlg
debt service	võlateenindus
decay product	lagusaadus
decentralisation	detsentraliseerimine
dechlorination	klooritustamine, dekloorimine
decibel	detsibell
deciduous forest ; deciduous wood	lehtmets, lehtpuistu ; lehtmets ; lehtpuistu
deciduous tree	lehtpuu
decision	otsus
decision making support	otsustussabi
decision process	otsustamine
decision-support system	otsustusabisüsteem
declaration of public utility	avalikuks kasutamiseks määramine
decomposition	lagunemine
decontamination	saastaärastus, kahjutustamine, saastast puhastamine ; saastaärastus ; kahjutustamine ; saastast puhastamine
decree	määrus
deep sea	süvamere-
deep sea fishing	süvamerepüük
deep sea mining	süvamerekaevandamine
deep-sea disposal	süvamerre kaadamine, süvamerre uputamine ; süvamerre kaadamine ; süvamerre uputamine
deer	hirv
defence	kaitse
deflation	deflatsioon
defoliation	defoliatsioon
deforestation	raadamine
degradability	lagundatavus
degradation	lagundamine
degradation of natural resources	loodusvarade vähenemine
degradation of the environment	keskkonna seisundi halvendamine
degradation product	lagusaadus
degreasing	rasvatustamine, rasvaärastus
dehydrated sludge	kuivatatud sete, kuivatatud muda
delegated management	delegeeritud juhtimine
delta	delta
demand	nõue; nõudlus ; nõue ; nõudlus
demesnial water	riigiveekogu
democracy	demokraatia
demographic development	rahvastiku kasv
demographic evolution	rahvastikuprotsess
demography	demograafia, rahvastikuteadus ; demograafia ; rahvastikuteadus
demolition business	lammutustegevus
demolition waste	lammutuspraht
demonstrability	tõestatavus
dendrochronology ; tree-ring dating	dendrokronoloogia
dendrometry	dendromeetria
denitrification	denitrifikatsioon
denitrification of waste gas	heitgaasi denitrifitseerimine
density	tihedus
dentist	dentisto ; hambaarst
deposition	sadenemine
deregulation	riigi vahelesegamise vähendamine
dermatology	dermatoloogia
desalination	magestamine
desalination plant	magestusseade
desert	kõrb
desert climate	kõrbekliima
desert locust	kõrbetirts
desertification	kõrbestumine, desertifikatsioon
desertification control	kõrbestumistõrje
design (project) ; design ; project design	projekt
desk study	kabinetiuuring
desorption	desorptsioon
destination of transport	veose sihtkoht
desulphurisation	väävlitustamine, väävliärastus, desulfuratsioon ; väävlitustamine ; väävliärastus ; desulfuratsioon
desulphurisation of fuel	kütuse väävlitustamine
detection	avastamine
detector	detektor
detergent	detergent, pesuaine, puhastusaine ; puhastusaine ; detergent
determination method	määramismeetod
deterrence	peletus, hirmutus
deterrent	peletusvahend, hirmutusvahend
detoxification	mürgitustamine, detoksikatsioon ; mürgitustamine ; detoksikatsioon
deuterium	deuteerium
developed country	arenenud maa
developing country	arengumaa
development aid	arenguabi
development area	arengupiirkond
development co-operation	arenduskoostöö
development model	arengumudel
development pattern	arengulaad
development plan	arengukava
devolution	taandareng
dialect	murre
dialysis	dialüüs
diary	päevik
diatom	ränivetikas, diatomee
dictionary	sõnaraamat ; sõnastik
didactics	didaktika, õpetamisteadus ; didaktika ; õpetamisteadus
diesel engine	diiselmootor
diesel fuel ; diesel	diiselkütus
differentiation	diferentseerumine
diffuse pollution	hajureostus
diffuse source	hajureostusallikas
diffusion	difusioon
digested sludge	käärinud [reovee]sete, käärinud muda ; käärinud (reovee)sete, käärinud muda ; käärinud (reovee)sete ; käärinud muda
digester	metaan[kääritus]tank, mädandi ; metaan(kääritus)tank, mädandi ; mädandi ; metaan(kääritus)tank
digestion	kääritamine ; mädandamine
digital image processing technique	digitaalpilditöötlus
digital land model	maapinna digitaalmudel
digitising	digiteerimine
diluted acid	lahjendatud hape
dioxin	dioksiin
dipteran	kahetiivaline, dipter
direct discharger	otseheiteallikas
directive	direktiiv
disabled person	invaliid, vaegur
disaster	katastroof ; õnnetus
disaster cleanup operation	õnnetustagajärgede kõrvaldamine
disaster contingency plan	õnnetuseplaan
disaster control service	õnnetustõrjeteenistus; õnnetustõrjetalitus
disaster preparedness	õnnetusvalmidus
disaster prevention	õnnetustõrje
disaster relief	õnnetusabi
disaster zone	õnnetuspiirkond
discharge regime	äravoolurežiim
disease ; illness ; affliction	haigus ; tõbi
disease cause	haiguse põhjus
disinfectant	desoaine, desinfitseeriv aine ; desoaine ; desinfitseeriv aine
disinfection	desinfektsioon, desifitseerimine ; desinfektsioon ; desifitseerimine
dispatch note	laadimisteatis
dispersion	dispersioon
dispersion calculation	hajumisarvutus
displaced person	pagulane
disposal of the dead	matusekorraldus
disposal of warfare materials	sõjavarustuse kõrvaldamine
dissolution	lahustamine
dissolved organic carbon	lahustunud orgaaniline süsinik
dissolved oxygen	lahustunud hapnik
distillation	destillatsioon ; destilleerimine
distortion of competition	konkurentsi kahjustamine
distribution	jaotumine
distribution area	areaal, levila, levikuala ; areaal ; levila ; levikuala
distributive trade	hulgikaubandus
district heating	kaugküte
district heating plant	kaugküttejaam
disused military site	hüljatud sõjaväeala
ditch	kraav
doctrine	doktriin
document	dokument
document lending	dokumendilaenutus
document type	dokumenditüüp
documentary film	dokumentaalfilm
documentary system	dokumendisüsteem
documentation	dokumentatsioon
documentation centre	dokumendikeskus
dog	koer
dolphin	delfiin
domestic appliance	majapidamisseade
domestic fuel	majapidamiskütus, olmekütus
domestic fuel oil	kerge kütteõli
domestic noise	olmemüra
domestic pollution	olmereostus
domestic trade	sisekaubandus
domestic waste	olmejäätmed ; olmejäätmed, majapidamisjäätmed ; majapidamisjäätmed
domestic waste landfill	olmejäätmeprügila
domestic waste water	olmereovesi
domesticated animal	kodustatud loom
donation	annetamine
door	uks
dosage	annustamine ; annustus ; doseerimine
dose	annus ; doos
dose-effect relationship	annuse ja toime suhe
draft legislation	seaduseelnõu
dragonfly	kiil
drainage	kuivendus
drainage system	kuivendussüsteem
drainage water	kuivendusvesi, drenaaživesi
draining	kuivendamine
draught animal	veoloom
dredged material	süvenduspinnas, süvendusaines
dredging	süvendamine
drift net fishing	triivpüük
drilling	puurimine
drilling for oil	naftapuurimine
drilling installation	puurseade
drinking water	joogivesi
drinking water protection area	joogiveekaitseala
drinking water supply	joogiveevarustus
drinking water treatment	joogiveekäitlus, joogiveetöötlus, joogiveepuhastus ; joogiveekäitlus ; joogiveetöötlus ; joogiveepuhastus
drought	põud
drought control	põuatõrje
drug	ravim
drum kit	trummid
dry	kuiv
dry cleaning	kuivpuhastus
dry deposition	kuivsadenemine
dry farming	kuivpõllundus
dry lawn	kuivmuru
drying	tahendamine, kuivatamine
drying out	kuivatamine
dual economy	kontsentriline rahvamajandus
dual waste management	rööbikjäätmekäitlus
dubnium	dubnium
duck	part
dumping	prügi ulakaadamine, jäätmete kontrollimatu mahapanek ; prügi ulakaadamine ; jäätmete kontrollimatu mahapanek
dune	luide
durable goods	kestvuskaubad, püsikaubad
duration of sunshine	päikesepaiste kestus
dust	tolm
dust removal	tolmuärastus
dwelling	eluruum
dye	värvaine, värv
dyke	tamm (tammi) ; tamm
dyke reinforcement	tammikindlustus
dysprosium	düsproosium
ear	kõrv
early warning system	varajase hoiatamise süsteem
earth ; Earth ; the world ; Blue Planet	Maa
earth science	teadus Maast, geoloogia
earth's crust ; crust ; Earth's crust	maakoor
earthquake	maavärin
earthworm	vihmauss
earwig	kõrvahark
easement	servituut
eat	sööma
echinoderm	okasnahkne, ehhinoderm ; okasnahkne ; ehhinoderm
eco-paediatrics	ökopediaatria
ecocatastrophe	ökokatastroof
ecodevelopment	ökoloogiline areng
ecolabel	ökomärgis, keskkonnamärgis
ecolabelling	ökomärgistamine
ecological abundance	arvukus (biol)
ecological adaptation	kohastumine
ecological assessment	ökoloogiline hindamine
ecological balance	ökoloogiline tasakaal ; ökotasakaal
ecological bookkeeping	ökoloogiline arvepidamine
ecological carrying capacity	keskkonnamahutavus
ecological community	kooslus
ecological factor	keskkonnategur, ökoloogiline faktor ; keskkonnategur ; ökoloogiline faktor
ecological inequality	ökoloogiline ebavõrdsus
ecological niche	ökoloogiline nišš, ökonišš, nišš
ecological parameter	ökoloogiline näitaja
ecological stocktaking	ökoloogiline loendus
ecologically sensitive area	ökoloogiliselt tundlik ala
ecologist movement	ökoliikumine, keskkonnaliikumine ; ökoliikumine ; keskkonnaliikumine
ecology	ökoloogia
ecomarketing	mahekaubandus
ecomuseum	keskkonnamuuseum
economic activity	majandustegevus
economic analysis	majandusanalüüs
economic competition	majanduskonkurents
economic concentration	kontsentratsioonitase
economic data	majandusandmed
economic development	majanduslik areng
economic forecasting	majanduslik prognoos
economic geography	majandusgeograafia
economic growth	majandustõus
economic incentive	majanduslik stiimul, majandushoob
economic instrument	majandusinstrument
economic management instrument	majanduse juhtimisinstrument
economic plan	majanduskava
economic planning	majanduse plaanimine
economic policy	majanduspoliitika
economic region	majanduspiirkond
economic rights	majanduslikud õigused
economic science ; economics	ökonoomika
economic sector	majandussektor
economic situation	majanduslik olukord
economic structure	majanduse struktuur
economic support	majandusabi
economic system	majandussüsteem
economic theory	majandusteooria
economic trend	majandusliku arengu tendents (suundumus)
economic viability	majanduslik elujõulisus
economical-ecological efficiency	majanduslik ja ökoloogiline tõhusus
economy	majandus
ecophysiology	ökofüsioloogia
ecosystem	ökosüsteem
ecosystem analysis	ökosüsteemanalüüs
ecosystem degradation	ökosüsteemi degradeerumine
ecosystem research	ökosüsteemne uurimistöö
ecosystem type	ökosüsteemitüüp
ecotourism	ökoturism
ecotoxicity	ökotoksilisus
ecotoxicological evaluation	ökotoksikoloogiline hindamine
ecotoxicology	ökotoksikoloogia
ecotype	ökotüüp
ecozone	ökopiirkond
edaphology	edafoloogia
edible fat	toidurasv
education	haridus
education policy	hariduspoliitika
educational institution	haridusasutus
educational path	haridustee
educational planning	hariduse planeerimine
educational system	haridussüsteem
effect	mõju
effect on health	mõju tervisele
effect on man	mõju inimesele
effect on the environment ; environmental consequence	keskkonnamõju
efficiency criterion	efektiivsuskriteerium
efficiency level	kasutegur
effluent	heitvesi
effort ; exertion	pingutus
egg	muna
einsteinium	einsteinium
elasticity	elastsus
elbow	küünarnukk
elderly person	vanur
electric battery	elektripatarei
electric line ; power line	elektriliin
electric power	elektrienergia, elekter
electric power plant	elektrijõujaam
electric power supply	elektrivarustus
electric vehicle	elektrisõiduk
electrical engineering	elektrotehnika
electrical goods industry	elektrikaubatööstus
electrical industry	elektritööstus
electricity	elekter, elektrienergia ; elekter ; elektrienergia
electricity company	elektriettevõte
electricity consumption	elektrienergia kulu
electricity generation	elektritootmine
electricity generation cost	elektritootmiskulud
electricity supply industry	elektrimajandus
electrokinetics	elektrokineetika
electrolysis	elektrolüüs
electronic information network	elektronteabevõrk
electronic mail ; email ; e-mail	elektronpost, e-post, meil ; elektronpost ; e-post ; e--kiri ; e-kiri ; e-posti sõnum ; sõnum
electronic material	elektronmaterjal
electronic scrap	elektroonikajäätmed
electronic scrap regulation	elektroonikajäätmemäärus
electronics	elektroonika
electrosmog	elektronsudu
electrotechnical equipment	elektrotehniline seadmestik
electrotechnical industry	elektrotehnikatööstus
element of group 0 ; noble gas	0-rühma element
element of group II (alkaline earth metals) ; alkaline earth metal ; element of group II	II rühma element
element of group III	III rühma element
element of group IV	IV rühma element
element of group V	V rühma element
element of group VI	VI rühma element
element of group VII ; halogen	VII rühma element, halogeen ; halogeen ; VII rühma element
emancipation	emantsipatsioon
embryo	embrüo ; loode
embryogenesis	embrüogenees
emergency	hädaolukord
emergency law	hädaolukorraseadus
emergency plan	tegevuskava hädaolukorras
emergency relief	hädaabi
emergency shelter	hädaulualune, hädapeavari
emission	emissioon, heide ; emissioon ; heide
emission control	heiteohje
emission data	heiteandmed
emission factor	heitetegur
emission forecast	heiteennustus, emissiooniprognoos ; emissiooniprognoos ; heiteennustus
emission reduction	heite vähendamine, emissiooni vähendamine, heitetõrje
emission reduction banking	heiteõiguse hoiustamine (heitekaubanduses)
emission register	emissioonikataster, heitekataster
emission situation	emissiooniseisund, heiteseisund
emission source	emissiooniallikas, heiteallikas
emission standard	emissiooninorm, heitenorm
emission to water	heide veekogusse, vetteheide
employment	teenistus, töö, amet; töökoht; tööhõive
employment ; employment ; job ; job ; occupation ; work ; work	amet ; elukutse ; kutse
employment and environment	töö ja keskkond
employment level effect	mõju tööhõivele
employment structure	tööhõivestruktuur
emulsification	emulgeerimine
emulsion	emulsioon
encapsulation	kaitsekatmine
encyclopaedia	entsüklopeedia
end-of-pipe technology	toruotsatehnoloogia, korstnaotsatehnoloogia
endangered animal species	eriti ohustatud loomaliik
endangered plant species	eriti ohustatud taimeliik
endemic species	endeemne liik, päriskodune liik
endocrine system	endokriinsüsteem, sisenõresüsteem
endocrinology	endokrinoloogia
energy	energia
energy balance	energiabilanss
energy consumption	energiakulu
energy conversion	energia muundamine, energia konversioon
energy demand	energiavajadus
energy dissipation	energiakadu
energy distribution system	energiajaotussüsteem
energy economics	energiamajandus
energy efficiency	energiakasutuse efektiivsus
energy industry	energiatööstus
energy legislation	energiaõigus
energy management	energiamajandus
energy market	energiaturg
energy policy	energiapoliitika
energy process	energeetiline protsess
energy production	energiatoodang
energy resource	energiavarud
energy saving	energia säästmine, säästev energiakasutus
energy source	energiaallikas
energy source material	energiakandja
energy storage	energia salvestamine, energiasalvestus
energy supply	energiavarustus; energiatarne
energy technology	energiatehnoloogia, energiatehnika ; energiatehnika ; energiatehnoloogia
energy type	energialiik
energy utilisation ; energy use	energiakasutus
enforcement	kehtestamine, jõustamine ; kehtestamine ; jõustamine
engine	mootor
engineering	inseneriteadus; masinateadus; tehnika; tehnoloogia ; tehnoloogia ; inseneriteadus ; masinateadus ; tehnika
engineering work	masinatehas
enjoy your meal ; have a nice meal	head isu
enlargement policy	laiendamispoliitika
enlargement programme	laiendamiskava
enriched uranium	rikastatud uraan
enrichment	rikastamine
enterovirus	enteroviirus
environment	keskkond
environment friendly	keskkonda säästev ; keskkonnahoidlik ; keskkonnasäästlik ; keskkonnasõbralik
environment market	keskkonnaturg
environmental accident	keskkonnaõnnetus
environmental accounting	keskkonnaarvepidamine
environmental administration institution	keskkonnajuhtimisasutus
environmental analysis	keskkonnaanalüüs
environmental anxiety	keskkonnamure
environmental aspect of human settlements	inimasulate keskkonnaaspekt
environmental assessment	keskkonnahinnang
environmental assessment criterion	keskkonnahinnangukriteerium
environmental auditing	keskkonnaaudit
environmental awareness	keskkonnateadvus
environmental change	keskkonnamuutus
environmental chemicals legislation	keskkonnakemikaaliõigus
environmental chemistry	keskkonnakeemia
environmental citizenship	keskkonnahoidlik kodakondsus
environmental compatibility	keskkonnahoidlikkus
environmental consequence	keskkonnamõju
environmental conservation	keskkonnakaitse
environmental contingency planning	tegevuse kavandamine keskkonnaõnnetuse puhuks
environmental control	keskkonnajärelevalve, keskkonnakontroll
environmental cost	keskkonnakulud
environmental crime	keskkonnakuritegu
environmental criminal law	keskkonnakriminaalõigus
environmental criminality	keskkonnakuritegevus
environmental criterion	keskkonnakriteerium
environmental culture	keskkonnakultuur
environmental damage	keskkonnakahju[stus] ; keskkonnakahju(stus)
environmental data	keskkonnaandmed
environmental development	keskkonnaareng
environmental economic valuation	keskkonna majanduslik hindamine
environmental economics	keskkonnaökonoomika
environmental economics of firms	ettevõtete keskkonnaökonoomika
environmental economy issue	keskkonna majandusprobleem
environmental education	keskkonnakasvatus
environmental engineering	keskkonnatehnika
environmental enterprise	keskkonnaettevõte
environmental ethics	keskkonnaeetika
environmental friendly procurement	keskkonnahoidlik hange
environmental fund	keskkonnafond
environmental hazard	keskkonnaoht, keskkonnarisk
environmental health	keskkonnalähtene tervishoid
environmental health hazard	keskkonnalähtene terviseoht
environmental health impact assessment	keskkonna tervisemõju hindamine
environmental health protection	tervise kaitsmine keskkonnamõju eest
environmental history	keskkonnaajalugu
environmental impact	keskkonnamõju
environmental impact of agriculture	põllumajanduse keskkonnamõju
environmental impact of aquaculture	vesiviljeluse (akvakultuuri) keskkonnamõju
environmental impact of energy	energeetika keskkonnamõju
environmental impact of fishing	kalanduse keskkonnamõju
environmental impact of forestry	metsanduse keskkonnamõju
environmental impact of households	kodumajapidamiste keskkonnamõju
environmental impact of industry	tööstuse keskkonnamõju
environmental impact of recreation	virgestuse (rekreatsiooni) keskkonnamõju
environmental impact of tourism	turismi keskkonnamõju
environmental impact of transport	veonduse keskkonnamõju
environmental impact statement	keskkonnamõju hindamise aruanne
environmental impact study	keskkonnamõju uuring
environmental incentive	keskkonnapreemia
environmental index	keskkonnakirjutiste register
environmental indicator	keskkonnanäitaja, keskkonnaindikaator
environmental industry	keskkonnatööstus
environmental informatics	keskkonnainformaatika
environmental information	keskkonnateave, keskkonnainfo
environmental information network	keskkonnateabevõrk
environmental information system	keskkonnateabesüsteem
environmental investment	keskkonnainvesteering
environmental law	keskkonnaseadus
environmental law enforcement	keskkonnaseaduse elluviimine
environmental legislation	keskkonnaõigus
environmental legislation on agriculture	põllumajandusse puutuv keskkonnaõigus
environmental legislative process	keskkonnaseadusandlus
environmental liability	keskkonnavastutus
environmental licence	keskkonnaluba
environmental management	keskkonnakorraldus, keskkonnajuhtimine
environmental medicine	keskkonnameditsiin
environmental misconduct	keskkonnanõuete rikkumine
environmental monitoring	keskkonnaseire
environmental noise	ümbrusemüra
environmental occupation	keskkonnaga seotud amet, keskkonnaelukutse
environmental perception	keskkonnataju
environmental plan	keskkonnakava
environmental planning	keskkonnaplaneerimine
environmental policy	keskkonnapoliitika; keskkonnapõhimõtted ; keskkonnapollitika
environmental policy instrument	keskkonnapoliitika vahend
environmental pollution	keskkonna reostumine, keskkonna saastumine
environmental priority	keskkonnaeelistus, keskkonnaprioriteet
environmental problem solving	keskkonnahäda, keskkonnamure, keskkonnaprobleem
environmental programme	keskkonnategevuskava
environmental protection	keskkonnakaitse
environmental protection agency	keskonnakaitseamet
environmental protection association	keskkonnakaitseühing
environmental protection cost	keskkonnakaitsekulud
environmental protection in the enterprise	keskkonnakaitse ettevõttes
environmental protection order	keskkonnakaitse-eeskiri
environmental protection organisation	keskkonnakaitseorganisatsioon
environmental protection regulation	keskkonnakaitsemäärus
environmental protection technology	keskkonnakaitsetehnoloogia
environmental psychology	keskkonnapsühholoogia
environmental quality	keskkonnakvaliteet
environmental quality criterion	keskkonnakvaliteedikriteerium
environmental quality objective	keskkonnakvaliteedieesmärk
environmental quality standard	keskkonnanorm, keskkonnakvaliteedinorm
environmental report	keskkonnaaruanne
environmental research	keskkonnauurimine
environmental risk	keskkonnarisk, keskkonnaoht
environmental risk assessment	keskkonnariski hindamine
environmental science	keskkonnateadus
environmental security	keskkonnaohutus
environmental specimen bank	keskkonnanäidisepank
environmental statement (eco-audit) ; environmental statement ; eco-audit	keskkonnamemorandum, keskkonnateatis ; keskkonnateatis ; keskkonnamemorandum
environmental statistics	keskkonnastatistika
environmental stock exchange	keskkonnabörs
environmental study	keskkonnauuring
environmental subsidy	keskkonnatoetus
environmental sustainable architecture	keskkonnahoidlik arhitektuur
environmental tax	keskkonnamaks
environmental teaching	keskkonnaõpetus
environmental technology	keskkonnatehnika
environmental terminology	keskkonnaterminoloogia, keskkonnasõnavara ; keskkonnaterminoloogia ; keskkonnasõnavara
environmental training	keskkonnakoolitus
environmental warfare	keskkonnavastane sõda
environmentalism	keskkondlus
environmentally dangerous substance	keskkonnaohtlik aine
environmentally friendly management	keskkonnahoidlik juhtimine
environmentally friendly product	keskkonnasäästlik toode
environmentally related disease	keskkonnalähtene haigus
environmentally responsible behaviour	keskkonnateadlik käitumine
environmentally unfriendly firm	keskkonnavaenulik ettevõte
enzyme	ensüüm, ferment ; ensüüm ; ferment
epicentre	epitsenter
epidemic	epideemia, rändtaud, taud ; epideemia ; rändtaud ; taud
epidemiology	epidemioloogia
equator	ekvaator
equatorial climate	ekvatoriaalkliima
equine	hobuslane
equipment	seadmestik, seadmed, varustus, aparatuur
equivalent dose	ekvivalentdoos
erbium	erbium
ergonomics	ergonoomia
erosion	erosioon, uuristus
erosion control	erosiooni ohjamine
estate rental	kinnisvara rentimine
estuarine biology	estuaaribioloogia
estuarine conservation area	estuaarikaitseala
estuary	estuaar, lehtersuue
estuary pollution	estuaarireostus
etching	söövitamine, söövitus
etching substance	söövitusaine
ethanol	etanool
ether	eeter
ethics	eetika
ethnography	etnograafia
ethnology	etnoloogia, rahvateadus
ethology	etoloogia, käitumispsühholoogia
europium	euroopium
eutrophication	eutrofeerumine
evaluation	hindamine
evaluation criterion	hindamiskriteerium
evaluation method	hindamismeetod
evaluation of technology	tehnoloogia hindamine
evaporation	aurumine
evapotranspiration	evapotranspiratsioon, koguaurumine
evolution	evolutsioon
exact science	täppisteadus
excavated hole	kaevand
excavation (process) ; excavation ; earthworks ; digging	kaevandamine
excavation heap	aherainemägi, terrikoonik ; aherainemägi ; aherainemägi ; terrikoonik
excavation side	kaevandamisrinne
excavation site	kaevandus, kaevandamiskoht
exceptional tax	erakordne maks
excessive height of chimney stacks	korstnate liigkõrgus
exchange policy	valuutavahetuspoliitika
executive order	täiteakt
exhaust device	väljalaskeseade
exhaust gas	heitgaas
exhibit	eksponaat
existing chemical	olemasolev kemikaal
exotic species	võõrliik
expenditure	väljaminek, kulu[d] ; väljaminek ; kulu ; kulud
experiment	katse, eksperiment
experimental study	katseuuring, eksperimentaaluuring
expert system	ekspertsüsteem
exploitation of underground water	põhjaveevõtt
exploration	uuring, uurimine
explosion	plahvatus
explosive	lõhkeaine
export	eksport, väljavedu
export licence	väljaveoluba, ekspordilitsents
export of hazardous wastes	ohtlike jäätmete väljavedu
exposure	ekspositsioon
expropriation	sundvõõrandamine
extensive cattle farming	ekstensiivne loomakasvatus
externality	välismõju, välistegurite tagajärg
extinct species	väljasurnud liik, hävinud liik
extinction (ecological) ; extinction	väljasuremine
extraction	hankiv metallurgia
extractive industry	maavaraammutustööstus
eye	silm
eyebrow	kulm
fabric	riie
factor market	tootmisteguriturg, sisenditurg, ressursiturg
factory farming	intensiivne loomakasvatus
faecal bacterium	fekaalibakter
fallout	õhuvõõriste sadenemine, õhusaasta sadenemine ; õhuvõõriste sadenemine ; õhusaasta sadenemine
fallow area	söötis maa
family	perekond ; sugukond
family law	perekonnaõigus
family planning	pereplaneerimine
famine	nälg
farm	talu
farm animal	põllumajandusloom
farm building	põllumajandusehitis
farm price	tootjahind
farming technique	talupidamistehnika
fascism	fašism
fast reactor	kiire reaktor
fast traffic	kiirliiklus
fault	murrang ; murrang
fauna	loomastik, fauna ; loomastik ; fauna
fauna restoration	looduselustiku taastamine
federal authority	föderaalametkond
federal government	föderaalvalitsus
federal law	föderaalõigus
fee	tasu
feeding of animals	loomasöötmine
feeling for nature	loodushoolivus
felid	kaslane
female ; woman	naine
fen	madalsoo
fermentation	käärimine, fermentatsioon
fermium	fermium
fern	sõnajalg
fertiliser	väetis
fertiliser law	väetiseseadus
fibre	kiud
fibreglass	klaaskiud
field ; land ; land ; acre ; patch	põld, nurm; väli ; põld ; nurm ; väli
field damage	põllumajandusmaa halvenemine (degradatsioon)
field experiment	välikatse
field study	väliuuring
filling material	pahtel, täitematerjal
filling station	tankla, bensiinijaam
film	film
filter	filter
filter cake	filtrikook
filtration	filtrimine, kurnamine
final storage	püsijäätmepanila
finances	rahalised vahendid
financial aid	toetusraha
financial assistance	finantsabi
financial compensation	rahaline hüvitis
financial contribution	rahaline panus
financial fund	finantsvahendid , finantseerimisvahendid ; finantsvahendid ; finantseerimisvahendid
financial instrument	finantseerimisinstrument
financial law	finantsõigus, rahandusõigus
financial management	finantsjuhtimine
financial market	laenuturg, rahaturg; väärtpaberiturg
financing	finantseerimine, rahastamine
fine	trahv, rahatrahv ; trahv ; rahatrahv
fine dust	peentolm
fire	põleng, tulekahju ; tulekahju ; põleng
fire precaution	tuleohutusmeede
fire protection	tuletõkestus
fire safety requirement	tuleohutusnõuded
fire service	tuletõrje
firefighter ; fireman ; firewoman ; fire fighter ; fire-eater	tuletõrjuja
fireproofing agent	tulekindlaks tegev aine
firing	põletamine, põletus
firm ; corporation ; enterprise ; company ; venture	firma, ettevõte ; ettevõte ; firma
fish	kala
fish disease	kalahaigus
fish farming	kalakasvatus
fish kill	kalahukk
fish stock	kalavarud
fish toxicity	mürgisus kaladele
fisheries management	kalamajanduse juhtimine, kalanduse juhtimine
fisheries structure	kalanduse struktuur
fishery	kalandus ; kalandus, kalamajandus; kalapüük ; kalapüük ; kalamajandus
fishery economics	kalandusökonoomoka
fishery policy	kalanduspoliitika
fishery resource	kalavarud
fishing	kalapüük
fishing ground	kalapüügipiirkond, kalastuspiirkond ; kalapüügipiirkond ; kalastuspiirkond
fishing industry	kalatööstus
fishing law	kalandusõigus (jur)
fishing licence	kalapüügiluba
fishing preserve	kalakaitseala
fishing vessel	kalalaev, kalapüügilaev
fitting (plumbing) ; fitting ; plumbing equipment ; plumbing fixtures	liitmik, toruliitmik ; liitmik ; toruliitmik
flag of convenience	mugavuslipp
flammable product	tuleohtlik toode, kergsüttiv toode
flaring	tungalpõletus
flavouring	maitseaine, vürts
flea	kirp
flexible approach to environmental protection	paindlik keskkonnakaitse
flocculant	helvestusaine, flokulant
flocculation	helvestamine, helvestumine, flokulatsioon
flood	tulv; suurvesi ; tulv ; suurvesi
flood control	üleujutustõrje, tulvatõrje; üleujutusohjeldus, tulvaohjeldus
flood forecast	suurvee-ennustus
flood protection	üleujutustõrje, tulvatõrje; üleujutusohjeldus, tulvaohjeldus
flood runoff	suurveeäravool
flooding	üleujutus
flora (biology) ; flora	taimestik, floora
flora (document) ; flora	floora (nimistu) ; floora
flora restoration	taimestiku taastamine
flotation	flotatsioon
flow	vool, voolamine
flow field	vooluväli
flower ; bloom ; blossom	lill
flowering plant	õistaim, katteseemnetaim
flowing water	vooluvesi, voolav vesi
flue gas	suitsugaas, põlemisgaas
fluidics	hüdroautomaatika
fluidisation	keevkihistamine, pseudoveeldamine
fluidised bed	keevkiht
fluoridation	fluorimine
fluorine	fluor
flushing	uhtmine, loputamine, läbipesu, pesu ; uhtmine ; loputamine ; läbipesu
flute	flööte ; flööt
fluvial resource	vooluveevaru
fly ash	lendtuhk
foaming agent	vahutekiti
fodder ; provender ; forage	sööt (sööda), loomatoit ; sööt ; loomatoit
fodder plant	söödataim
fog	udu
foliage	lehestik
folk tradition	rahvakomme
folklore	rahvaluule, folkloor ; rahvaluule ; folkloor
food	toit
food additive	toidulisand
food chain	toiduahel, toitumisahel
food commerce	toidukaubandus
food contamination	toidu saastumine
food hygiene	toiduhügieen
food industry	toiduainetööstus
food irradiation	toiduainekiiritus
food pollutant	toidusaasteaine
food preservation	toiduainete konserv[eer]imine ; toiduainete konserv(eer)imine
food processing industry	toiduainetööstus
food production (agriculture) ; food production	toidu[aine]tootmine ; toidu(aine)tootmine ; toiduainetootmine ; toidutootmine
food quality	toidu kavaliteet
food requirement	toitainevajadus, toiduvajadus
food science	toiduteadus
food storage	toiduvaru
food technology	toidutehnoloogia
food transport	toiduvedu
foodstuff	toiduaine
football	jalgpall
footpath	jalgrada
forage contamination	sööda saastumine, loomatoidu saastumine
forage crop	söödakultuur, söödavili; söödatootmine
forage law	söödaseadus
ford	koolmekoht
forecast	ennustus, prognoos
foreclosure	väljalunastusõiguse kaotus
foreign economic relations	välismajandussuhted
foreign policy	välispoliitika
foreign trade	väliskaubandus
forest	mets ; mets, laas ; laas
forest biological reserve	bioloogiline metsakaitseala
forest cover destruction	metsa raadamine, metsa hävitamine
forest damage	metsakahjustus
forest deterioration	metsa suremine, metsa kuivamine
forest ecology	metsaökoloogia
forest ecosystem	metsaökosüsteem
forest exploitation	metsakasutus
forest fire	metsapõleng, metsatulekahju ; metsapõleng ; metsatulekahju
forest industry	metsamajandus
forest management	metsakorraldus
forest pest	metsakahjur
forest policy	metsapoliitika
forest product	metsasaadus
forest production	metsatooted
forest protection	metsakaitse
forest reserve	metsakaitseala
forest resource	metsavaru
forestry	metsandus
forestry economics	metsamajanduse ökonoomika
forestry law	metsaseadus
forestry legislation	metsaõigus
forestry practice	metsakasvatus
forestry unit	metsaettevõte
form of government	riigivorm
forwarding agent	ekspediitor
fossil	fossiil, kivistis ; fossiil ; kivistis
fossil fuel	fossiilkütus, ürgkütus
fouling growth	laevakere kattumine (saastumine)
fountain	purskkaev
four stroke engine	neljataktiline mootor
framework legislation	raamseadustik
francium	frantsium
free movement of capital	kapitali vaba liikumine
free trade	vabakaubandus
freedom	vabadus
freedom of speech ; freedom of speech	sõnavabadus
freight transport	kaubavedu
freon	freoon
freshwater	magevesi
freshwater degradation	magevee halvenemine (degradatsioon)
freshwater ecosystem	mageveeökosüsteem
freshwater organism	mageveeorganismid
freshwater pollution	mageveereostus
freshwater resource	mageveevaru
frog	konn
frost	hall (halla) ; hall
fruit	vili, puuvili ; puuvili ; vili
fruit cultivation	puuviljandus
fruit tree	viljapuu
fuel	kütus
fuel additive	kütuselisand
fuel alcohol	küttealkohol
fuel composition	kütuse koostis
fuel consumption	kütusekulu
fuel oil	kütteõli, masuut ; kütteõli ; masuut
fuel tank installation	tankla, kütusetankla
fuel wood	küttepuit, küttepuu ; küttepuit ; küttepuu
fume	toss, ving ; toss ; ving
fumigation	fumigatsioon
functional substance	sihtotstarbeline aine
fungicide	fungitsiid, seenetõrjevahend
fungus	seen
fur	karusnahk
fur animal	karus[naha]loom ; karus(naha)loom
furan	furaan
furnace	ahi
furniture	mööbel
furniture industry	mööblitööstus
furriery	köösneritöökoda
gadolinium	gadoliinium
gallinacean	kanalised
gallium	gallium
galvanisation	galvaanimine, galvaanpindamine
game	mäng
game	jahiulukid, jahiloomad ja -linnud
gamma radiation	gammakiirgus
garden	aed
garden waste	aiajäätmed
gardener	aednik
gas	gaas
gas chromatography	gaaskromatograafia
gas company	gaasifirma
gas engine	gaasimootor
gas liquefaction	gaasi veeldamine
gas mixture	gaasisegu
gas network	gaasivõrk
gas pipeline	gaasitorustik, gaasijuhe
gas powered plant	gaasijõujaam
gas purification	gaasipuhastus
gas reservoir	gaasihoidla
gas supply	gaasivarustus
gaseous air pollutant	gaasiline õhusaaste
gaseous state	gaasiline olek
gasification	gaasistamine
gasohol	gasohol
gasoline engine	bensiinimootor
gastropod	tigu, kõhtjalgne
gaswork	gaasivabrik
gene	geen
genealogy	genealoogia
general	üldterminid
general	kindral
general administrative order	üldhaldusakt
general chemistry	üldkeemia
general education	üldharidus
genetic diversity	geneetiline mitmekesisus
genetic effect	geneetiline toime
genetic engineering	geenitehnoloogia, tehnogeneetika
genetic engineering legislation	tehnogeneetikaõigus
genetic information	geneetiline informatsioon, pärilikkuse informatsioon
genetic modification	geneetiline hälve
genetic pool ; gene pool	genofond, geenifond
genetic resource	geneetiline ressurss
genetic variation	geneetiline muutus
genetically modified organism	geneetiliselt modifitseeritud organism
genetics	geneetika
genocide	genotsiid
genome	genoom
genotoxicity	genotoksilisus
genotype	genotüüp
geo-referenced data	georefereeritud andmed
geo-referenced information	georefereeritud informatsioon
geodesy	geodeesia
geogenic factor	geogeenne tegur
geographic information system	geoinfosüsteem, GIS
geographical distribution of population	rahvastiku geograafiline jaotus
geographical projection	kaardiprojektsioon
geography	geograafia ; geograafia, maateadus
geological disaster	geoloogiline katastroof
geological process	geoloogiline protsess
geology	geoloogia
geometric correction	geomeetriakorrektsioon
geometry	geomeetria
geomorphic process	geomorfoloogiline protsess
geomorphology	geomorfoloogia
geophysical environment	geofüüsikaline keskkond
geophysics	geofüüsika
geotechnics	geotehnika
geotechnology	geotehnoloogia
geothermal energy	geotermiline energia, geotermaalenergia
germ	mikroob; idu ; mikroob ; idu
germ plasm	iduplasma
germanium	germaanium
germination	idanemine
geyser	geiser
giraffe	kaelkirjak
glacier	liustik
glaciology	liustikuteadus, glatsioloogia
glass	klaas
glass industry	klaasitööstus
glaze	jäide
global aspect	globaalaspekt
global convention	globaalkonventsioon, ülemaailmne kokkulepe
global model	maailmamudel
global warming	globaalsoojenemine, Maa kliima soojenemine ; globaalsoojenemine ; maa kliima soojenemine
glossary	seletussõnastik
glue	liim
glycolysis	glükolüüs
goal of individual economic business	eraettevõtluse eesmärk
gold	kuld
golf	golf
good management	hea juhtimine
goods	kaubad ; kaubad ; tooted
goods and services	kaubad ja teenused
goose	hani
gorilla	gorilla
government (cabinet)	valitsus
government advisory body	valitsuse nõuandeorgan
government building	valitsushoone
government liability	valitsuse vastutus
government policy	valitsuse poliitika
grain	teravili
graminaceous plant	kõrrelised, kõrstaimed ; kõrrelised ; kõrstaimed
granite	graniit
granulometry	lõimis, granulomeetriline koostis
grass	heintaimed
grass fire	rohtlatulekahju
grasshopper	rohutirts
grassland	rohumaa
gravel	kruus
gravel extraction	kruusavõtt, kruusa kaevandamine
gravel pit	kruusaauk, kruusakarjäär, kruusavõtukoht
grazing	karjatamine
green building	ökomaja
green corridor	roheline koridor
green manure	haljasväetis
green revolution	roheline revolutsioon
green space	haljasala
green tide	rohelised looded
green vegetable	köögivili
greenhouse cultivation	katmikaiandus
greenhouse effect	kasvuhooneefekt
greenhouse gas	kasvuhoonegaas
gridding	koordinaatvõrk
grinding	jahvatamine
gross national product	rahvamajanduse kogutoodang
groundwater	põhjavesi
groundwater endangering	põhjavee ohustamine
groundwater extraction	põhjaveevõtt
groundwater pollution	põhjavee reostamine
groundwater protection	põhjaveekaitse
groundwater quality	põhjavee kvaliteet
group behaviour	rühmakäitumine
guitar	kitarr
gulf	merelaht
gull	kajakas
gymnosperm	paljasseemnetaim
gypsum	kips
habitat	elupaik, kasvukoht ; elupaik ; kasvukoht
habitat destruction	elupaikade (kasvukohtade) hävitamine
haematology	hematoloogia, vereõpetus ; hematoloogia ; vereõpetus
hafnium	hafnium
haiku	haiku
hail	rahe
hairdresser ; barber	habemeajaja
half-life	poolestusaeg
haloform	haloform
halogenated biphenyl	halogeenitud difenüül
halogenated compound	halogeenitud ühend
halogenated hydrocarbon	halogeenitud süsivesinik
halogenated phenol	halogenofenool, halogeenitud fenool
halogenated pollutant	halogeene sisaldav reoaine
handicraft	käsitöö
handicraft business	käsitööndus
handkerchief	taskurätik
harbour	sadam
hard disk drive ; hard disk ; HD	kõvaketas
hard-to-dispose-of waste	raskesti kõrvaldatavad jäätmed
hardness	kõvadus
harem	haarem
harmonisation of law	seaduste ühtlustamine
harvest	saak ; saak, viljasaak ; viljasaak
hassium	hassium
hazard	oht
hazard area	ohupiirkond
hazard of pollutants	reostusoht, saasteoht
hazardous chemical export	ohtlike kemikaalide väljavedu (eksport)
hazardous substance	ohtlik aine
hazardous substances legislation	seadused ohtlike ainete kohta
hazardous waste	ohtlikud jäätmed
hazardous waste dump	ohtlike jäätmete prügila
hazardous working material	ohtlik töömaterjal
haze	somp, põuasomp, põuasumu ; somp ; põuasomp ; põuasumu
headland	maanina ; neem
headland	pöörderiba
health	tervis
health care	tervishoid
health care profession	tervishoiuelukutse
health effect of noise	müra mõju tervisele
health facility	tervishoiuasutus
health hazard	terviseoht
health legislation	tervishoiuõigus
health regulation	tervishoiueeskiri
health service	tervishoiuteenistus
health-environment relationship	keskkonna mõju tervishoiule
health-related biotechnology	tervishoiuotstarbeline biotehnoloogia
hearing	kuulmine
hearing acuity	kuulmisteravus
hearing impairment	kuulmiskahjustus
hearing procedure	ülekuulamine
hearing protection	kõrvakaitse
hearing system	kuulmiselund
heat	soojus
heat and power station	koostootmisjaam
heat pump	soojuspump
heat storage	soojuse salvestamine
heat supply	soojusvarustus
heater	kütteseade, küttekeha
heathland	nõmm
heating	küte, kütmine ; küte ; kütmine
heating plant	küttekatlamaja
heaven ; sky	taevas
heavy goods vehicle traffic	raskeveokiliiklus
heavy metal	raskmetall
heavy metal load	raskmetallikoormus
hedge	hekk
hedgehog	siil
hedonism	hedonism
helium	heelium
herbicide	herbitsiid
herbivore ; plant eater	rohusööja, herbivoor ; rohusööja ; herbivoor
heroin	heroiin
heron	haigur
heterocyclic compound	heterotsükliline ühend
high mountain	kõrge mägi
high tide water	tõusukõrgvesi
high voltage line	kõrgepingeliin
high-rise building	kõrghoone
high-speed railway	kiirraudtee
high-speed train	kiirrong
higher education	kõrgharidus
highway	maantee
hiking trail	matkarada
historic centre	vanalinn
historical evolution	ajaloomälestis
historical monument	ajalooline areng
historical research	ajaloouuring
historical site	ajalooline paik
history	ajalugu
holiday ; opor-garai	puhkus
holiday camp	puhkelaager
holmium	holmium
home ; home ; house	hoone
home garden	koduaed
homeostasis	homöostaas
homepage	kodulehekülg
homologation	kohtuniku kinnitus
honey	mesi
horse	hobune
horticulture	aiandus
hospital ; clinic	haigla
hospital waste	haiglajäätmed
hot water	kuum vesi
hotel industry	hotellindus
household	majapidamine
household chemical	majapidamiskemikaal
household expenditure	majapidamiskulud
household goods	majapidamiskaubad
housing	elamispind; ulualune ; elamispind ; ulualune
housing density	asustustihedus; hoonestustihedus
housing improvement	elamistingimuste parendamine
housing legislation	elamuõigus
housing programme	elamuehituskava
housing quality standard	elamukvaliteedinormid
human body	inimese keha
human disease	inimeste haigus
human ecology	inimese ökoloogia, humaanökoloogia
human habitat	inimese elupaik
human health	inimese tervis ; inimtervis
human migration	inimränne
human physiology	inimfüsioloogia
human population	inimpopulatsioon
human rights	inimõigused
human science	inimteadus
human settlement	inimasula
human settlement management	asulamajandus
human-made disaster	inimtekitatud katastroof
humanitarian aid	humanitaarabi
humus	huumus
hunting	jaht, küttimine
hunting licence	jahiluba
hunting reserve	jahikaitseala
hurricane	orkaan
hybridisation	hübridiseerimine
hydraulic construction	vesiehitis
hydraulic engineering	vesiehitus
hydraulics	hüdraulika
hydrobiology	hüdrobioloogia
hydrocarbon	süsivesinik
hydrocarbon storage tank	süsivesinikumahuti
hydrochloric acid ; muriatic acid	vesinikkloriidhape, soolhape
hydroculture	hüdropoonika
hydroelectric energy	hüdroelektrienergia
hydroelectric power plant	hüdroelektrijaam
hydrogen	vesinik
hydrogen sulphide	vesiniksulfiid, väävelvesinik
hydrogeology	hüdrogeoloogia
hydrographic basin	valgla
hydrographic network	veekoguvõrk, hüdrograafiline võrk
hydrography	hüdrograafia
hydrologic balance	veebilanss
hydrologic cycle	veeringe
hydrologic disaster	veekatastroof
hydrologic flow	vee voolamine looduses
hydrology	hüdroloogia
hydrolysis	hüdrolüüs
hydrometeorology	hüdrometeoroloogia
hydrometry	hüdromeetria
hydrosphere	hüdrosfäär
hyena	hüään
hygiene	hügieen
hymenopteran	kiletiivaline, hümenopter ; kiletiivaline ; hümenopter
hypertext	hüpertekst
ice	jää
ice hockey	jäähoki
ice pack	paakjää
iceberg	jäämägi
ideology	ideoloogia
illiterate	kirjaoskamatu
image classification	satelliitpildiliigitus
image enhancement	pildiväärindus
image filtering	satelliitpildifiltrimine
image processing digital system	pilditöötluse digitaalsüsteem
image registration	kujutise geokodeerimine
immission	immissioon
immission control	immissioonikontroll
immission control law	immissioonikontrolliseadus
immission damage	immissioonikahjustus
immission forecast	immissiooniprognoos
immission limit	immisioonipiirväärtus
immission load	immissioonikoormus
immune system	immuunsüsteem
immunity	immuunsus
immunoassay	immunoloogiline määramine (analüüs)
immunological disease	immunoloogiline haigus
immunology	immunoloogia
impact assessment	mõju hindamine
impact minimisation	mõju minimeerimine
impact prevention	mõju vältimine
impact reversal	keskkonnamõju pööramine
impact source	mõjuallikas
impactor	tolmuproovel, tolmumõõtur
implementation law	rakendusseadus
import	import, sissevedu ; import ; sissevedu
import licence	sisseveoluba, impordilitsents
impoverishment	vaesumine
impregnating agent	immutusaine
impregnation	immutus, immutamine, impregneerimine
improvement of efficiency	kasuteguri suurendamine
impulsive noise	impulssmüra
in situ	kohapeal, in situ ; kohapeal ; in situ
in vitro assay	in vitro-katse, katseklaasikatse
in vivo assay	in vivo-katse
incentive fund	ergutusfond
incentive tax	ergutusmaks[ustamine] ; ergutusmaks(ustamine)
incidental pollution	juhuslik reostus, ettekavatsemata reostus
incineration	põletamine
incineration of waste	prügipõletus, jäätmepõletus
incineration residue	põletusjääk
incinerator	põletusahi, prügipõletusahi, jäätmepõletusahi
income	sissetulek; tulu
income tax	tulumaks
incorporation	inkorporeerimine
indefinite legal concept	määratlemata õigusmõiste
indemnity	hüvitis
index	indeks; register ; indeks ; register
indexing of documentation	dokumentatsiooni indekseerimine
indicator	indikaator
indicator of environmental quality	keskkonnakvaliteedi näitaja (indikaator)
indigenous knowledge	omamaised teadmised
indigenous technology	omamaine tehnoloogia
indirect discharger	kaudheiteallikas
indium	indium
individual wastewater treatment	reovee omapuhasti
indoor air pollution	siseõhu saastamine (reostamine )
indoor environment	ruumikeskkond
industrial activity	tööstustegevus
industrial area	tööstuspiirkond
industrial association	tööstusettevõtete liit
industrial building	tööstushoone
industrial crop	tehniline kultuur
industrial development	tööstuse areng
industrial dumping	tööstusjäätmete ladestamine
industrial economics	tööstusökonoomika
industrial effluent	tööstusreovesi
industrial emission	tööstusheide õhku
industrial environment	tööstuskeskkond
industrial environmental policy	tööstuse keskkonnapoliitika
industrial equipment	tööstusseadmed
industrial installation	tööstusseade
industrial legislation	tööstusõigus
industrial manufacturing	tööstustootmine
industrial material	tööstusmaterjal
industrial medicine	töötervishoid
industrial noise	tööstusmüra
industrial planning	tööstuse planeerimine
industrial plant (building) ; industrial plant	tehas, vabrik ; tehas ; vabrik
industrial plant (organism) ; industrial plant	tehniline kultuur
industrial policy	tööstuspoliitika
industrial pollution	tööstusreostus, tööstussaastus
industrial process	tööstusprotsess
industrial product	tööstustoode
industrial production	tööstustoodang
industrial production statistics	tööstustoodangustatistika
industrial property right	tööstusomandiõigus
industrial safety	töökaitse; tööohutus[hoid] ; töökaitse; tööohutus(hoid)
industrial site	tööstuskrunt
industrial sludge	pulp, lobri, tööstussete
industrial society	tööstusühiskond, industriaalühiskond
industrial structure	tööstusehitis
industrial waste	tööstusjäätmed
industrial waste gas	tööstusheitgaas
industrial waste water	tööstusreovesi
industrial wasteland	tööstusjäätmaa
industrial zoning	tööstuse tsoneerimine
industrialisation	industrialiseerimine
industry	tööstus
inert waste	püsijäätmed, inertjäätmed
inertisation	jäätmete püsivaks muutmine
infant	väikelaps
infant mortality	laste suremus
infection	nakkus, infektsioon
infectious disease	nakkushaigus
infestation of crops	põllukahjurirünne
infestation of food	nugilisnakatus, infestatsioon
infiltration	maasseimbumine, infiltratsioon
inflammable substance	tuleohtlik aine
inflation	inflatsioon
inflow	juurdevool[uvesi], sissevool[uvesi] ; juurdevool(uvesi), sissevool(uvesi) ; juurdevool ; sissevool
influenza ; flu	gripp
info ; information	info ; informatsioon ; teave
informal negotiation	mitteametlik läbirääkimine
informatics ; computer science ; information science	informaatika
information centre	teabekeskus, infokeskus
information clearing-house	infokeskus
information exchange	teabevahetus, infovahetus
information infrastructure	infovahetuse infrastruktuur
information kit	teabemapp
information network	infovõrk
information processing	infotöötlus, teabetöötlus
information service	infotalitus, teabetalitus ; infotalitus ; teabetalitus
information source	infoallikas, teabeallikas
information system	infosüsteem
information technology ; IT	infotehnoloogia; infotehnika
information technology industry	infotehnoloogiatööstus
information transfer	teabeedastus, infoedastus
infraction	õigus[e]rikkumine, seadus[e]rikkumine ; õiguserikkumine ; õigusrikkumine ; seaduserikkumine ; seadusrikkumine
infrared radiation	infrapunakiirgus
infrasound	infraheli
infrastructure	infrastruktuur
inhabitant	elanik, asukas ; elanik ; asukas
initial training	algväljaõpe
injury	vigastus
ink	tint; trükivärv, trükimust ; tint ; trükivärv ; trükimust
inland fishery	siseveekalandus
inland navigation	siseveesõit
inland water	sisevesi
inland waterways transport	siseveevedu, siseveetransport
innovation	innovatsioon, uuendus ; uuendus ; innovatsioon
inorganic chemistry	anorgaaniline keemia
inorganic fertiliser	mineraalväetis, kunstväetis
inorganic pollutant	anorgaaniline reoaine
inorganic substance	anorgaaniline aine
insect	putukas
insecticide	insektitsiid, putukamürk
insectivore	putuktoiduline, insektivoor ; putuktoiduline ; insektivoor
insoluble substance	lahustumatu aine
inspection	ülevaatus
inspection of records	raamatupidamisrevisjon
inspection service	inspektsioon
installation optimisation	seadmestiku optimeerimine
installation requiring approval	paigaldusluba vajav seade
installation restoration	seadme taastamine
instep	pöiaselg
institutional activity	institutsiooniline tegevus
institutional structure	institutsionaalstruktuur
institutionalisation	institutsionaliseerimine
instrument manufacture	aparaadiehitus
instrumentation	aparatuur; mõõteseadmed
insulation	isoleerimine
insurance	kindlustamine, kindlustus
insurance business	kindlustustegevus
insurance coverage	kindlustuskate
integral natural reserve	loodusreservaat
integrated environmental protection technology	kompleksne keskkonnakaitse, tervikkeskkonnakaitse
integrated management	tervikjuhtimine
integrated pest control	kompleksne kahjuritõrje, terviktaimekaitse
integrated pollution control	kompleksne reostustõrje (saastetõrje), kompleksne reostusohje (saasteohje), tervikreostustõrje
intensive animal husbandry	intensiivloomakasvatus
intensive farming	intensiivpõllumajandus
inter-library loan	raamatukogudevaheline laenutus
interaction of pesticides	pestitsiidide koostoime
interchange of electronic data	elektrooniline andmevahetus
interdisciplinary research	erialadevaheline (interdistsiplinaarne) uurimistöö
interest	intress
interest group	huvirühm
interim decision	esialgne otsus
interlaboratory comparison	laboritevaheline võrdlus
intermediate goods	pooltooted
intermittent noise	vahelduv müra
internal European market	Euroopa siseturg
internal migration	sisemigratsioon
internalisation of external costs	väliskulude muutmine otsesteks tootmiskuludeks
international agreement	rahvusvaheline leping
international assistance	rahvusvaheline abi
international balance	rahvusvaheline tasakaal
international co-operation	rahvusvaheline koostöö
international competitiveness	rahvusvaheline konkurentsivõime
international conflict	rahvusvaheline konflikt
international convention	rahvusvaheline konventsioon
international distribution	rahvusvaheline jaotus
international division of labour	rahvusvaheline tööjõujaotus
international economic law	rahvusvaheline majandusõigus
international environmental relations	rahvusvahelised keskkonnasuhted
international harmonisation	rahvusvaheline ühtlustamine
international law	rahvusvaheline õigus
international organisation	rahvusvaheline organisatsioon
international politics	rahvusvaheline poliitika
international relations	rahvusvahelised suhted
international safety	rahvusvaheline julgeolek
international standardisation	rahvusvaheline standardimine
international trade	rahvusvaheline kaubandus
international transaction	rahvusvaheline tehing
international watercourse	rahvusvaheline vooluveekogu
internationally important ecosystem	rahvusvaheliselt tähtis ökosüsteem
internet search service	Internetiotsiteenindus, Internetiotsiteenus
internet service provider ; ISP ; Internet access provider ; Internet service provider	Internetiteenuse andja, Interneti tarnija ; Internetiteenuse andja ; Interneti tarnija
interpolation	interpoleerimine, interpolatsioon
interpretation method	interpretatsioonimeetod, tõlgendusmeetod
interpreter	tõlk
intertidal zone	loodetevöönd
intervention fund	interventsioonifond
intervention in nature and landscape	sekkumine loodus- ja maastikukasutusse
intervention on land	sekkumine maakasutusse
intoxication	joove
introduction of animal species	loomaliikide sissetalumine (introduktsioon)
introduction of plant species	taimeliikide sissetalumine (introduktsioon)
inventory	varaloend
inventory of forest damage	metsakahjustuste inventuur
inversion	inversioon, ümberasetus ; inversioon ; ümberasetus
inversion layer	inversioonikiht
invertebrate	selgrootu, invertebraat
investment	investeering
iodine	jood
ion	ioon
ion exchange	ioonivahetus
ion exchanger	ioniit, ioonivaheti
ionising radiation	ioniseeriv kiirgus
ionosphere	ionosfäär
iridium	iriidium
iron	raud
iron and steel industry	raua- ja terasetööstus
iron industry	rauatööstus
iron scrap	vanaraud
ironwork industry	malmivalutööstus
irradiation	kiiritus
irreversibility of the phenomenon	nähtuse pöördumatus
irrigation	niisutus
irrigation farming	niisutusmaaviljelus
irrigation system	niisutussüsteem
island ; isle	saar
island ecosystem	saareökosüsteem
isomer	isomeer
isotope	isotoop
ivory	elevandiluu, vandel ; elevandiluu ; vandel
jazz	džäss
joint debtor	solidaarvõlgnik
joint implementation	ühisrakendus
journalism	ajakirjandus
judgement (sentence) ; sentence ; judgement	kohtuotsus
judicial assistance	õigusabi
judicial body	kohtuorgan
judicial system	kohtusüsteem
judiciary rule	kohtupidamist reguleeriv norm
judo	judo
juridical act	õigustoiming
jurisdiction	õigusmõistmine, kohtumõistmine ; õigusmõistmine ; kohtumõistmine
jurisprudence	õigusteadus
justice	õigus
karate	karate
karst	karst
kerosene	petrooleum, petrool
krypton	krüptoon
labelling	markeerimine, tähistamine
laboratory	labor[atoorium] ; labor(atoorium)
laboratory experiment	laborivarustus
laboratory research	laboratoorne uurimistöö, laboriuuring
laboratory technique ; laboratory techniques	laboritehnika
laboratory test	laborikatse, laboriuuring
laboratory waste	laborijäätmed
labour	töö
labour force	tööjõud
labour law	tööõigus
labour market	töö[jõu]turg ; töö(jõu)turg
labour relations	töösuhted
lacquer	lakk
lagoon	laguun
lagooning	biotiikpuhastus
lake	järv
lake basin	järvenõgu; järvevalgla
lake pollution	järvereostus
lamp ; light	lamp
land	maa
land allotment	maa  kruntimine
land clearing	raadamine
land conservation	maahooldus
land consolidation	maa massiivistamine
land cover	maapinnakate
land development	kinnisvara arendamine
land disposal	jäätmete pinnaskäitlus, jäätmekäitlus künnikihis ; jäätmete pinnaskäitlus ; jäätmekäitlus künnikihis
land ecology	maismaaökoloogia
land forming	maaüksuste formeerimine
land mammal	maismaaimetaja
land management and planning	maa korraldus ja planeerimine
land occupation	maa hõlvamine; maahõlve
land planning	maa planeerimine
land pollution	maa reostamine (saastamine)
land reclamation	maaparandus
land register	maakataster
land restoration	maa tervendamine
land restoration in mountain areas	mägismaa tervendamine
land setup	maakasutuse planeerimine
land tax	maamaks
land transportation	maismaavedu
land use	maakasutus
land use classification	maakasutuse liigitus
land use plan	maakasutuskava
land use planning	maakasutuse planeerimine, territoriaalplaneerimine
land use regime	maakasutussuhe
land value	maa väärtus
land-based activity	maismaategevus
land-based marine pollution	maalähtene merereostus
land-management intervention area	maastikuhooldusala
landfill	prügila
landfill base sealing	prügilapõhja vooderdamine
landfill covering	prügila katmine
landfill degasification	prügilagaasiärastus
landfill gas	prügilagaas
landfill leachate	prügilanõrgvesi; prügilavesi
landform	pinnavorm
landscape	maastik
landscape after mining	kaevandamisjärgne maastik
landscape alteration	maastikukujundus
landscape architecture	maastikuarhitektuur
landscape component	maastikuelement
landscape conservation	maastikuhoid
landscape conservation policy	maastikukaitsepoliitika
landscape consumption	maastiku röövkasutus
landscape ecology	maastikuökoloogia
landscape management	maastikuhooldus
landscape planning	maastikuplaneerimine
landscape protection	maastikukaitse
landscape protection area	maastikukaitseala, looduspark
landscape utilisation	maastikukasutus
landslide	maalihe
lanthanum	lantaan
large combustion plant	suur prügipõletusettevõte, suur jäätmepõletusettevõte
laser ; Light Amplification by Stimulated Emission of Radiation	laser
latitude	geograafiline laius ; laius
laugh	naerma
laundering	pesupesemine
law	seadus
law	õigus
law ; law (science)	õigusteadus
law amendment	seadusemuutus
law branch	õigusharu
law draft	seaduseelnõu
law enforcement	seaduse rakendamine
law relating to prisons	õigussätted kinnipidamiskohtade kohta
lawrencium	lavrentsium
leaching	leostumine
lead	plii
lead compound	pliiühend
lead level in blood	vere pliisisaldus
lead-in-petrol law	seadus bensiini pliisisalduse kohta
leaf	leht
leakage	leke, lekkimine ; leke ; lekkimine
leap year	liigaasta
lease	rendileping
leather	nahk ; nahk
leather industry	nahatööstus
legal basis	õiguslik alus, seaduslik alus
legal form of organisations	organisatsiooni seaduslik vorm
legal procedure	kohtumenetlus
legal profession	õigustalitus
legal regulation	määrus
legal remedy	õigusabinõu
legal system	õigussüsteem
legal text	juriidiline tekst
legally protected right	seadusega kaitstud õigus
legislation	seadusandlus, seadusloome ; seadused
legislation on pollution	keskkonnaõigus
legislative authority	seadusandja
legislative competence	juriidiline kompetents
legislative information	juriidiline informatsioon, õigusteave
legislative procedure	juriidiline protseduur
legislature	seadusandlik võim
leisure activity	vabaajategevus
leisure centre	vabaajakeskus, puhkekeskus
leisure time	vaba aeg
lemon	sidrun
lens	lääts
lepidopteran	liblikaline, soomustiivaline, lepidopter
less developed country	arengumaa
leukaemia	leukeemia
level of education	haridustase
levy	lõiv, maks ; maks ; lõiv
lexicon	leksikon
liability	vastutus
liability legislation	kahjuhüvitamisõigus
liberalism	liberalism
library	raamatukogu
library service	raamatukoguteenistus
licencing procedure	litsentsimisprotseduur
lichen	samblik
life cycle	elutsükkel, arengutsükkel
life science	bioloogia, teadus elust
life-cycle management	olelustsükli juhtimine
lifestyle	eluviis
light	valgus
lighting	valgustus
lignite	pruunsüsi, ligniit
lignite mining	pruunsöe kaevandamine
lime	lubi
limestone	lubjakivi
limit value	piirväärtus
limnology	limnoloogia, järveteadus ; limnoloogia ; järveteadus
line	liin
line source	joonsaasteallikas
linear source of sound	joonmüraallikas
liner material	vooderdusmaterjal
linguistics	keeleteadus ; lingvistika
lion	lõvi
lipid	lipiid, rasv
lipophilic substance	rasvlahustuv aine, lipofiilne aine
lipstick	huulepulk
liquefied gas	vedelgaas
liquid	vedelik
liquid manure	vedelsõnnik, läga
liquid state	vedel olek
liquid waste	vedeljääde
literature	kirjandus
literature data bank	kirjandusandmepank
literature evaluation	kirjanduse hindamine
literature study	kirjandusallikate läbitöötamine
lithium	lLiitium ; liitium
lithography	litograafia
lithosphere	litosfäär
litigation	kohtuasi; hagi ; kohtuasi ; hagi
litter	allapanu ; jäätmed
littoral	rannikuvöönd, litoraal ; rannikuvöönd ; litoraal
livestock	kari (karja), kariloomad, põllumajandusloomad ; kari ; kariloomad ; põllumajandusloomad
livestock breeding	tõuaretus
livestock farming	loomakasvatus ; loomapidamine
living condition	elamistingimused
living environment	elukeskkond
living space	eluruum
living standard	elustandard
lizard	sisalik
load bearing capacity	koormustaluvus
local afforestation	kohalik metsastamine
local authority	kohalik võim
local development	kohalik areng
local finance	kohalik finantseerimine
local government	kohalik omavalitsus
local government policy	kohalik omavalitsuspoliitika
local heat supply	kohtküte
local passenger service	kohalik sõitjatevedu
local recreation	kohalik virgestus
local resource utilisation	kohalike ressursside kasutamine
local traffic	kohalik liiklus
location of industries	tööstusettevõtete paiknemine
locomotive	vedur
lodging	elukoht, korter ; elukoht ; korter
logic	loogika
long	pikk
long-distance traffic	kaugliiklus
long-distance transport	kaugvedu
long-term effect	pikaaajamõju, kaugmõju
long-term experiment	kestuskatse
longitude	geograafiline pikkus, pikkus
lorry	veoauto, madelauto ; veoauto ; madelauto
loss	kadu
loss of biotope	biotoobikadu
loudness	valjus
low flow	madalveeaeg, madalvesi; madalveevooluhulk
low-cost housing	odavad elamud
low-level flight	madallend
low-level technology	lihttehnoloogia
lubricant	määrdeaine, määrdeõli, määre ; määrdeaine ; määrdeõli ; määre
luminosity	kirkus, heledus
lunch ; lunch ; lunch ; lunch ; luncheon	lõuna ; lõuna ; lõuna ; lõuna ; lõuna
lutetium	luteetsium
lye	leelis
lymphatic system	lümfisüsteem
lynx	ilves
lysimetry	lüsimeetria
machine manufacture	masinaehitus
machinery ; mechanism	masinad, mehhanismid ; masinad ; mehhanismid
macroeconomic goal	makromajanduslik eesmärk
macroeconomics	makromajandusteadus, makroökonoomika
macrophyte	makrofüüt
macroscopic	makroskoopiline
magnesium	magneesium
magnetic tape	magnetlint
magnetism	magnetism
maintenance (technical) ; maintenance	hooldus, hoole, korrashoid ; hooldus ; hoole, ; hoole ; korrashoid
maintenance of environment	keskkonnahooldus
major accident	suurõnnetus
major risk	suurrisk
major risk installation	suurriskseade
malaria	malaaria
malformation	väärarend, väärmoodustis
malnutrition	alatoitlus
mammal	imetaja
man	inimene
man-made climate change	inimpõhjustatud kliimamuutus
management	juhtimine, haldamine
management accounting	juhtimisarvestus, operatiivarvestus
management contract	haldusleping
management of natural resources	loodusvarade haldamine
management plan	halduskava
management technique	juhtimistehnika
mandate	mandaat
manganese	mangaan
mangrove	mangroov[mets] ; mangroov(mets)
manpower	tööjõud
manufacturing activity	tootmine
manufacturing trade	ärikaubandus
manure	väetis ; väetis, sõnnik ; sõnnik
manure production	väetisetootmine
map	kaart ; maakaart
map chart	kaart
mapping	kaardistamine
mapping of lichens	samblike kaardistamine
maquis	makja
marble	marmor
marginal land	marginaalmaa
mariculture	meriviljelus
marina	paadisadam, jahisadam ; paadisadam ; jahisadam
marine biology	merebioloogia
marine ecology	mereökoloogia
marine ecosystem	mereökosüsteem
marine engineering	laevatehnika
marine environment	merekeskkond
marine fauna	mereloomastik
marine fishery	merekalapüük
marine geology	meregeoloogia
marine mammal	mereimetaja
marine monitoring	mereseire
marine organism	mereorganism
marine park	merelooduspark
marine pollution	merereostus
marine reserve	merekaitseala
marital status	perekonnaseis
maritime law	mereõigus
maritime navigation	meresõit
maritime transport	meretransport, merevedu, meritsivedu
marker	märgis, marker, tähis
market ; marketplace	turg
market economy	turumajandus
market form	turutüüp
market gardening	äriaiandus
market price	turuhind
market research	turu-uuring
market study	turu-uuring
marketing	turundus
marsh	marš ; padur
marsupial	kukruline
mason ; bricklayer ; stonemason	müürsepp
masonry	müüritis
mass media	massiteabevahendid, massisuhtlusvahendid, meedia
mass recreation	hulgavirgestus
mass transport	massiülekanne
material ; materials	materjal ; materjalid
material life cycle	materjali olelusiga
materials science	materjaliõpetus, materjaliteadus
mathematical analysis	matemaatiline analüüs
mathematical method	matemaatiline meetod
mathematics	matemaatika
maximum admissible concentration	lubatud piirsisaldus, künnissisaldus, lubatud piirkontsentratsioon
maximum immission concentration	immissiooni piirmäär
meadow	niit, looduslik rohumaa; aas, nurm ; nurm ; niit ; looduslik rohumaa ; aas
means of agricultural production	põllumajanduslikud tootmisvahendid
means of communication	sidevahendid
measuring	mõõtmine
measuring instrument	mõõteriist
measuring method	mõõtmismeetod
measuring programme	mõõtmiskava, mõõtmisprogramm
meat	liha
mechanical equipment	mehaaniline sisseseade
mechanical industry	masinatööstus
mechanical vibration	mehaaniline vibratsioon
medical science	arstiteadus
medicinal plant	ravimtaim
medicine ; medicine (practice)	meditsiin
meitnerium	meitneerium
melting	sulatamine, sulatus; sulamine ; sulatamine ; sulatus ; sulamine
membrane	membaan, diafragma ; membaan ; diafragma
mendelevium	mendeleevium
menorah	menoraa
merchant shipping	kaubalaevandus
mercury	elavhõbe
metabolism	ainevahetus, metabolism ; ainevahetus ; metabolism
metabolite	ainevahetussaadus, metaboliit ; ainevahetussaadus ; metaboliit
metainformation	metainformatsioon
metal	metall
metal oxide	metalloksiid
metal product	metallsaadus
metal products industry	metallsaadusetööstus
metal waste	vanametall, metallijäätmed
metallic mineral	metallimaak
metallurgical industry	metallurgiatööstus
metallurgy	:metallurgia ; metallurgia
metaphysics	metafüüsika
meteor ; meteor ; meteor ; meteor ; meteor ; shooting star ; falling star	meteoor ; meteoor ; meteoor ; meteoor ; meteoor
meteorite	meteoriit
meteorological disaster	ilmastikukatastroof
meteorological parameter	ilmastikutegur
meteorological phenomenon	ilmastikunähtus
meteorological research	meteoroloogiline uurimistöö
meteorology	meteoroloogia
methane ; marsh gas ; methyl hydride	metaan
methanisation	metaankääritamine
methanol	metanool
method	meetod
methodology	metodoloogia
metrology	metroloogia
metropolis	pealinn ; pealinn, suurlinn ; suurlinn
micro-organism	mikroorganism, mikroob, pisik
microbiological analysis	mikrobioloogiline analüüs
microbiology	mikrobioloogia
microclimate	mikrokliima
microclimatology	mikroklimatoloogia
microcomputer	mikroarvuti
microecosystem	mikroökosüsteem
microelectronics ; microminiaturization ; microsystem electronics	mikroelektroonika
microfiltration	mikrofiltrimine
microphone	mikrofon
micropollutant	mikroreoaine, mikrosaasteaine
microscopy	mikroskoopia
microwave	mikrolaine
migrant labour	rändtööjõud
migratory bird	rändlind
migratory fish	siirdekala
military activities	sõjategevus
military air traffic	kaitseõhusõidukite liiklus
military aspects	militaaraspektid ; sõjaväe keskkonnamõju
military equipment	sõjavarustus
military zone	sõjaväepiirkond
milk	piim
mill	veski
mine	kaevandus
mine filling	kaevandusala täitmine
mineral	mineraalne pinnasestabilisaator
mineral conditioner	mineraalne
mineral deposit	maardla
mineral extraction	mineraalide kaevandamine
mineral fibre	mineraalkiud
mineral industry	mäetööstus
mineral matter	mineraalaine
mineral oil	mineraalõli
mineral pollution	mineraalne reostus
mineral resource	maavarad
mineral waste	kaevandamisjäätmed
mineral water	mineraalvesi
mineralisation	mineraliseerumine
mineralogy	mineraloogia
minimal cost planning	miinimumkuluplaanimine
minimisation of damage	kahju minimeerimine
mining district	kaevanduspiirkond
mining industry	mäetööstus
mining law	kaevandamisõigus (jur)
mining product	kaevandamissaadus
mining regulation	kaevandamiseeskiri
mining site restoration ; mine reclamation	kaevandusala rekultiveerimine
mining waste	kaevandamisjäätmed
minister competence	ministri kompetents
ministerial decree	ministeeriumi määrus
ministry	ministeerium
ministry ; ministry building	ministeeriumihoone
minor	alaealine
minority	vähemus
miscellaneous product	segatoode
miscibility	segunevus
mist	somp (märg), hägu, uduvine ; somp ; hägu ; uduvine
mite	lestaline
mitigation measure	leevendusmeetmed
mixed farming	segapõllumajandus
mixed forest	segamets, segapuistu ; segamets ; segapuistu
mixed use area	maa segakasutusala
mixing	segamine
mobile home	haagiselamu
mode of transportation	vedamisviis; veovahend
model	mudel
modelling	modelleerimine, mudeldamine ; modelleerimine ; mudeldamine
moisture	niiskus
molecular biology	molekulaarbioloogia
mollusc	limus, mollusk ; limus ; mollusk
molybdenum	molübdeen
monetary assessment	rahaline hindamine
monetary economics	monetaarökonoomika
monetary relations	rahalised suhted
money market	rahaturg, laenurahaturg
monitoring	seire
monitoring criterion	seirekriteerium
monitoring data	seireandmed
monitoring equipment	seireseadmed
monitoring network	seirevõrk
monitoring station	seirejaam
monitoring technique	seiretehnika
monopoly	monopol
monument	monument, mälestussammas, ausammas
moon ; moon ; satelite ; satelite	kuu
morphology	morfoloogia, kujuõpetus ; morfoloogia ; kujuõpetus
mortality	suremus
mosaic	mosaiik
moss	sammal
mother-in-law ; mother in law	ämm
motherhood ; maternity	emadus
motor fuel	mootorikütus
motor vehicle	mootorsõiduk
motor vehicle exhaust gas	mootorsõiduki heitgaas
motor vehicle industry	mootorsõidukitööstus
motor vehicle pollution	liiklussaastus
motorcycle ; motorbike	mootorratas
motorway ; pike ; expressway ; freeway ; state highway ; superhighway ; throughway ; thruway	kiirtee
mountain	mägi
mountain climate	mägikliima
mountain forest	mägimets
mountain management	mäestikumajandus
mountain protection	mäestikukaitse
mountain range	mäeahelik
mountain resort	mäestikupuhkeala
mountainous area	mägismaa
mouse	hiir
mowing	niitmine
mud	muda
mud flat	mudarand
mulch	multš
multilateral agreement	mitmepoolne leping
multimedia technology	multimeediumtehnika
multinational firm	hargmaine firma
multispectral scanner	mitmevärviskanner
mumps	mumps
municipal cleansing service	linnapuhastusteenistus
municipal dumping	olmejäätmeprügila
municipal environment plan	kohalik keskkonnakava
municipal environmental policy	kohalik keskkonnapoliitika
municipal law	munitsipaalõigus
municipal level	kohalik tasand
municipal waste	olmejäätmed
municipal water distribution system	olmeveevärk
municipal water management	asula veemajandus
municipality	vald
muscular system	lihaskond
museum	muuseum
mushroom	seen
music	muusika
musical	muusikal
musician	muusik
musquito ; mosquito	sääsk
mussel farming	karbikasvatus
mustelid	kärplane
mutagen	mutageen
mutagenicity	mutageensus
mutagenicity testing	mutageensustest
mutant	mutant
mutated micro-organisms release	mutantsete mikroorganismide vallapäästmine
mutation	mutatsioon
mycete	seened
mycology	seeneteadus, mükoloogia ; seeneteadus ; mükoloogia
mycorrhiza	mükoriisa, seenjuur
mysterious	salapärane
myth	müüt, muistend ; müüt ; muistend
nappy	mähe
national accounting	rahvamajanduse raamatupidamine, makroraamatupidamine
national boundary	riigipiir
national economy	rahvamajandus
national environmental accounting	riigi keskkonnaaarvepidamine
national fishing reserve	riiklik kalavesi
national legislation	riiklikud õigusaktid
national park	rahvuspark
national planning	riiklik planeerimine
nationalisation	riigistamine, natsionaliseerimine
natural area	loodusmaistu
natural areas protection	loodusmaistukaitse
natural disaster	loodusõnnetus
natural environment	looduskeskkond
natural fertiliser	looduslik väetis
natural fibre	looduslik kiud
natural forest	looduslik mets
natural gas	maagaas
natural gas exploration	maagaasiuuring
natural gas extraction	maagaasivõtt, maagaasi ammutamine ; maagaasi ammutamine
natural hazard	loodusoht
natural heritage	looduspärand
natural heritage assessment	looduspärandi hindamine
natural material	looduslik materjal
natural monument	loodusmälestis
natural park	looduspark
natural radioactivity	looduslik radioaktiivsus
natural regeneration	looduslik taastumine
natural resource	loodusvara
natural resource conservation	loodusvarakaitse
natural risk	loodusoht
natural risk analysis	loodusohuanalüüs
natural risks prevention	loodusohutõrje
natural scenery	loodusmaastik
natural science	loodusteadus
natural stone	looduskivi
natural value	looduslik väärtus
nature conservation	looduskaitse
nature conservation legislation	looduskaitseõigus
nature conservation organisation	looduskaitseorganisatsioon
nature conservation programme	looduskaitsekava, looduskaitseprogramm
nature protection	looduskaitse
nature reserve	loodusreservaat
nausea	iiveldus
navigation	laevandus, laevasõit
navigational hazard	laevasõiduoht
necrosis	nekroos
need	vajadus
neighbourhood noise	ümbrusemüra
nematode	ümaruss, nematood ; ümaruss ; nematood
neodymium	neodüüm
neon	neoon
neoplasm ; tumour	kasvaja ; tuumor
neptunium	neptuunium
nervous system	närvisüsteem
nesting	pesitsemine
nesting area	pesitsusala
netting policy (emissions trading) ; netting policy	ettevõtja heiteõiguse tervikkäsitlus (heitekaubanduses)
neurotoxicity	neurotoksilisus
neutralisation	neutraliseerimine, neutralisatsioon; neutraliseerumine
new community	uus ühiskond
new installation	uus seade
new material	uus materjal
new technology	uus tehnoloogia
newsgroup	uudisegrupp
newsletter	infoleht
nickel	nikkel
niobium	nioobium
nitrate	nitraat
nitrification	nitrifikatsioon
nitro compound	nitroühend
nitrogen	lämmastik
nitrogen cycle	lämmastikuringe
nitrogen dioxide	lämmastikdioksiid
nitrogen fixation	lämmastiku seondamine (fikseerimine) ; lämmastiku seondamine
nitrogen monoxide	lämmastik[mono]oksiid ; lämmastikmonooksiid
nitrogen oxide	lämmastikoksiid
nitrogen oxides	lämmastikoksiidid
nitrogenous fertiliser	lämmastikväetis
nitrosamine	nitrosoamiin
nobelium	nobeelium
noise	müra
noise ; noise, vibrations ; racket	müra
noise abatement	müratõrje
noise analysis	müraanalüüs
noise barrier	müratõke, müravarje
noise control	müratõrje
noise disturbance ; noise pollution	mürahäiring
noise emission	müraheide, müraemissioon
noise emission levy	müraheitemaks
noise exposure plan	müraekspositsioonitõrjekava
noise immission	müraimmissioon
noise legislation	müraõigus
noise level	müratase
noise measurement	müra mõõtmine
noise pollutant	mürakoormus
noise pollution	mürahäiring ; mürahäiring, mürasaaste ; mürasaaste
noise protection	mürakaitse
noise reduction	müra vähendamine
noise spectrum	müraspekter
noise-free technology	müravaba tehnoloogia, vaikne tehnoloogia
nomad	nomaad
nomenclature	nomenklatuur, nimestik ; nomenklatuur ; nimestik
non-biodegradable pollutant	bioloogiliselt mittelagundatav reoaine
non-built-up area	täisehitamata ala
non-conventional energy	alternatiivenergia
non-demesnial water	eraõigusliku isiku veekogu, mitteriiklik veekogu
non-durable goods	kulukaubad, tavalised tarbekaubad
non-ferrous metal	mitteraudmetall, värviline metall
non-ferrous metal industry	mitteraudmetallitööstus, värvilise metalli tööstus
non-governmental organisation	valitsusväline organisatsioon
non-ionising radiation	mitteioniseeriv kiirgus
non-metal	mittemetall
non-metallic mineral	mittemetallmineraal
non-polluting energy source	reostusvaba energiaallikas
non-polluting fuel	reostusvaba kütus
non-renewable energy resource	taastumatu energiavaru, mittetaastuv energiavaru
non-renewable resource	taastumatu loodusvara, mittetaastuv loodusvara
non-residential building	mitteeluhoone
non-returnable container	ühekorrapakend
non-target organism	mittesihtorganism
non-volatile substance	mittelenduv aine
norm	norm
notice	teatis
notification	teade, teadaanne
noun ; substantive	nimisõna
nuclear accident	tuumaõnnetus
nuclear debate	tuumavaidlus
nuclear energy	tuumaenergia
nuclear energy legislation	tuumaenergiaõigus
nuclear energy use	tuumaenergia kasutamine
nuclear explosion (accident) ; nuclear explosion	tuumaplahvatus
nuclear facility	tuumaseade
nuclear fission	tuuma lõhustumine, tuumajagunemine ; tuuma lõhustumine ; tuumajagunemine
nuclear fuel	tuumkütus
nuclear fuel element	tuumkütuseelement
nuclear fusion	tuumasüntees, tuumade liitumine ; tuumasüntees ; tuumade liitumine
nuclear hazard	tuumaoht
nuclear physics	tuumafüüsika
nuclear power plant	tuumajõujaam, tuumaelektrijaam ; tuumajõujaam ; tuumaelektrijaam
nuclear reaction	tuumareaktsioon
nuclear reactor	tuumareaktor
nuclear research centre	tuumauurimiskeskus
nuclear risk	tuumarisk
nuclear safety	tuumaohutus
nuclear test	tuumakatse
nuclear weapon	tuumarelv
nucleic acid	nukleiinhape
nursery (plant breeding) ; nursery ; plant nursery	puukool ; taimla ; taimla, puukool
nutrient	toiteelement, taimetoitaine, toitesool
nutrient balance	toiteelemendibilanss, toitesoolabilanss
nutrient content	toiteelemendisisaldus, toitesoolasisaldus
nutrient cycle	toiteelemendiringe, toitesoolaringe
nutrient medium	toitekeskkond
nutrient removal	toiteelemendiärastus, toitesoolaärastus
nutrition	toitumine
nutritive value of food	toidu toiteväärtus
oak	tamm (tamme)
obey	kuuletuma
objection	protest ; vastuväide
obligation to inform	teavituskohustus
obligation to label	märgistuskohustus
observation satellite	vaatlussatelliit
obstacle ; obstruction	takistus
occupational disease	kutsehaigus
occupational health	tööhügieen
occupational health care	töötervishoid
occupational medicine	töömeditsiin
occupational safety	tööohutus
occupational safety regulation	tööohutuseeskirjad
occupational status	ametiseisund
ocean ; sea ; body of water ; bounding main	ookean
ocean circulation	ookeanivee ringlus
ocean current	ookeanihoovus
ocean dumping	merrekaadamine, merreuputamine
ocean exploitation	ookeanikasutus
ocean temperature	ookeanivee temperatuur
ocean-air interface	ookeani ja õhu piirpind
oceanic climate	ookeanikliima
oceanography	okeanograafia
octopus	kaheksajalg
odour	hais
off-peak travelling	tipuväline sõitmine
off-site	paigaväline
offence against the environment	keskkonnakuritegu
office	kontor, büroo ; kontor ; büroo
official duty	ametikohustus, teenistuskohustus, teenistusülesanne ; ametikohustus ; teenistuskohustus ; teenistusülesanne
official hearing	ametlik arutelu
official language	riigikeel
offset policy (emissions trading)	heitekompensatsioonistrateegia (heitekaubanduses)
offshore mining	merealune kaevandamine
oil and fat industry	õli- ja rasvatööstus
oil binding agent	õliabsorbent, naftaabsorbent
oil boom	õlitõkkepoom, naftatõkkepoom
oil disaster	õliõnnetus, naftaõnnetus ; õliõnnetus ; naftaõnnetus
oil exploration	õliuuring, naftauuring
oil extraction	õli ammutamine, nafta ammutamine
oil pipeline	õlijuhe, õlitorustik, naftajuhe, naftatorustik
oil pollution	õlireostus, naftareostus ; õlireostus ; naftareostus
oil pollution abatement	õlireostustõrje, naftareostustõrje
oil production (chain)	naftatootmisahel
oil recovery vessel	õlikogumisalus, naftakogumisalus
oil refinery	naftatöötlustehas, naftadestillerimistehas
oil residue recuperation	õlijääkide taaskasutamine, naftajääkide taaskasutamine
oil slick	õlilaik, naftalaik
oil spill	õliheide, naftaheide
oil tanker	naftatanker ; õlitanker
oil-based energy	naftapõhine energia
old hazardous site	vanareostusobjekt, vanasaasteobjekt
old landfill site	vanaprügila
olfactory pollution	haisuhäiring
olive oil mill wastewater	oliivõlipressimisreovesi
on-line service	võrguteenus
on-site wastewater treatment	reoveepuhastus omal krundil
oncology	onkoloogia
ontogenesis ; ontogenesis ; ontogeny	ontogenees ; ontogenees
ontology	ontoloogia
open lawn	muruväljak
open sea	avameri, ulgumeri ; avameri ; ulgumeri
open sea fishing	avamerekalastus
opencast mining ; open-pit mining	avakaevandamine, pealmaakaevandamine ; pealmaakaevandamine ; avakaevandamine
opera	ooper
operating data	käitusandmed, käiduandmed
operetta	operett
opinion ; stance	arvamus
opinion survey	arvamusuuring
optics	optika
optimism ; optimism ; optimism ; optimism ; optimism ; optimism ; optimism	optimism
or	või
oral sex	oraalseks
orchestra	orkester
orchid	orhidee
order	ettekirjutus ; käsk ; korraldus
order	ettekirjutus, käsk, korraldus ; ettekirjutus ; käsk ; korraldus
ordinance	määrus, dekreet
ore	maak
organ	elund, organ ; elund ; organ
organic carbon	orgaaniline süsinik
organic chemistry	orgaaniline keemia
organic farming	mahepõllumajandus
organic matter	orgaaniline aine
organic nitrogen	orgaaniline lämmastik
organic pollutant	orgaaniline reoaine
organic pollution	orgaaniline reostus
organic solvent	orgaaniline lahusti
organic substance	orgaaniline aine
organic waste	orgaanilised jäätmed
organisation (law)	organisatsioon
organisation of teaching	koolituskorraldus
organisation of the legal system	õigussüsteem
organism	organism
organochlorine compound	kloororgaaniline ühend
organohalogen compound	halogeenorgaaniline ühend
organoleptic property	organoleptiline omadus, meeltajutav omadus
organometallic compound	metallorgaaniline ühend
organonitrogen compound	lämmastikorgaaniline ühend
organooxygen compound	hapnikorgaaniline ühend
organophosphorous compound	fosfororgaaniline ühend
organosulphur compound	väävelorgaaniline ühend
ornithology	ornitoloogia, linnuteadus ; ornitoloogia ; linnuteadus
orography	orograafia
orthopteran	sihktiivaline, ortopter
osmium	osmium
osmosis	osmoos
ostrich	jaanalind
outer space (allocation plan) ; outer space	asulaväline ala
oven	ahi
overburden	pinnakate; katend
overexploitation	ülekasutus, röövkasutus ; ülekasutus ; röövkasutus
overfertilisation	üleväetamine
overfishing	ülepüük
overflow (outlet)	ülevool
overgrazing	ülekarjatamine
overhead power line	õhuliin
overpopulation	ülerahvastus
overturn (limnology)	ümberkihistumine
overwintering	talvitumine
ovine	lambad
ownership	omand
oxidation	oksüdatsioon
oxidation-reduction	redoksreaktsioon
oxide	oksiid
oxidisable material	oksüdeeritav aine
oxidising agent	oksüdeeriv aine, oksüdant
oxygen	hapnik
oxygen content	hapnikusisaldus
oxygenation	hapnikuga rikastamine
oyster farming	austrikasvatus
ozone	osoon
ozone depletion potential	osoonilagundusvõime, võime kahandada (hõrendada) osoonikihti
ozone layer	osoonikiht
ozone layer depletion	osoonikihi kahanemine (hõrenemine), osoonikadu
ozonisation	osoonimine, osoneerimine
pacifist	patsifist
packaging	pakend
packaging waste	pakendijäätmed
packing industry	pakenditööstus
paediatrician	pediaater
paint	värv
paint room	värvimisruum
paint shop	värvimistöökoda, värvikoda
painting business	värvimisettevõtlus
palaeoclimatology	paleoklimatiloogia
palaeoecology	paleoökoloogia
palaeontology	paleontoloogia, kivististeteadus ; paleontoloogia ; kivististeteadus
palladium	pallaadium
paper	paber
paper industry	paberitööstus
parachute	langevari
parameter	parameeter
parasite	parasiit
parasitology	parasitoloogia
parking provision	parkimisvõimalus
parliamentary debate	parlamendidebatt, parlamendivaidlus
parliamentary report	parlamendiaruanne
parrot	papagoi ; papagoiline
part of speech ; lexical category	sõnaliik
partially halogenated chlorofluorohydrocarbon	osaliselt halogeenitud süsivesinik
participation	osalemine, osalus
particle	kübe ; osake
particle separator	kübemepüünis
party ; political party	poliitiline partei
passenger transport	reisijatevedu
paste-like waste	pastataoline jääde
pasture	karjamaa
patent	patent
path	rada
pathogen	tõvestaja, haigustekitaja, patogeen
pathogenic organism	tõvestaja, haigustekitaja
pathologic effect	patoloogiline toime
pathology	haigusõpetus, patoloogia ; haigusõpetus ; patoloogia
patrimonial management	isalik juhtimine
pattern recognition	kujutuvastus
pay policy	töötasupoliitika
peacekeeping	rahuvalve
pear	pirn
peat	turvas
peat extraction	turbatootmine
pedagogy	pedagoogika, kasvatusteadus ; pedagoogika ; kasvatusteadus
pedestrian zone ; pedestrian area ; car-free zone ; auto-free zone ; pedestrianised zone	jalakäiguala, käiguala ; jalakäiguala ; käiguala
pedosphere	pedosfäär
penalty	karistus; trahv ; karistus ; trahv
penalty for environmental damage	trahv keskkonnakahjustuse eest
penguin	pingviin
peninsula	poolsaar
pentachlorophenol	pentaklorofenool
per capita data	andmed inimese (elaniku) kohta
percolating water	nõrgvesi, vajuvesi, gravitatsioonivesi
periodic table	keemiliste elementide perioodilisussüsteem
peripheral park area	kaitseala puhverala
periphyton	peal[is]kasv, perifüüton ; peal(is)kasv, perifüüton
periurban space	äärelinn
permeability	läbilaskvus
permissible exposure limit	suurim lubatav ekspositsioon
permission	luba
peroxyacetylnitrate	peroksüatsetüülnitraat
persistant organic pollutant	orgaaniline püsireoaine (püsisaasteaine)
persistence	püsivus
persistence of pesticides	pestitsiidide püsivus
person	isik
personal responsibility	isiklik vastutus
pest	kahjur[organism] ; kahjur(organism)
pest control	kahjuritõrje
pest infestation	kahjurirünne
pesticide	pestitsiid
pesticide control standard	pestitsiiditõrjenorm
pet	lemmikloom
petition	petitsioon
petition right	taotlusõigus
petrochemical	naftakeemiasaadus
petrochemical industry	naftakeemiatööstus
petrol	bensiin
petroleum	nafta, toornafta ; nafta ; toornafta
petroleum consumption	nafta tarbimus
petroleum industry	naftatööstus
phanerogam ; spermatophyte	fanerofüüt, kõrgtaim
pharmaceutical industry	farmaatsiatööstus ; ravimitööstus
pharmaceutical waste	ravimijäätmed
pharmacokinetics	farmakokineetika
pharmacology	ravimiteadus, farmakoloogia ; ravimiteadus ; farmakoloogia
pheasant	faasan
phenol	fenool
pheromone	feromoon
philology	filoloogia
philosophy	filosoofia
phone ; telephone	telefon
phonetics	foneetika
phosphate	fosfaat
phosphate removal	fosfaadiärastus
phosphate substitute	fosfaadiasendi
phosphatic fertiliser	fosfaatväetis
phosphorus	fosfor
photo ; photograph	foto
photochemical agent	fotokeemiline aine
photochemical oxidant	fotokeemiline oksüdant, fotooksüdant
photochemical pollution	fotokeemiline reostus (saastus) ; fotokeemiline reostus
photochemical product	fotokeemiline saadus
photochemical reaction	fotokeemiline reaktsioon
photochemical smog	fotokeemiline sudu
photodegradation	fotolüüs, fotokeemiline lagunemine
photogrammetry	fotogramm[-m]eetria ; fotogramm(-m)eetria
photography	fotograafia
photon	footon
photosynthesis	fotosüntees
physical alteration	füüsiline muutumine
physical chemistry	füüsikaline keemia
physical conditions	füüsikalised tingimused
physical geography	loodusgeograafia
physical measurement of pollution	reostuse füüsikaline mõõtmine
physical planning	füüsiline planeerimine
physical pollutant	füüsikaline reostaja
physical pollution	füüsikaline reostus
physical process	füüsikaline protsess
physical property	füüsikaline omadus
physical science	loodusteadus
physical treatment	füüsikaline käitlus
physicochemical analysis	füüsikalis-keemiline analüüs
physicochemical process	füüsikalis-keemiline protsess
physicochemical purification	füüsikalis-keemiline puhastus
physicochemical treatment	füüsikalis-keemiline käitlus
physics	füüsika
physiology	füsioloogia
phytomass	taimne biomass, fütomass
phytopathology	fütopatoloogia
phytoplankton	taimhõljum, fütoplankton ; taimhõljum ; fütoplankton
phytosanitary treatment	taimestikpuhastus
phytosociology	fütosotsioloogia
phytotoxicity	fütotoksilisus
pickling plant	söövitusseade
pigeon ; dove	tuvi
piggery	sigala
pike ; spear	oda
pilot plant	katseseade
pilot project	katseprojekt
pilotage	lootsimine
pinniped	loivaline
pino ; pine	mänd
pipe	toru
pipeline	torustik
pity ; compassion	kaastunne
pixel	piksel
place ; location	koht
plain	tasandik
plan	plaan
plane source	pindreostusallikas
plankton	plankton
planning	projekteerimine
planning law	planeerimisõigus
planning measure	planeerimismeede
planning permission	planeerimisluba
plant	taim
plant biology	taimebioloogia
plant breeding	taimearetus
plant community	taimekooslus, fütotsönoos
plant component	taimeosa
plant disease	taimehaigus
plant ecology	taimeökoloogia
plant equipment	tehasesisseseade
plant heritage	pärandtaimestik
plant physiology	taimefüsioloogia
plant population	taimeasurkond, taimepopulatsioon
plant production	taimesaaduste toodang
plant protection	taimekaitse
plant protection product	taimekaitsevahend
plant reproduction	taimepaljundus
plant resource	taimsed loodusvarad
plant selection	taimearetus
plant species	taimeliik
plant species reintroduction	taimeliikide reintroduktsioon
plant textile fibre	taimne riidekiud
plant trade	taimekaubandus
planting	istutamine
plasma technology	plasmatehnika
plastic	plast
plastic waste	plastijäätmed
platinum	plaatina
pleasure cruising	ristlus
plutonium ; plutonium ; plutonium	plutoonium ; plutoonium ; plutoonium
point	punkt
point source	punkt[reostus]allikas, punktsaasteallikas ; punkt(reostus)allikas, punktsaasteallikas
poison	mürk
poisoning	mürgitamine
polar region	polaarpiirkond
polder	polder
police	politsei
police law	politseiseadus
police power	politseivõim
policy	poliitika ; poliitika, strateegia ; strateegia
policy guideline	poliitikasuunis
policy instrument	poliitiline vahend
policy integration	poliitika ühtlustamine
policy planning	strateegia kavandamine
political counselling	poliitiline nõuanne
political doctrine	poliitiline doktriin
political ecology	poliitiline ökoloogia
political geography	poliitiline geograafia
political ideology	poliitiline ideoloogia
political organisation	poliitiline organisatsioon
political power	poliitiline võim
politics	poliitika
pollen	õietolm
pollutant	reoaine, saasteaine
pollutant absorption	reoaine (saasteaine) absorbeerimine
pollutant accumulation	reoaine (saasteaine) akumuleerumine ; reoaine saasteaine akumuleerumine ; reoaine akumuleerumine
pollutant analysis	reoaine (saasteaine) määramine
pollutant assessment	reoaine (saasteaine) hindamine
pollutant concentration	reoaine (saasteaine) kontsentratsioon
pollutant degradation	reoaine (saasteaine) lagunemine
pollutant deposition	reoaine (saasteaine) sadenemine
pollutant dispersion	reoaine (saasteaine) hajumine
pollutant distribution	reoaine (saasteaine) jagunemine (jaotus)
pollutant elimination	reoaine (saasteaine) kõrvaldamine
pollutant emission	reoaine (saasteaine) heide (emissioon)
pollutant evolution	reoaine (saasteaine) toime suurenemine
pollutant exposure	ekspositsioon reoainele (saasteainele)
pollutant flow	reoainevoog, saasteainevoog
pollutant formation	reoaine (saasteaine) kujunemine
pollutant immission	reoaine (saasteaine) immissioon
pollutant immobilisation	reoaine (saaasteaine) immobiliseerimine
pollutant migration	reoaine (saasteaine) levimine
pollutant monitoring	reoaineseire, saasteaineseire
pollutant pathway	reoaine (saasteaine) levimisteekond
pollutant reduction	reoainesisalduse (saasteainesisalduse) vähendamine
pollutant remobilisation	reoaine (saasteaine) taasliikumapanek
polluted matter	reoaine, saasteaine
polluted site	reostatud (saastatud) paik
polluter-pays principle	reostaja-maksab-põhimõte, põhjustajapõhimõte
pollution	reostamine, reostus, saastamine, saastus ; reostus (saastus) ; reostamine ; reostus ; saastamine ; saastus
pollution abatement	reostustõrje, saastetõrje
pollution abatement equipment	reostustõrjevarustus, saastetõrjevarustus
pollution abatement waste	reostustõrjejäätmed, saastetõrjejäätmed ; reostustõrjejäätmed ; saastetõrjejäätmed
pollution control	reostusohje, saasteohje
pollution control equipment	reostustõrjevarustus, saastetõrjevarustus
pollution control investment	reostustõrjeinvesteering, saastetõrjeinvesteering
pollution control measure	reostustõrjemeede, saastetõrjemeede
pollution control technology	reostustõrjetehnika, saastetõrjetehnika
pollution cost	reostuse maksumus, saastemaksumus
pollution effect	reostustoime, saastetoime
pollution indicator	reostusindikaator, saasteindikaator
pollution insurance	reostuskindlustus, saastekindlustus
pollution liability	reostusvastutus, saastevastutus
pollution load	reostuskoormus, saastekoormus
pollution measurement	reostuse (saastuse) mõõtmine
pollution monitoring	reostusseire, saasteseire
pollution norm	reostusnorm, saastenorm
pollution prevention	reostamise vältimine, saastamise vältimine
pollution risk	reostusoht, saasteoht
pollution type	reostuse (saastuse) liik
polonium	poloonium
polybrominated biphenyl	polübroomitud difenüül
polychlordibenzo-p-dioxin	polüklorodibenso-p-dioksiin
polychlorinated biphenyl	polüklooritud difenüül
polychlorinated dibenzofuran	polüklooritud dibensofuraan
polychlorinated terphenyl	polüklooritud terfenüül
polycyclic aromatic hydrocarbon	polütsükliline aromaatne süsivesinik
polycyclic hydrocarbon	polütsükliline süsivesinik
polyethylene terephtalate	polüetüleenterftalaat
polygon	hulknurk, polügoon
polymer	polümeer
polymerisation	polümerisatsioon
polyvinyl chloride	polüvinüülkloriid
pond	tiik
pool ; puddle ; puddle	loik, lomp
population	asurkond ; populatsioon
population density	asustustihedus
population dynamics	populatsioonidünaamika
population ecology	populatsiooniökoloogia
population growth	rahvastikuiive, rahvastiku juurdekasv
population movement	rahvastikuränne
population structure	rahvastiku struktuur
population trend	rahvastiku arengutrend
poriferan	käsn
posidonia ; neptunegrass	posidoonia
possession	omandus ; valdamine
post-treatment	järelkäitlus, järelpuhastus
potash	potas, kaaliumkarbonaat
potassium	kaalium
potassium fertiliser	kaaliumväetis
potato ; patato	kartul
poultry	kodulinnud, sulgloomad
poultry farming	linnukasvatus
poverty	vaesus
power (physics) ; power	võimsus
power company	energiafirma
power station	jõujaam, elektrijaam
power station derating	jõujaama sulgemine
power-heat relation	töö ja soojuse suhtarv
praseodymium	praseodüüm
pre-emption	ostueesõigus
pre-emption zone	ostueesõiguspiirkond
precautionary principle	ettevaatuspõhimõte
precipitation ; precipitation (chemical)	sadestamine ; sadestamine; sadestumine ; sadestumine
precipitation enhancement	sademete rohkendamine
precision engineering	peenmehaanika
predator	kiskja ; kiskja, röövloom ; röövloom
prefabricated building	monteeritav ehitis
pregnancy	rasedus
preliminary proceedings	eelmenetlus
premium	preemia
preparation for market	müügiks ettevalmistamine
prescription	igamine
preservation of evidence	tõendusmaterjali säilitamine
preservative	säilitusaine
preserve	hoidis, säilis, konserv
press	ajakirjandus, press ; ajakirjandus ; press
pressing	pressimine
pressure	rõhk
pressure equipment	surveseadmed, rõhuseadmed
pressure group	huvirühm
prevention measure	vältimisabinõu, ennetusabinõu
prevention of forest fires	metsapõlengute vältimine
preventive health measure	tervisekaitsemeede
preventive information	preventiivinformatsioon
price	hind
prices policy	hinnapoliitika
pricing policy of resources	loodusvarade hinnapoliitika
primary education	algharidus
primary energy consumption	primaarenergiakasutus
primary forest	ürgmets
primary sector	toormesektor
primary treatment	reovee eelselitus
primate	esikloom, primaat ; primaat ; esikloom
prime number ; prime	algarv
principle of sustainability	säästvuspõhimõte, jätkusuutlikkuspõhimõte
printing work	trükkimistöö
private car	eraauto
private domain	eramaa
private forest	eramets
private household	eramajapidamine
private international law	rahvusvaheline eraõigus
private law	eraõigus
private sector	erasektor
private transport	eraveod
privatisation	erastamine
proboscidean	londiline
procaryote	prokarüoot, eeltuumne
procedural law	protsessiõigus
process analysis	protsessianalüüs
process technology	töötlemistehnoloogia
process water	tehnoloogiavesi, tootmisvesi
processed agricultural produce	töödeldud põllumajandussaadus
processed foodstuff	töödeldud toiduaine
processing	töötlemine, töötlus
producer liability	tootja vastutus
product	saadus, produkt
product advertising	toote reklaamimine
product comparison	tootevõrdlus
product evaluation	toote hindamine
product identification	toote markeering
product information	tooteteave, info toodete kohta
product liability	vastutus toote eest, tootevastutus
product life cycle	toote olelustsükkel
product standard	tootestandard
production policy	tootmispoliitika
productivity	tootlikkus, tootlus; jõudlus; tööviljakus
productivity trend	tootlustrend
profit	kasum
prognostic data	prognoosandmed
programme	programm, tegevuskava ; programm ; tegevuskava
progress line	ajakõver
prohibition	keeld
project	projekt
promethium	promeetium
promotion of trade and industry	kaubanduse ja tööstuse edendamine (soodustamine)
propagation process	levi[mine] ; levi(mine)
propellant	propellent, pakendigaas
properties of materials	materjalide omadused
property protection	omandikaitse
propulsion technique	ajamitehnika
prosecution	kohtulikule vastutusele võtmine; jälitus[tegevus] ; kohtulikule vastutusele võtmine ; jälitus
prosperity	õitseng, heaolu ; õitseng ; heaolu
prostitution	prostitutsioon
protactinium	protaktiinium
protected area	kaitseala
protected landscape	looduspark ; maastikukaitseala, looduspark ; maastikukaitseala
protected marine zone	merekaitseala
protected species	kaitsealune liik
protection from neighbours	kaitse naabrite eest
protection of animals	loomakaitse
protection of birds	linnukaitse
protection of species	liigikaitse
protection system	kaitsesüsteem
protective measure	kaitsemeede, kaitseabinõu
protein ; poly peptide	proteiin ; valk
protein product	valgusaadus
protocol	protokoll
protozoan	ainurakne, algloom ; ainurakne ; algloom
province	maakond
provincial/regional authority (D) ; regional authority ; provincial authority	piirkonnaametkond
provincial/regional law (D) ; regional legislation	piirkondlik õigus
pruning	pügamine, kärpimine (puude, põõsaste); laasimine
psychiatrist	psühhiaater
psychic effect	psüühiline mõju
psychological effect	psühholoogiline mõju
psychological stress	psühholoogiline stress
psychology	psühholoogia
psychosomatic effect	psühhosomaatiline mõju
psychosomatic illness	psühhosomaatiline haigus
public	üldsus
public access to land	iga-ühe-õigus
public action	avalik üritus
public aid	riigi abi
public attendance	üldsuse osavõtt
public awareness campaign	üldsuse teadlikkus
public bath	avalik ujula
public benefit inquiry	arupärimine üldkasulikkuse kohta
public building	ühiskondlik hoone, üldkasutatav hoone
public contract	riiklik leping
public debt	riigivõlg
public discussion	avalik arutelu
public domain	avalik omand, ühisomand
public expenditure	riiklikud kulutused
public finance	riigi rahandus
public financing	riiklik finantseerimine
public function	riigi funktsioon
public health	tervishoid
public hearing	avalik arutelu
public information	üldsuse informeerimine (teavitamine) ; üldsuse informeerimine
public inquiry	avalik arupärimine
public institution	ametiasutus
public institution of administrative nature	riiklik juhtimisasutus
public institution of industrial and commercial nature	riiklik tööstus- ja kaubandusasutus
public international law	rahvusvaheline avalik õigus
public law	avalik õigus
public maritime domain	riigile kuuluv mereala
public opinion	avalik arvamus
public opinion polling	avaliku arvamuse uuring
public park	avalik park
public participation	üldsuse osalemine, üldsuse kaasamine
public procurement	riigihange
public prosecutor's office	prokuratuur
public relations	avalikud suhted
public sector	riiklik sektor, avalik sektor ; riiklik sektor ; avalik sektor
public transport	ühistransport ; ühisveondus
public transport vehicle	ühissõiduk
public utility	munitsipaalettevõte, kommunaalettevõte
public waterways domain	riigile kuuluvad siseveekogud
public works	riigiehitused
public-private partnership	riigi- ja erapartnerettevõte
pulmonary disease	kopsuhaigus
pump	pump
pumping	pumpamine
purification	puhastamine, puhastus
purification facility	puhastusseade
purification plant	puhastusseade
purification through the soil	pinnaspuhastus
purifying power	puhastusvõime
purin	puriin
pyralene	püraleen
pyrolysis	pürolüüs
quality assurance	kvaliteedi tagamine; kvaliteedigarantii
quality certification	kvaliteedisertifitseerimine
quality control	kvaliteediohje, kvaliteedikontroll
quality objective	kvaliteedieesmärk
quality of life	elukvaliteet
quality standard	kvaliteedistandard
quarry	kivimurd, karjäär
quarrying	kivi murdmine
quartering	tükeldamine
rabbit	küülik
race relations	rassidevahelised suhted
racking	nõrutamine
radar	radar
radiation ; radiations	kiirgus ; kiirgused
radiation damage	kiirguskahjustus
radiation dose	kiirgusannus, kiirgusdoos ; kiirgusannus ; kiirgusdoos
radiation effect	kiirgusmõju
radiation exposure	kiiritus
radiation physics	kiirgusfüüsika, radiatsioonifüüsika ; kiirgusfüüsika ; radiatsioonifüüsika
radiation protection	kiirguskaitse
radiation protection law	kiirguskaitseseadus
radiation sickness	kiirgustõbi
radio	raadio
radio programme	raadiosaade
radioactive contamination	radioaktiivne saastumine
radioactive decontamination	radioaktiivse saaste ärastus (kõrvaldamine)
radioactive dumping	radioaktiivsete jäätmete panila
radioactive emission	radioaktiivne emissioon
radioactive fallout	radioaktiivne sade
radioactive pollutant	radioaktiivne saasteaine
radioactive substance	radioaktiivne aine
radioactive tracer	radiomärgend
radioactive waste ; nuclear waste	radioaktiivsed jäätmed
radioactivity ; radioactive decay	radioaktiivsus
radioelement	radioaktiivne element ; radioelement
radionuclide	radionukliid, radioisotoop, radioaktiivne isotoop ; radionukliid ; radioisotoop ; radioaktiivne isotoop
radium	raadium
radon	radoon
rag	kalts[ud ; kaltsud ; kalts
rail traffic	raudteeliiklus
rail transport	raudteevedu
railroad vehicle ; carriage ; wagon	raudteesõiduk
railway	raudtee
railway network	raudteevõrk
railway station	raudteejaam
rain	vihm
rain forest	vihmamets
rain water	vihmavesi
rain water sewer system	sademekanalisatsioon
rainout	pilvesisene õhuvõõriseuhe
raising a site	maapinna tõstmine
random test	üksikproov
rape	raps
rapid test	kiirproov
rapid transit train	kiirrong
rare species	haruldane liik
raster	raster
raster to vector	rasterdamine
rate	kiirus ; kiirus, muutumiskiirus ; muutumiskiirus
raw material	toormaterjal, toore, tooraine ; toormaterjal ; toore ; tooraine
raw material consumption	toormekulu
raw material securing	toorme tagamine
raw water	toorvesi
reaction kinetics	reaktsioonikineetika
reactor	reaktor
reactor safety	reaktori ohutus
reasonableness	arukus ; mõistlikkus
recipe	retsept
reclamation industry	taaskasutustööstus
recombinant DNA technology	DNA rekombinatsioon, DNA-süntees
recommendation	soovitus
recorder	plokkflööt
recording of substances	ainete registreerimine
recovery of landscape	maastiku taastamine
recovery plan	taastamiskava
recreation	virgestus, rekreatsioon ; virgestus ; rekreatsioon
recreational area	virgestusala, puhkeala
recyclability	ringluskõlblikkus, taaskasutatavus
recyclable plastic	kasutuskõlblikud plastijäätmed
recycled material	teisene materjal, teisesmaterjal
recycled paper	teisene paber, teisespaber
recycling	ringlussevõtt (jäätmete), jäätmete ringlussevõtt
recycling management and waste law	jäätmekäitlusseadus
recycling potential	riglussevõtukõlblikkus
recycling ratio	ringlussevõtusuhe
red tide	punased looded
redress	heastamine
reed	pilliroog
reef	kari (kari)
reference service	raamatukogu teabeteenindus, raamatukogu infoteenindus
referral information	allikaosundus
referral information system	allikaosundamisteenistus
refinery	rafineerimisettevõte
refining	rafineerimine
reflection	peegeldus, peegeldumine; peegeldamine
reflectometry	reflektomeetria
reforestation	metsauuendus, metsa uuendamine, taasmetsastamine
refrigerant	jahutusaine, külmutusagens
refrigeration	jahutamine, külmutamine
refrigeration industry	jahutustööstus, külmutustööstus
refrigerator	külmik; külmutusseade ; külmik ; külmutusseade
refuge	pagula, refuugium ; pagula ; refuugium
refugee	pagulane
refuse collection vehicle	prügiveok
refuse derived fuel	jäätmekütus, prügikütus
refuse shredder	jäätmepurusti, prügipurusti
refuse-sludge compost	jäätme- ja [reovee]settekompost ; jäätme- ja (reovee)settekompost
regeneration	regenereerimine
region	piirkond, regioon ; piirkond ; regioon
regional authority	piirkondlik ametiasutus
regional convention	piirkondlik konvent
regional development	piirkonna areng
regional law	piirkondlik õigus
regional natural park	piirkondlik looduspark
regional plan	piirkondlik tegevuskava
regional planning	piirkondlik planeerimine
regional regulation	piirkondlik määrus
regional statistics	piirkonnastatistika
regional structure	piirkonna struktuur
registered site	katastrisse kantud maa
registration	registreerimine
registration obligation	registreerimiskohustus
registration proceeding	registreerimiskorraldus
regulation	määrus ; reguleerimine; määrus; eeskiri ; reguleerimine ; eeskiri
regulation of agricultural production	põllumajandusse puutuvad määrused
regulation on maximum permissible limits	määrus piirväärtuste kohta
regulative law	reguleeriv seadus
rehousing	ümberasustamine
reindeer	põhjapõder
reintroduction	reintroduktsioon
relational database	relatsioon[andme]baas ; relatsioon(andme)baas
release of organisms	organismide vabadusselaskmine
relief (land)	pinnamood, reljeef
religion	usund, usk, religioon ; religioon ; usk ; usund
remote sensing	kaugseire
remote sensing centre	kaugseirekeskus
removal	ärastus, kõrvaldus, kõrvaldamine ; eliminazio ; ärastus ; kõrvaldus ; kõrvaldamine
renaissance	renessanss
renaturation	keskkonnataastus, keskkonnaennistus
renewable energy source	taastuva (uueneva) energia allikas
renewable raw material	taastuv (uuenev) toore
renewable resource	taastuv (uuenev) loodusvara
repair business	remontimine
replacement	asendamine
replacement cost	asenduskulu
report on the state of the environment	keskkonnaaruanne
report to the minister	aruanne ministrile
reporting process	aruandlus
representation	esindamine
repression	repressioon
reprocessing	ümbertöötlemine
reproduction	paljunemine, sigimine
reproductive manipulation	DNA reproduktiivne käitlemine
reptile ; reptile ; reptile	roomaja, reptiil ; roomaja, reptiil ; roomaja, reptiil
rescue service	päästeteenistus
rescue system	päästesüsteem
research	uurimistöö ; uurimus ; uuring
research centre	uurimiskeskus
research of the effects	mõju-uuring
research policy	uurimispoliitika
research project	uurimisprojekt
reserve	reservaat
reservoir	veehoidla
residential area	elurajoon, asustusala ; elurajoon ; asustusala
residential area with traffic calmings	kiirustõketega elurajoon
residential building	elamu
residual amount of water	veejääk
residual pesticide	pestitsiidijääk
residual risk	jääkrisk
residual waste	prügi
residual waste sludge	jääkmuda
residue analysis	jääksisalduse määramine
residue of grinding	jahvatusjääk
residue recycling	jääkide ringlussevõtt
resin	vaik
resinous plant	vaigutaim
resistance (biological) ; resistance	resistentsus, vastupanuvõime
resolution	otsus
resolution ; resolution (parameter)	eraldusvõime
resorption	resorptsioon, imendumine
resource ; resources	loodusvara, ressurss ; loodusvarad
resource appraisal	ressursside hindamine
resource conservation	ressursihoid
resource exploitation	ressursikasutus
resource reserve	ressursivaru
resource utilisation	ressursikasutus
resources management	ressursimajandus
respiration	hingamine ; respiratsioon
respiratory air	hingamisõhk
respiratory disease	hingamisteede haigus
respiratory system	hingamissüsteem, respiratoorsüsteem
retaining reservoir	veehoidla
reverse osmosis	pöördosmoos
rhenium	reenium
rhodium	roodium
rice	riis
rising sea level	meretaseme tõus
risk communication	ohust teavitamine
river	jõgi
river bed	jõesäng
river water	jõevesi
road	maantee ; tee
road network	teedevõrk
road salt	teesool
rock	kivim
rodent	näriline
roentgenium	röntgeenium
rolling noise	veeremüra
roof ; roof ; roof	katus ; katus ; katus
root	juur
rotary furnace	pöördahi
route	marsruut
rubber	kautšuk
rubidium	rubiidium
ruby	rubiin
rural area	maakoht, maapiirkond
ruthenium	ruteenium
rutherfordium	rutherfordium
safety ; security	ohutus, julgeolek, turvalisus ; ohutus ; julgeolek ; turvalisus
safety measure	ohutusmeede, ohutusabinõu ; ohutusmeede ; ohutusabinõu
sahara	sahara
salamander	salamander
salmon	lõhe
salt	sool
salt water	soolane vesi
samarium	samaarium
sand	liiv
sand dune	liivaluide
sanitary fitting	sanitaarseade
sapphire	safiir
satellite	satelliit, tehiskaaslane ; tehiskaaslane ; satelliit
sawdust	saepuru
scandium	skandium
school	kool
science	teadus
scientific co-operation	teaduskoostöö
scientific dispute	teadusvaidlus
scientific research	teaduslik uurimistöö
scientist	teadlane
screwdriver	kruvikeeraja
sculptor	skulptor
sea	meri ; meri
sea level	meretase
sea water	merevesi
seaborgium	seaborgium
seashore	mererand
season	aastaaeg ; hooaeg ; sesoon
secondary education	keskharidus
sediment	uhtained
sedimentation (geology) ; sedimentation	settimine, sedimentatsioon ; settimine ; sedimentatsioon
sedimentology	sedimentoloogia
seed	seeme
seed	külvis ; seemnevili
seismic activity	seismoaktiivsus, seismiline aktiivsus
seismic sea wave ; tsunami	tsunami
selenium	seleen
semi-metal	poolmetall
semiconductor	pooljuht
semiotics ; semiology	semiootika
separator	eraldi, separaator
sewage farm	reoveeniisutusala
sheep	lammas
shellfish ; shellfish	koorikloom
ship	laev, alus
shop	kauplus, pood
shopping centre	kaubanduskeskus
shrub	võsa
side effect	kõrvalmõju
siemens	siimens
sign language	viipekeel
silicon	räni
silt	tolm ; tolm ; möll ; aleuriit
silver	hõbe
simulation	matkemodelleerimine
ski run	suusarada
skiing	suusatamine
skin	nahk
slag	räbu
slaughter	tapma
slaughter-house	tapamaja
slaughterhouse ; slaughter-house ; abattoir ; butchery ; shambles	tapamaja
sleep	magamine ; uni
sleep disturbance	une häirimine
slipper	toatuhvel
slope	nõlv
sludge	muda
smile	naeratus
smog	sudu
smog warning	suduhoiatus
smoke	suits
smoking	suitsetamine
snake	madu
snow	lumi
snowslide	lumelaviin, laviin
soaking	leotamine; vettimine ; leotamine ; vettimine
soap	seep
social behaviour	sotsiaalne käitumine
social group	sotsiaalne grupp
social protection	sotsiaalne kaitse
social psychology	sotsiaalpsühholoogia
social science	sotsiaalteadus
social survey	sotsiaaluuring
social welfare	sotsiaalhoolekanne
society	ühiskond
socioeconomic aspect of human settlements	asulate sotsiaalmajanduslik aspekt
sociolinguistics ; sociology of language	sotsiolingvistika
sociology	sotsioloogia
sodium	naatrium
software	tarkvara
software development	tarkvaraarendus
soil	muld
soil fertilisation	väetamine
soil fertility	mullaviljakus
soil science	mullateadus, pedoloogia ; mullateadus
solar cell	päikeseelement, heliorakk
solar collector	päikesepatarei
solar energy	päikeseenergia
solar energy technology	päikeseenergia kasutamine
solar power station	päikeseelektrijaam
solar radiation	päikesekiirgus
solubility	lahustuvus
solvent	lahusti
songbird	laululind
soot	tahm
sorption	aine neeldumine, sorptsioon ; aine neeldumine ; sorptsioon
sound	heli
sound measurement	heli mõõtmine
space ; space ; space (interplanetary) ; interplanetary space	kosmos ; kosmos, maailmaruum ; maailmaruum
space travel	kosmoselend
spasmodic croup	spastiline krupp
species	liik
speech	kõne
speed	kiirus
sphinx	sphinx
spider	ämblik
sport	sport
spring	kevad
spring ; spring (hydrology, land)	allikas, läte ; allikas ; läte
spring water	allikavesi
square	väljak
standard	norm ; norm; standard ; standard
staple food	põhitoit
star	täht
starch	tärklis
station	jaam
statistics	statistika
steam generator	aurukatel, aurugeneraator ; aurukatel ; aurugeneraator
steel	teras
sterilisation	sterilisatsioon ; steriliseerimine
sterilisation	steriliseerimine
steroid	steroid
stocking	varu täiendamine
stone	kivi
stork	toonekurg
storm ; tempest	torm, raju ; torm ; raju
stove	ahi ; ahi; pliit ; pliit
strange ; odd	imelik
strawberry	maasikas
stress	stress
strontium	strontsium
subject ; topic	teema
submarine	allveelaev
subsidence	maapinna vajumine ; vajumine
subsidy	toetus, toetusraha ; toetusraha ; toetus
suburb	äärelinn
sudden ; abrupt ; precipitous	äkiline
sugar	suhkur
sulphur	väävel
sulphur concentration	väävlisisaldus
sulphur dioxide	vääveldioksiid
supermarket	kaubahall
supply	pakkumine
supply and demand	pakkumine ja nõudmine
surface tension	pindpinevus
swans, geese and ducks	hanelised
sweetener	magusaine
sword	mõõk
symbiosis	sümbioos, kooselu
synagogue	sünagoog
syndrome	sündroom
synecology	sünökoloogia
tailor	rätsep
takeover	ülevõtmine
tanker	paakauto ; tsisternauto
tanker ; tanker (ship)	tanker, tanklaev ; tanker ; tanklaev
tannin	tanniin
tantalum	tantaal
target group	sihtrühm
tax	maks
taxonomy	taksonoomia
tea	tee
teaching	õpe, õpetamine; õpetus
technetium	tehneetsium
technology	tehnoloogia
technology transfer	tehnoloogiasiire
telecommunications ; telecommunication	side, telekommunikatsioon
telemetry	kaugmõõtmine, telemeetria ; kaugmõõtmine ; telemeetria
television	televisioon
television programme	teleprogramm
tellurium	telluur
temperature	temperatuur
teratogen	teratogeen
terbium	terbium
terminology	terminoloogia
termite	termiit
terracotta ; terracotta ; terracotta ; terra cotta	terrakota
territory	maaala, territoorium ; maaala ; territoorium
tertiary sector	kolmas sektor
test	katse ; proov ; test
textile industry	tekstiilitööstus
textile plant	kiudtaim
thallium	tallium
theocracy	teokraatia
theology	teoloogia
therapy	ravi, ravimine, teraapia ; ravi ; ravimine ; teraapia
thermal equipment	soojussisseseade
thermal power plant	soojusjõujaam, soojuselektrijaam
thermodynamics	termodünaamika
thesis	väitekiri
thirst	janu
thorium	toorium
thulium	tuulium
thunder	kõu
thunderstorm	äike
tidal power station	loodetejõujaam
tidal water	tõusuvesi
timber forest	kõrgmets, raieküps mets
time	aeg
timezone	ajavöönd
tin	tina
tissue	kude
titanium	titaan
titanium dioxide	titaandioksiid
toad	kärnkonn
tobacco	tubakas
tornado	tornaado
tortoise	kilpkonn
tourism	turism
toxic metal	mürgine (toksiline) metall
toxic substance	mürgine (toksiline) aine
toxicity	mürgisus, toksilisus ; mürgisus ; toksilisus
toxicology	toksikoloogia, mürgiõpetus ; mürgiõpetus ; toksikoloogia
toxin	toksiin
trace element	mikroelement, jälgelement
tracheophyte ; vascular plant	soontaim
trade	elukutse ; kauplemine
trade	kaubandus
trade and consumption	kauplemine ja tarbimine
trades union	ametiühing
traffic	liiklus
traffic noise	liiklusmüra
train	rong
training	koolitus, väljaõpe
training centre	koolituskeskus, väljaõppekeskus
trajectory	trajektoor, liikumistee
transition element ; transition metal	siirdeelement
translate ; interpret	tõlkima
transpiration	transpiratsioon, taimaurumine
transport	ülekandumine ; ülekanne ; veondus
transport ; transportation	vedu, transport ; vedu ; transport
travel	reisimine
treaty	konventsioon ; rahvusvaheline kokkulepe
tree	puu
triangle	kolmnurk
tritium	triitium, üliraske vesinik ; triitium ; üliraske vesinik
trophic level	troofiline tase
tropical forest	troopikamets
tropical plant	troopikataim
tropical rain forest	troopiline vihmamets
tropics ; torrid zone	troopika, palavvööde ; troopika ; palavvööde
tundra	tundra
tungsten	volfram
tunnel	tunnel
turbidity	hägusus, sogasus (vee)
turbine	turbiin
turkey	kalkun
twin	kaksik
typhoon	taifuun
tyre	rehv
ultraviolet radiation	ultraviolettkiirgus
underground railway	allmaaraudtee, metroo ; allmaaraudtee ; metroo
underground train	allmaarong, metroorong ; allmaarong ; metroorong
unemployment	töötus, tööpuudus ; töötus ; tööpuudus
ungulate	kabjaline, sõraline, ungulaat
university ; university ; academy	ülikool ; ülikool
ununbium	ununbium
ununhexium	ununheksium
ununoctium	ununoktium
ununpentium	ununpentium
ununquadium	ununkvaadium
ununseptium	ununseptium
ununtrium	ununtrium
upbringing	kasvatus
uranium	uraan
urbanisation	linnastumine, urbaniseerumine ; linnastumine ; urbaniseerumine
ursid	karulane
usurp	usurpeerima ; ; usurpeerima
vacuum cleaner	tolmuimeja
valley	org
valuable	väärtuslik
vanadium	vanaadium
vandalism	vandalism
vapour pressure	aururõhk
vector	vektor
vegetable	köögivili
vegetable oil	taimeõli
vehicle	sõiduk
ventilation	ventilatsioon, tuulutus, õhuvahetus ; ventilatsioon ; tuulutus ; õhuvahetus
verb	tegusõna ; verb
vertebrate	selgroogne, vertebraat ; selgroogne ; vertebraat
veteran	sõjaveteran
veterinarian	loomaarst
veterinarian ; veterinary	loomaarst
village	küla
vinasse	käärimispära
virology	viroloogia
virus	viirus
viscosity	viskoossus
vitamin	vitamiin
vocabulary	sõnastik
volatile substance	lenduv aine
volatility	lenduvus
volcanic eruption	vulkaanipurse
volcanism	vulkanism
volcano	vulkaan, tulemägi ; tulemägi ; vulkaan
volleyball	võrkpall
voltage	pinge
voting	hääletamine
vulcanisation	vulkaniseerimine
wall	sein
walrus	merihobu
war	sõda
warm-blooded animal	püsisoojane [loom], soojavereline [loom] ; püsisoojane (loom), soojavereline (loom)
wasp	herilane
waste	jäätmed (ääde)
waste bin	prügikast
waste disposal act	jäätmeseadus
waste dump	ulaprügila
waste paper	vanapaber, paberijäätmed
waste water	reovesi
waste water purification	reoveepuhastus, reoveekäitlus
water	vesi
water ; body of water	veekogu
water aeration	vee õhustamine
water cost	vee hind
water desalination	vee magestamine
water flea	vesikirp
water level	veetase, veeseis
water mill	vesiveski
water polo	veepall
water protection legislation	veekaitseõigus
water pump	veepump
water reservoir	veemahuti, veepaak
water resource	veevaru
water salination	vee sooldumine
water supply	veevarustus
water treatment	veekäitlus, veetöötlus, veepuhastus
water well	veekaev
waterfall	juga
waterfowl	veelinnud
watershed	valgla ; veelahe; valgla ; veelahe
weapon	relv
weather	ilm
web ; spider web	ämblikuvõrk
weed	umbrohund
weight	kaal
welding	keevitamine, keevitus
well	kaev
whale	vaal
whaling	vaalapüük
wheelchair	ratastool
whey	vadak
white	valge
wild animal	loodusloom
wild fauna ; wildlife ; wild animals	loodusfauna
wild plant	loodustaim
wildlife ; 野生生物	elusloodus, looduselustik
wind	tuul
wind power	tuuleenergia
windmill	tuulik, tuuleveski
window	aken
wine	vein
winter	talv
wizard ; sorcerer ; magician	võlur
wolf	susi
wood	mets
wood	puit
wood product	puittoode
wool	vill
word	sõna
work accident	tööõnnetus
workplace	töökoht
world	maailm
world heritage site	maailmapärand (objekt)
write	kirjutama
wrongful act	seadusvastane tegu
xenon	ksenoon
yeast	pärm
yield	saak
yield	intress ; kasvik
young	noor
ytterbium	Üterbium ; üterbium
yttrium	ütrium
zero ; null	null
zinc	tsink
zirconium	tsirkoonium
zoological garden	loomaaed
zoology	zooloogia
zoonosis	zoonoos
Åland Islands	Ahvenamaa
återställande ; rehabilitation	ennistamine
