English	Portuguese
9 ; nine	nove
AIDS	SIDA
AOX value	halogéneos orgânicos
ASEAN ; Association of Southeast Asian Nations	ANSA
Abidjan	Abidjan
Abkhaz ; Abkhazian ; Abkhazian	abecásio
Abkhazia	Abecásia
Abraham Lincoln ; Abraham Lincoln ; Abraham Lincoln ; Abraham Lincoln ; Abraham Lincoln ; Abraham Lincoln ; Abraham Lincoln ; Abraham Lincoln ; Abraham Lincoln ; Abraham Lincoln ; Abraham Lincoln	Abraham Lincoln
Abuja	Abuja
Adelaide	Adelaide
Adriatic Sea	Mar Adriático
Aegean Sea	mar Egeu ; Mar Egeu
Afar ; Afar	afar
Afghanistan ; Transitional Islamic State of Afghanistan	Afeganistão
Africa	África
Afrikaans	africâner ; africânder ; afrikaans
Albania ; Republic of Albania	Albânia
Algeria ; People's Democratic Republic of Algeria	Argélia
Alps	Alpes
American Samoa	Samoa Americana
American football ; American football	futebol americano
Americas	Continente Americano ; América
Ames test	teste de Ames
Amsterdam	Amsterdão
Andorra ; Principality of Andorra	Andorra
Angola ; Republic of Angola	Angola
Anguilla	Anguila
Antarctic Ocean ; Southern Ocean	Oceano Antárctico
Antarctic ecosystem	ecossistema antárctico
Antarctica	Antárctica ; Antártida
Antigua and Barbuda	Antígua e Barbuda
April	abril
Apus	Apus
Aquarius	Aquarius
Aquila	Aquila
Arabic ; Standard Arabic	árabe
Aragonese ; Aragonese	aragonês
Arctic Ocean	Oceano Árctico
Arctic ecosystem	ecossistema árctico
Argentina ; Argentine Republic	Argentina
Aries	Aries
Arizona	Arizona
Armenia	Arménia
Armenian	arménio ; arménio
Articulata	Articulata
Aruba	Aruba
Asia	Ásia
Assamese ; Assamese	assamês
Asteraceae ; sunflower family ; Compositae ; daisy family ; aster family	Asteraceae
Astur-Leonese ; Asturian ; Asturian-Leonese ; Astur	asturiano
Athens	Atenas
Atlantic Ocean	Oceano Atlântico
August	agosto
Australia ; Commonwealth of Australia	Austrália ; Austrália
Austria ; Republic of Austria	Áustria
Austria-Hungary ; Austro-Hungarian Empire	Áustria-Hungria
Azerbaijan ; Republic of Azerbaijan	Azerbaijão
Azerbaijani ; Azeri ; Azerbaijani Cluster	azeri
Azores	Açores
BBS ; bulletin board system	quadros de afixação de avisos
Bahamas ; Commonwealth of the Bahamas ; Bahama Islands	Bahamas
Bahrain	Bahrein
Balearic Islands	Baleares
Bangladesh ; People's Republic of Bangladesh	Bangladeche
Barbados	Barbados
Basque ; Basque	basco
Bavaria	Baviera
Beijing	Pequim
Belarus ; Republic of Belarus	Bielorrússia
Belarusan ; Belarusan ; Belarusian ; Belorussian ; Byelorussian	belorusso ; bielorrusso
Belgium ; Kingdom of Belgium	Bélgica
Belgrade	Belgrado
Belize	Belize
Belmopan	Belmopan
Bengali ; Bengali	bengali
Benin ; Benin ; Republic of Benin	Benim
Berlin	Berlim
Bermuda	Bermudas
Berne	Berna
Bethlehem	Belém
Bhutan ; Kingdom of Bhutan	Butão
Bible	Bíblia
Birmingham	Birmingham
Black Sea	Mar Negro
Bokmål	bokmål
Bolivia ; Republic of Bolivia	Bolívia
Bonn	Bonn ; Bona
Borneo ; Kalimantan	Bornéu
Bosnia and Herzegovina ; Republic of Bosnia and Herzegovina	Bósnia-Herzegovina
Bosnian ; Bosnian	bósnio
Botswana ; Republic of Botswana	Botsuana ; Botswana
Bourgogne	Borgonha
Bouvet Island	Ilha Bouvet
Boötes	Boötes
Bratislava	Bratislava
Brazil	Brasil
Breton ; Breton	bretão
British Indian Ocean Territory ; BIOT	Território Britânico do Oceano Índico
Brunei ; Negara Brunei Darussalam	Brunei
Bucharest	Bucareste
Bulgaria ; Republic of Bulgaria	República da Bulgária ; Bulgária
Bulgarian ; Bulgarian	búlgaro
Burkina Faso	Burquina Faso
Burmese	birmanês
Burundi ; Republic of Burundi	Burúndi ; Burundi
CD-ROM	CD-ROMs
CD-ROM search service	serviços de pesquisa em CD-ROM
CFC ; chlorofluorocarbon	clorofluorcarbonetos
CFC and halons prohibition	CFCs e halogénios (proibição)
Cairo	Cairo
California	Califórnia
Cambodia ; Kingdom of Cambodia	Camboja ; Reino do Camboja
Cameroon ; Republic of Cameroon	Camarões
Canada	Canadá
Cancer	Cancer
Canes Venatici	Canes Venatici
Canis Major	Canis Major
Canis Minor	Canis Minor
Cape Verde ; Republic of Cape Verde	Cabo Verde
Capricorn	Capricornus
Caribbean Area ; Caribbean	Caraíbas
Caribbean Sea	Marea Caraibelor ; Marea Antilelor
Caspian Sea	Mar Cáspio
Cassiopeia	Cassiopéia
Castilian ; Spanish ; Spanish	espanhol
Catalan ; Catalan	catalão
Cayman Islands	Ilhas Caimão
Central Africa	África Central
Central African Republic	República Centro-Africana
Central America	América Central
Central Asia	Ásia Central
Chad ; Republic of Chad	Chade
Charente	Charente
Chechen ; Chechen	checheno
Chihuahua	Chihuahua
Chihuahua ; chihuahua	chihuahua
Chile ; Republic of Chile	Chile
Chinese	chinês
Christmas	Natal
Christmas Island	Ilha Christmas
Christmas tree	árvore de Natal
Chuvash ; Chuvash ; Chuwash ; Chovash ; Chavash ; Chttash	chuvache
Cologne	Colônia
Colombia ; Republic of Colombia	Colômbia
Community act	actos comunitários
Community budget	orçamento comunitário
Community finance	finanças comunitárias
Community law	Direito comunitário
Community legal system	sistema jurídico comunitário
Community ruling	decisões comunitárias
Comoros ; Union of the Comoros	Comores
Cook Islands	Ilhas Cook
Copenhagen	Copenhaga
Corfu	Corfu
Cornish	córnico
Corsican ; Corsican	corso
Costa Rica ; Republic of Costa Rica	Costa Rica
Court of Justice of the European Communities	Tribunal de Justiça das Comunidades Europeias
Croatia ; Republic of Croatia	Croácia
Croatian ; Croation	croata
Cuba ; Republic of Cuba	Cuba
Cyprus ; Republic of Cyprus	Chipre
Cyrillic alphabet	alfabeto cirílico
Czech ; Czech	tcheco ; checo
Czech Republic ; Czechia	Chéquia ; República Checa
DDT ; dichloro-diphenyl-trichloroethane	DDT ; diclorodifeniltricloretano
DNA ; deoxyribonucleic acid	ADN
Dagestan	Daguestão
Dakar	Dakar
Danish	dinamarquês
December	dezembro
Definition ; definition	definição
Delaware	Delaware
Democratic Republic of the Congo ; Congo-Kinshasa	República Democrática do Congo ; Congo-Kinshasa
Denmark ; Kingdom of Denmark	Dinamarca ; Reino da Dinamarca
Djibouti ; Republic of Djibouti	Jibuti ; Jibuti
Dominica ; Commonwealth of Dominica	Domínica ; Comunidade da Dominica
Dominican Republic	República Dominicana
Down syndrome ; Down’s syndrome	síndrome de Down
Dublin	Dublim
Dutch	holandês ; neerlandês
EC Council of Ministers	Conselho de Ministros da CE
EC Treaty	Tratado da CE
EC directive	directivas comunitárias
EC directive on biocides	biocidas (directiva CE)
EC directive on waste disposal	eliminação de resíduos (directiva CE)
EC directive on water protection	protecção da água (directiva CE)
EC ecolabel	rótulo ecológico da CE
EC policy	políticas da CE
EC regulation	regulamentos da CE
EC regulation on eco-management and audit	ecogestão e auditoria (regulamento CE)
EC regulation on existing chemicals	substâncias químicas existentes (regulamento CE)
EIA (local)	AIA ; avaliação de impacte ambiental
EIA ; environmental impact assessment	avaliação de impacte ambiental
EIA directive	AIA (directiva)
EIA law	AIA (legislação)
EU ; European Union	União Europeia
EU Council	Conselho da UE
Earth-Sun relationship	inter-relações Terra-Sol
East Africa	África Oriental
East Timor ; Democratic Republic of Timor-Leste	Timor Leste ; República Democrática de Timor-Leste
East-West relations	relações Este-Oeste
East-West trade	comércio Este-Oeste
Easter	Páscoa
Eastern Asia ; East Asia	Ásia Oriental
Eastern Europe	Europa Oriental
Ecuador ; Republic of Ecuador	Equador ; República do Equador
Egypt ; Arab Republic of Egypt	Egipto ; Egipto ; Egito
El Salvador ; Republic of El Salvador	El Salvador
England	Inglaterra
English	inglês
English garden	jardim inglês
Epiphany	Epifania ; Epifania do Senhor
Equatorial Guinea ; Republic of Equatorial Guinea	Guiné Equatorial ; República da Guiné Equatorial
Erevan ; Yerevan	Erevan
Eritrea	Eritreia
Esperanto ; Esperanto	Esperanto ; esperanto
Estonia ; Republic of Estonia	Estónia ; República da Estónia
Estonian	estoniano ; estónio
Ethiopia ; Federal Democratic Republic of Ethiopia	Etiópia
Euratom	Euratom
Europe	Europa
European Commission	Comissão Europeia
European Communities	Comunidades Europeias
European Court of Justice	Tribunal de Justiça Europeu
European Environment Agency	Agência Europeia do Ambiente
European Environmental Council	Conselho Europeu do Ambiente
European Monetary Fund	Fundo Monetário Europeu
European Monetary System ; EMS	Sistema Monetário Europeu
European Parliament	Parlamento Europeu
European nature reserve	reservas naturais europeias
European standard	normas europeias
Falkland Islands	ilhas Falkland ; ilhas Malvinas
Faroe Islands	Ilhas Feroé
Faroese ; Faeroese	faroês
February	fevereiro
Fiji ; Republic of the Fiji Islands	Fiji ; República das Ilhas Fidji
Finland ; Republic of Finland	Finlândia ; República da Finlândia
Finnish	finlandês
Flanders ; Flemish region	Flandres
Flemish	flamengo
Flevoland	Flevolândia
France	França
French ; French	francês
French Guiana	Guiana Francesa
French Polynesia	Polinésia Francesa
French Southern Territories ; French Southern and Antarctic LandsA ; French Southern and Antarctic Lands ; Territory of the French Southern and Antarctic Lands	Terras Austrais e Antárticas Francesas
French formal garden	jardim à francesa
Friday	sexta-feira
Frisian ; Western Frisian	frisão
GDP ; gross domestic product	PIB ; produto interno bruto
GDR ; German Democratic Republic	RDA ; República Democrática Alemã
GIS digital format	formatos digitais SIG
GIS digital system	sistemas digitais SIG
GIS digital technique	técnicas digitais SIG
GIS laboratory	laboratórios SIG
Gabon ; Gabonese Republic	Gabão
Gaborone	Gaborone
Galician ; Galician	galego
Gambia ; Gambia ; Gambia ; Gambia ; The Gambia ; Republic of The Gambia	Gâmbia ; República da Gâmbia
Gaza Strip	Faixa de Gaza
Gemini	Gemini
Georgia	Geórgia
Georgian ; Georgian	georgiano
German	alemão
German	alemã ; alemão ; alemão
German (Austria)	alemão (Áustria)
German (Switzerland)	alemão (Suíça)
Germany ; Federal Republic of Germany	Alemanha ; República Federal da Alemanha
Ghana ; Republic of Ghana	Gana ; República do Gana
Gibraltar	Gibraltar
Global Environment Facility ; GEF	Fundo Mundial para o Ambiente
Great Britain ; Britain	Grã-Bretanha
Greece ; Hellenic Republic	Grécia
Greek ; Greek	grego
Greek alphabet	alfabeto grego
Greenland	Groenlândia
Grenada	Granada
Guadeloupe	Guadalupe
Guam ; Guam ; Guam	Guam
Guatemala ; Republic of Guatemala	Guatemala ; República da Guatemala
Guinea ; Republic of Guinea	Guiné ; República da Guiné
Guinea-Bissau ; Republic of Guinea-Bissau	Guiné-Bissau ; República da Guiné-Bissau
Gujarati ; Gujarati	gujarate
Guyana ; Republic of Guyana	Guiana
H5N1 ; Influenza A virus subtype H5N1 ; A(H5N1)	H5N1
Haiti ; Republic of Haiti	Haiti ; República do Haiti
Hannukah	Chanucá
Hanover	Hanôver
Happy New Year	feliz ano novo
Hebrew	hebraico
Hercules	Hércules
Hindi ; Hindi	hindi
Holland ; Kingdom of the Netherlands ; The Netherlands	Reino dos Países Baixos ; Países Baixos
Honduras ; Republic of Honduras	Honduras ; República das Honduras
Hungarian	húngaro
Hungary ; Republic of Hungary	Hungria ; República da Hungria
I	eu
IMCO code	códigos IMO
IMF ; International Monetary Fund	Fundo Monetário Internacional
ISO standard	normas ISO
Iceland ; Republic of Iceland	Islândia ; República da Islândia
Icelandic	islandês
Ido ; Ido	ido
Iliad	Ilíada
India ; Republic of India	Índia ; República da Índia
Indian Ocean	Oceano Índico
Indonesia ; Republic of Indonesia	Indonésia ; epública da Indonésia ; República da Indonésia
Indonesian	indonésio
Indre	Indre
Interlingua ; Interlingua, "Simplified" Latin ; Interlingua, "Simplified" Latin	interlíngua
International Court of Justice	Tribunal de Justiça Internacional
Internet	internet
Iran ; Islamic Republic of Iran	Irão ; Irã ; República Islâmica do Irão
Iraq ; Republic of Iraq	Iraque ; República do Iraque
Ireland ; Republic of Ireland	Irlanda
Irish ; Irish ; Irish Gaelic ; Irish	irlandês
Islam	Islã
Isle of Man ; Isle of Mann ; Mann	Ilha de Man
Israel ; State of Israel	Israel ; Estado de Israel
Italian ; Italian	italiano
Italian Republic ; Italy	Itália ; República Italiana
Ivory Coast ; Cote d'Ivoire ; Republic of Cote d'Ivoire	Costa do Marfim
Jakarta ; Djakarta ; DKI Jakarta	Indonésia ; Jakarta ; Jacarta ; Indonesia
Jamaica	Jamaica
January	janeiro
Japan ; State of Japan	Japão
Japanese ; Japanese	japonês
Javanese	javanês
Jersey ; Bailiwick of Jersey	Jersey
Jordan ; Hashemite Kingdom of Jordan	Jordânia
Judaism	judaísmo
Jupiter	Júpiter
Kalaallisut	gronelandês
Kannada ; Kannada	canará
Karelian	careliano
Kazakh ; Kazakh	cazaque
Kazakhstan ; Republic of Kazakhstan	Cazaquistão ; República do Cazaquistão
Kenya ; Republic of Kenya	Quénia ; República do Quénia
Khartoum	Cartum
Khmer ; Central Khmer	khmer
Kiribati ; Republic of Kiribati	Quiribáti
Korean ; Korean	coreano
Krakow ; Cracow	Cracóvia
Kuwait ; State of Kuwait	Kuwait ; Estado do Kuwait
Kyoto	Quioto
Kyrgyzstan ; Kyrgyz Republic	Quirguizistão
Lagos	Lagos
Lao ; Lao	laociano
Laos ; Lao People's Democratic Republic	Laos ; República Popular Democrática Lao
Latin ; Latin	latim
Latvia ; Republic of Latvia	Letónia
Latvian ; Latvian	letão
Lausanne	Lausana
Lebanon ; Lebanese Republic	Líbano ; República do Líbano
Leningrad ; Petrograd ; Saint Petersburg ; St. Petersburg	São Petersburgo
Leo	Leo
Lesotho ; Kingdom of Lesotho	Lesoto ; Reino do Lesoto
Liberia ; Republic of Liberia	Libéria ; República da Libéria
Libra	Libra
Libya ; Great Socialist People's Libyan Arab Jamahiriya	Líbia ; Grande Jamahiriya Socialista Popular Árabe da Líbia
Liechtenstein ; Principality of Liechtenstein	Listenstaine ; Liechtenstein ; Principado do Liechtenstein
Limburgish ; Limburgian	limburguês
Lisbon	Lisboa
Lithuania ; Republic of Lithuania	Lituânia ; República da Lituânia
Lithuanian ; Lithuanian	lituano
London	Londres
Lower House	Câmara dos Deputados
Lower Saxony	Baixa Saxônia
Luxembourg ; Grand Duchy of Luxembourg	Luxemburgo ; Grão-Ducado do Luxemburgo
Luxembourgish ; Luxemburgish ; Luxembourgian	luxemburguês
Lyon	Lyon
Macedonia ; Republic of Macedonia	Macedónia
Macedonian ; Macedonian	macedônio
Madagascar ; Republic of Madagascar	Madagáscar ; República de Madagáscar
Malawi ; Republic of Malaŵi	Malawi ; República do Malawi
Malayalam ; Malayalam	malayalam ; malabar
Malaysia	Malásia
Maldives ; Republic of the Maldives	Maldivas ; República das Maldivas
Mali ; Republic of Mali	Mali ; República do Mali
Malta ; Republic of Malta	Malta ; República de Malta
Maltese	maltês
Maori	maori
Marathi ; Marāthi ; Marāthi ; MarÄthi	marata
March	março
Markov chain ; Markoff chain	cadeias de Markov ; cadeia de Markov
Marshall Islands ; Republic of the Marshall Islands	Ilhas Marshall ; República das Ilhas Marshall
Martinique	Martinica
Mauritania ; Islamic Republic of Mauritania	Mauritânia
Mauritius ; Republic of Mauritius	Maurícia ; Maurício
May	maio
Mayotte	Mayotte
Mecca	Makkah
Mediterranean Area	área mediterrânea
Mediterranean Sea	Mar Mediterrâneo
Mediterranean climate	clima mediterrânico
Mediterranean forest	floresta mediterrânica
Mediterranean wood	madeira mediterrânica
Mercury	Mercúrio
Merry Christmas	Feliz Natal
Merry Christmas and a happy New Year	Bom Natal e feliz Ano Novo
Mexico ; United Mexican States	México ; Estados Unidos Mexicanos
Micronesia ; Federated States of Micronesia	Micronésia ; Estados Federados da Micronésia
Milan	Milão
Milky Way ; Galaxy	Via Láctea
Milwaukee	Milwaukee
Moldova	Moldávia
Monaco	Mónaco
Monday	segunda-feira
Mongolia	Mongólia
Montenegro	Montenegro
Montserrat	Montserrat
Morocco ; Kingdom of Morocco	Marrocos
Moscow	Moscovo
Mount Fuji	Monte Fuji
Mozambique	Moçambique
Munich	Munique
Myanmar	Myanmar ; União de Myanmar
NIMBY aptitude ; NIMBY attitude	atitude "NIMBY"
NOEL	NOEL (limite de dose sem efeitos adversos observados)
Nairobi	Nairobi
Namibia	Namíbia
Naples	Nápoles
Nauru ; Republic of Nauru	Nauru
Neapolitan ; Neapolitan	napolitano
Nepal	Nepal
Nepali ; Nepali	nepali
Neptune	Neptuno
New Caledonia	Nova Caledónia
New Year ; New Year's Day	Ano Novo ; ano novo
New York	Nova Iorque
New Zealand	Nova Zelândia
Nicaragua	Nicarágua
Niger	Níger
Nigeria	Nigéria
Niue	Niue
North Africa	África do Norte
North America	América do Norte
North Atlantic Ocean	Oceano Atlântico Norte
North Korea ; Democratic People's Republic of Korea	Coreia do Norte
North-South relationship	relações Norte-Sul
Northern Ireland	Irlanda do Norte
Norway ; Kingdom of Norway	Noruega ; Reino da Noruega
Norwegian	norueguês
Novial	novial
Nuuk	Nuuk
Nynorsk	nynorsk
Oceania	Oceânia
Oman ; Sultanate of Oman	Omã ; Omã ; Oman ; Oman ; Omão ; Sultanato do Omã
Orleans	Orleães
Oslo	Oslo
Pacific Ocean	Oceano Pacífico
Pakistan ; Islamic Republic of Pakistan	Paquistão ; República Islâmica do Paquistão
Palau	Palau
Panama	Panamá
Papua New Guinea	Papua-Nova Guiné
Paraguay	Paraguai
Paris	Paris
Parliament	Parlamento
People's Republic of China ; China	China
Persian ; Western Farsi ; Farsi	persa
Peru ; Republic of Peru	Peru ; República do Peru
Philadelphia	Filadélfia
Philippines	Filipinas
Phobos	Fobos
Piedmontese ; Piedmontese ; Piemontese ; Piemontese	piemontês
Poland	Polónia ; Polónia ; Polônia
Polish ; Polish	polaco ; polonês
Portugal	Portugal
Portuguese ; Portuguese	português ; Portugänapük ; lingua Lusitana
Puerto Rico	Porto Rico
Punjabi ; Panjabi	punjabi
Pyrenees	Pireneus
Pyrrhic victory	vitória pírrica ; vitória de Pirro
Qatar	Catar ; Qatar
Ramadan	Ramadão
Republic of the Congo ; Congo-Brazzaville	República do Congo
Rhône	Ródano
Romania	Roménia
Romanian ; Romanaian	romeno
Rome	Roma
Russia ; Russian Federation	Rússia
Russian ; Russian	russo
Sagittarius	Sagittarius
Saint-Pierre and Miquelon	Saint-Pierre e Miquelon
Sakhalin ; Saghalien	Sacalina
Samoa	Samoa
San Marino	São Marinho
Sanskrit ; Sanskrit	sânscrito
Sapir–Whorf hypothesis	hipótese Sapir-Whorf
Saturday	sábado
Saturn	Saturno
Saudi Arabia ; Kingdom of Saudi Arabia	Arábia Saudita
Saxony	Saxónia
Scorpio	Scorpius
Scotland	Escócia
Seine	Sena
Senegal	Senegal
September	setembro
Serbia	Sérvia
Serbia and Montenegro	Sérvia e Montenegro
Serbian ; Serbian	sérvio
Seychelles ; Republic of Seychelles	Seicheles
Sicilian ; Sicilian	siciliano
Sierra Leone	Serra Leoa
Sindhi ; Sindhi	sindhi
Singapore	Singapura
Slovak ; Slovak	eslovaco
Slovakia	Eslováquia
Slovene ; Slovenian ; Slovenian	esloveno
Slovenia	Eslovénia
Solomon Islands	Ilhas Salomão
Somali ; somali	somali
South Africa	África do Sul
South America	América do Sul
South Korea ; Republic of Korea	Coreia do Sul
Southeast Asia	Sudoeste Asiático
Southern Asia ; South Asia	Ásia do Sul
Spain	Espanha
Sri Lanka	Sri Lanka ; Sri Lanca
Sudan	Sudão
Sun King	Rei-Sol
Sunday	domingo
Suriname	Suriname
Swahili	suaíli
Sweden	Suécia
Swedish	sueco
Switzerland	Suíça
Syria ; Syrian Arab Republic	Síria ; República Árabe Síria
Tagalog	tagalo
Taiwan	Taiwan ; Formosa
Tajik	tadjique
Tajikistan	Tajiquistão
Tamil ; Tamil	tâmil
Tanzania	Tanzânia
Tatar ; Tatar	tártaro
Taurus	Taurus
Telugu ; Telugu	telugu
Tennessee	Tennessee
Thai ; Thai	tailandês
Thailand	Tailândia
The Hague	Haia
Thuringia	Turíngia
Thursday	quinta-feira
Togo	Togo
Tokyo	Tóquio
Tonga	Tonga
Toronto	Toronto
Tswana	seTswana
Tuesday	terça-feira
Tunisia	Tunísia
Turkey	Turquia
Turkish ; Turkish	turco
Turkmenistan	Turquemenistão
UN ; United Nations	Nações Unidas
Uganda ; Republic of Uganda	Uganda
Ukraine	Ucrânia
Ukrainian ; Ukrainian	ucraniano
United Arab Emirates	Emiratos Árabes Unidos ; Emirados Árabes Unidos
United Kingdom ; United Kingdom of Great Britain and Northern Ireland ; UK	Reino Unido ; Reino Unido da Grã-Bretanha e Irlanda do Norte
United States ; United States of America ; America ; US ; U.S. ; U.S.A. ; U.S. of A. ; States	Estados Unidos da América ; Estados Unidos
Uranus	Urano
Urdu ; Urdu	urdu
Utah	Utah
Vaduz	Vaduz
Vatican City ; The Holy See ; State of the Vatican City	Cidade do Vaticano ; Santa Sé ; Estado da Cidade do Vaticano
Venezuela	Venezuela
Venice	Veneza
Venus	Vénus
Venus	Vênus
Vienna	Viena
Vietnamese ; Vietnamese	vietnamita
Volapük	volapuque
Volga	Volga
Wales	País de Gales
Wallis and Futuna ; Territory of the Wallis and Futuna Islands	Wallis e Futuna
Walloon ; Walloon	valão
Wednesday ; quarta-feira	quarta-feira
Welsh ; Welsh	galês
Western Asia ; Southwest Asia	Ásia Ocidental
Western Europe	Europa Ocidental
Wikipedia	Wikipédia
Wiktionary	Wikcionário
World Wide Web ; WWW	World Wide Web
Wyoming	Wyoming
Xhosa	xhosa
Yemen ; Republic of Yemen	Iémen ; Iémen
Yiddish	iídiche
Zambia ; Republic of Zambia	Zâmbia ; República da Zâmbia
Zanzibar	Zanzibar
Zimbabwe ; Republic of Zimbabwe	Zimbabué ; República do Zimbábue
Zulu	zulu ; isiZulu
aAmplitude ; amplitude	amplitude
aback	chocado
abacus	ábaco
abandoned industrial site	zonas industriais abandonadas
abandoned vehicle ; car wreck	veículos abandonados
abbreviation	abreviatura
abhor ; loathe ; detest	detestar
abiotic environment	ambiente abiótico
abiotic factor	factores abióticos
abolitionist	abolicionista
abortive	fracassado
abrasive	abrasivo
abridge	abreviar
abscess	abcesso
absolutely	absolutamente
absorption	absorção
acceleration	aceleração
acceptable daily intake	dose diária aceitável
acceptable risk level	nível de risco aceitável
acceptance ; credence	aceitação
access road	caminhos de acesso
access to administrative documents	acesso a documentos administrativos
access to culture	acesso à cultura
access to information	acesso à informação
access to the courts	acesso aos tribunais
accident	acidentes ; acidente
accident source ; cause of the accident	origem de acidentes
accidental release of organisms	libertação acidental de organismos
accordion ; squeeze box ; piano accordion	acordeão
account	conta
accountancy	contabilidade
accounting	contabilidade
accounting system	sistemas de contabilidade
accumulator	acumuladores
acid	ácidos ; ácido
acid deposition	deposição ácida
acid rain	chuvas ácidas
acidification	acidificação
acidity	acidez
acidity degree	grau de acidez
acne	acne
acorn	bolota
acoustic comfort	conforto acústico
acoustic filter ; audio filter	filtros acústicos
acoustic insulation	isolamento acústico
acoustic level ; sound pressure level	níveis acústicos
acoustic property	propriedades acústicas
acoustical quality	qualidade acústica
acoustics	acústica
acquisition	aquisição
acrid	acre
act ; deed	actos legislativos ; acto legislativo
actinide	actinídeos ; actínido
actinium	actínio
action group ; action committee	grupos de intervenção
activated carbon	carvão activado
activated sludge	lamas activadas
active participation	participação activa
active population	população activa
activist	activista
adaptation period	períodos de adaptação
add	somar
addition	adição ; soma
additional packaging	embalagens adicionais
additive	aditivos
adequate food supply	fornecimento adequado de alimentos
adhesive	materiais aderentes
adieu ; bye ; cheerio ; farewell ; good day ; goodbye	adeus
adjective ; describing word	adjectivo ; adjetivo
adjust	regular
administration ; direction ; management	administração
administrative body ; administrative organ	corpos administrativos
administrative boundary	limites administrativos
administrative competence ; administrative ability	competência administrativa
administrative deed	acções administrativas
administrative fiat	ordem oficial
administrative instructions	instruções administrativas
administrative law	Direito administrativo
administrative occupation	cargos administrativos
administrative organisation	organização administrativa
administrative procedure	procedimentos administrativos
administrative sanction	sanção administrativa
adoption	adopção
adsorption	adsorção
adult	adultos
adult education	educação de adultos
adventure	aventura
adverb	adverbio ; advérbio
advertisement ; promotion	publicidade
advice	guias de remessa
aeration	arejamento
aerial	antena
aerial photograph	fotografia aérea ; fotografia aérea (imagem)
aerial photography	fotografia aérea
aerobic process	processos aeróbios
aerobic treatment	tratamento aeróbio
aerobiology	aerobiologia
aerodynamic noise	ruído aerodinâmico
aeroplane ; bird ; plane	aeroplano ; avião
aerosol	aerossóis
aesthetics	estética
afforestation ; tree planting ; afforestment	florestação
afterburning ; afterburning ; afterburner	pós-combustão
age	idade
aggressive	agressivo
aggressor ; assailant ; attacker ; assaulter	assaltante
agoraphobia ; agoraphobia ; agoraphobia ; agoraphobia	agorafobia ; agorafobia
agreement	acordos económicos
agreement	contratos administrativos
agreement	acordos
agri-foodstuff	indústria agro-alimentar
agricultural biotechnology	biotecnologia agrícola
agricultural building	instalações agrícolas
agricultural disaster	catástrofes agrícolas
agricultural ecology ; agroecology	ecologia agrícola
agricultural economics	economia agrária
agricultural effluent	efluentes agrícolas
agricultural engineering	engenharia agrícola
agricultural equipment	equipamento agrícola
agricultural equipment ; agricultural machinery ; farm machinery	equipamento agrícola ; maquinaria agrícola
agricultural exploitation	exploração agrícola
agricultural hydraulics	hidráulica agrícola
agricultural land	solos agrícolas
agricultural landscape	paisagens agrícolas
agricultural legislation	legislação agrícola
agricultural management	gestão agrícola
agricultural method	sistemas de exploração agrícola
agricultural pest	pragas agrícolas
agricultural planning	planeamento agrícola
agricultural policy	política agrícola
agricultural pollution	poluição agrícola
agricultural product	produtos agrícolas
agricultural production ; farm production ; agricultural output	produção agrícola
agricultural real estate	propriedades rurais
agricultural storage	armazenagem de produtos agrícolas
agricultural structure	estrutura agrícola
agricultural undervaluation	depreciação agrícola
agricultural waste	resíduos agrícolas
agriculture	agricultura
agriculture ; agriculture	agricultura ; agricultura
agriculture and cattle industry	indústria agro-pecuária
agriculture framework plan	planos estruturais agrícolas
agritourism	turismo rural
agrochemical	produtos agro-químicos
agroforestry	silvicultura agronómica
agroindustry	agro-indústria
agrometeorology	meteorologia ; meteorologia (agricultura)
agronomic value	valor agronómico
agronomy	agronomia
agrosystem	sistemas agrícolas
aid policy	políticas de ajuda
air	ar
air conditioning ; AC ; air-conditioning	ar condicionado
air movement	movimentos atmosféricos
air pollutant	poluentes do ar
air pollution	poluição do ar
air quality	qualidade do ar
air quality control	controlo da qualidade do ar
air quality management	gestão da qualidade do ar
air quality monitoring	qualidade do ar (monitorização)
air sac ; alveolus	alvéolos
air safety	segurança aérea
air temperature	temperatura do ar
air traffic	tráfego aéreo
air traffic law	tráfego aéreo (legislação)
air transportation	transporte aéreo
air-water interaction	interacção ar-água
airborne noise	ruído de transmissão aérea
aircraft	aeronaves
aircraft noise	ruído de aeronaves
airmail	correio aéreo
airport	aeroportos ; aeroporto
airspace planning	planeamento do espaço aéreo
alarm ; alert ; warning	alarmes ; alarme
alarm clock	despertador
albinism	albinismo
alchemist	alquimista
alchemy	alquimia
alcohol	álcoois ; álcool
alcoholism	alcoolismo
alga	algas
algal bloom	blooms algais
algebra	álgebra
algicide ; algaecide	algicida
algorithm	algorytm ; algoritmo
alibi	álibi
alicyclic compound	compostos alicíclicos
alicyclic hydrocarbon	hidrocarbonetos alicíclicos
alignment	alinhamento
aliphatic compound	compostos alifáticos
aliphatic hydrocarbon	hidrocarbonetos alifáticos
alkali soil	solos alcalinos
alkaline ; element of group I ; alkaline metal ; alkali metal	alcalinos ; elementos do grupo I ; elemento do grupo I
alkaline battery	baterias alcalinas
alkane ; paraffin ; methane series ; alkane series	alcano
alkyl compound	compostos de alquilo
all-terrain vehicle	veículos de todo o terreno ; veículo todo-terreno
allegory	alegoria
allergen	alergénios
allergy	alergias ; alergia
allocation ; allotment ; resource allotment	atribuição
allocation plan	planos de locação
allotropy	alotropia
allowance	descontos
alloy	ligas metálicas ; liga
alluvial plain	planícies aluviais
alluvion ; flood ; overflowing ; inundation	aluvião
almanac	almanaque
almond	amêndoa
almost	quase
alongside ; amongst ; with	com
alpha radiation	radiação alfa
alphabet	alfabeto
alternative material	materiais alternativos
alternative technology	tecnologias alternativas
altitude	altitude
alumina	alumina
aluminium	alumínio
aluminium container	recipientes de alumínio
aluminium content	teor de alumínio
aluminium industry	indústria do alumínio
amalgam	amálgama
ambassador	embaixador
amber	âmbar
ambulance	ambulância
americium	amerício
amethyst	ametista
amine	amina
amino acid	aminoácidos ; aminoácido
ammonia	amoníaco
ammonification	amonificação
ammonium	amónia
amphetamine	anfetamina
amphibian	anfíbios
amphitheatre	anfiteatro
amusement park	parques de diversões
anaconda	anaconda
anaerobic process	processos anaeróbicos
anaerobic treatment	tratamento anaeróbio
anagram	anagrama
analogous	análogo
analogy	analogia
analysis	análises
analysis programme	programas de análises
analytical chemistry	química analítica
analytical equipment	equipamento de análise
analytical method	métodos de análise
anarchism	anarquismo
anarchy	anarquia
anatomy	anatomia
anchor	âncora
and	e
and ; as well as ; in addition to ; together with ; too	e
angel	anjo
angiosperm ; flowering plant	angiospérmicas ; plantas de flor ; angiosperma
angling ; fishing ; line-fishing	pesca à linha
animal	animais ; animal
animal behaviour	comportamento animal
animal biology	biologia animal
animal conservatory	áreas protegidas (fauna)
animal corridor	corredores ecológicos (fauna)
animal damage	danos causados por animais
animal disease	doenças de animais
animal displacement	deslocação de animais
animal ecology	ecologia animal
animal excrement	excrementos
animal experiment	experiências com animais
animal foodstuff	rações para animais
animal for slaughter	animais para abate
animal habitat	habitats animais
animal heritage	património animal
animal husbandry	pecuária
animal manure	estrume
animal migration	migrações de animais
animal noise	ruído de animais
animal nutrition	nutrição animal
animal physiology	fisiologia animal
animal population	população animal
animal product	produtos de origem animal
animal production	produção animal
animal protection	protecção dos animais
animal reproduction	reprodução animal
animal resource	recursos animais
animal rights	direitos dos animais
animal shelter	abrigos para animais
animal species	espécies animais
animal species reintroduction	espécies animais (reintrodução)
animal trade	comércio de animais
animal waste	resíduos animais
anime	anime
anion	aniões
anise	anis
ankle ; talocrural joint	tornozelo
annelid	anelídeos
anniversary	aniversário
ant	formiga
antagonism	antagonismo
antelope	antílope
anthropic activity	actividades antrópicas
anthropologic reserve	reservas antropológicas
anthropologist	antropólogo
anthropology	antropologia
antibiotic	antibiótico
antibody	anticorpos ; anticorpo
anticipation of danger	previsão do perigo
antifouling agent	anti-incrustantes
antimony	antimônio
antiparticle	antipartícula
antipollution incentive	incentivos antipoluição
antiquated plant	instalações obsoletas
antiseismic regulation	regulamentos anti-sísmicos
antonym	antônimo
anvil	bigorna
anytime	sempre
apartheid	apartheid
apartment block	edifícios de apartamentos
apathy	apatia
aphorism	aforismo
apiculture ; beekeeping	apicultura
apoptosis	apoptose
apostle	apóstolo
appeal	recursos ; recursos (legislação)
appeal procedure	processos de recursos
apple	maçã
apple ; apple tree	macieira
applied ecology	ecologia aplicada
applied nutrition	nutrição aplicada
applied research	investigação aplicada
applied science	ciências aplicadas ; ciência aplicada
appraisal	apreciação
appreciate	apreciar
approach	abordagens
appropriate technology	tecnologias adequadas
approval ; approbation	aprovação
approval of installations	aprovação de instalações
apricot	abricó
apron	avental
aquaculture	aquacultura
aquamarine	água-marinha
aquarium	aquário
aquatic animal	animais aquáticos
aquatic ecology	ecologia aquática
aquatic ecosystem	ecossistema aquático
aquatic environment	ambiente aquático
aquatic mammal	mamíferos aquáticos
aquatic organism	organismos aquáticos
aquatic plant	plantas aquáticas
aqueduct	aquedutos
aquifer	aquíferos
arable farming	agricultura arável
arboretum	arboreto
arboriculture	arboricultura
archaeological	arqueológico
archaeological site	patrimómio arqueológico
archaeology ; archeology ; archæology	arqueologia
archbishop	arcebispo
archduke	arquiduque
archer ; archer	arqueiro
archetype	arquetipo
archipelago	arquipélagos ; arquipélago
architect	arquitecto ; arquiteto
architecture	arquitectura
archive	arquivo
area of potential pollution	áreas de poluição potencial
area under stress	áreas sob stress
argon	argônio
argument	disputa
arid land	zonas áridas
aristocracy	aristocracia
arithmetic ; arithmetics	aritmética
arm	braço
armament	armamento
armament conversion	conversão de armamento
armed forces	forças armadas
armistice	armistício
armoury	arsenal
armpit	sovaco
aromatic compound	compostos aromáticos
aromatic hydrocarbon	hidrocarbonetos aromáticos
aromatic substance	substâncias aromáticas
arrange ; adapt ; adjust ; conform ; accommodate ; suit	adaptar ; ajustar
arrangement for a deposit on packaging	depósitos de embalagens (acordo)
arrival	chegada
arrow	flecha ; seta
arrowhead	ponta de seta
arsenic	arsénio
arson	fogo posto
arsonist	incendiário
art	arte
artery	artéria
artful	astuto
arthritis	artrite
arthropod	artrópodes
artichoke	alcachofra
article	artigo
artificial lake	lagos artificiais
artificial reproductive technique	técnicas de reprodução artificial
artificial satellite	satélites artificiais
artist ; creative person	artista
asbestos	asbestos ; amianto
asbestos cement	fibrocimento
asbestosis	asbestose
ascendancy	superioridade
ascent	subida
ascertain	descobrir
ascetic	asceta
ash	cinzas
ashamed	envergonhado
ashen	cinzento
ashore	em terra
ashtray	cinzeiro
asleep	adormecido
asparagus	espargo
asphalt	asfalto
aspiration	aspiração
aspirin	aspirina
assassin ; assassinator	assassino
assay	ensaios
assemble ; get together ; gather	reunir
assent	assentimento
assent	concordar
assert	declarar
assert	afirmar
assertive	agressivo
assign	escolher
assignment	tarefa ; encargo
assimilate	assimilar
assimilation	assimilação
assist	ajudar
association	associações
assorted	sortido
assumption ; supposition	suposição
astatine	astato
asterisk	asterisco
asteroid	asteróide
asthenosphere	astenosfera
astonish	surpreender
astonishing	surpreendente
astonishment	surpresa
astound	pasmar
astounding	estarrecedor
astride	escarranchado
astride	de cada lado
astrology ; star divination	astrologia
astrometry	astrometria ; astronomia de posição
astronautics	astronáutica
astronomer	astrônomo  .
astronomy	astronomia
astrophysics	astrofísica
asymmetric ; asymmetrical	assimétrico
asymptote	assíntota
atheist	ateu
atlas	atlas
atmosphere	atmosfera
atmospheric aerosol	aerossóis atmosféricos
atmospheric chemistry	química da atmosfera
atmospheric circulation	circulação atmosférica
atmospheric component	componentes da atmosfera
atmospheric composition	composição da atmosfera
atmospheric correction	correcção atmosférica
atmospheric emission	emissões para a atmosfera
atmospheric fallout	fallout atmosférico
atmospheric layering	estratificação da atmosfera
atmospheric monitoring	monitorização atmosférica
atmospheric ozone	ozono atmosférico
atmospheric particulate	partículas atmosféricas
atmospheric physics	Aeronomia ; física da atmosfera
atmospheric pollution	poluição atmosférica
atmospheric precipitation ; precipitation	precipitação atmosférica
atmospheric process	processos atmosféricos
atmospheric science	ciências da atmosfera
atmospheric structure	estrutura da atmosfera
atoll	atol
atom	átomo
atomic mass	massa atômica
atractive	atraente
atrazine	atrazina
atrocity	atrocidade
attached	afeiçoado
attachment	afeição
attachment	acessório
attack	ataque
attain	atingir
attend	tratar
attend	ir a
attend	dar atenção
attend	tratar de
attendant	empregado
attentive	atento
attic	sótão
attire	roupa
attire	vestir
attitude	posição
attract	atrair
attribute	atributos
auction	leilão
audacious	audacioso
audio-visual presentation	apresentação audiovisual
audiovisual equipment	equipamento audiovisual
audiovisual media	meios audiovisuais
audit	auditorias ; auditoria
augment	aumentar
auspicious	auspicioso
authorisation	autorizações ; autorização
authoritarian	autoritário
authoritative	de perito
authority body	órgãos de poder
authorship	autoria
autocracy	autocracia
autoecology	autoecologia
automobile industry	indústria automóvel
autopsy	autópsia
autumn	outono
available	disponível
avalanche	avalanches ; avalanche
avalanche protection	protecção contra avalanches
avaricious	ávido
avert	evitar
avert	desviar
aviary	aviário
aviation law	Direito aéreo
aviculture	avicultura
avid	ávido
avifauna	aves
awe	espanto
awhile	um pouco
axiom	v ; axioma
aye ; yeah ; yep ; yes	sim
baboon	babuíno
background level	nível de fundo
background noise	ruído de fundo
background radiation	radiação de fundo
bacon	bacon
bacterial bed	leitos bacterianos
bactericide	bactericidas ; bactericida
bacteriological pollution	poluição bacteriológica
bacteriology	bacteriologia
bacterium	bactérias ; bactéria
bag ; pocket ; steal	roubar ; furtar
bagpipes	gaita-de-fole
baker	padeiro
baker ; bakery	padaria
baking powder	fermento
balance	saldo
balance of matter	balanço de matéria (biologia)
balancing of interests	equilíbrio de interesses
ballad	balada
ballroom	salão de baile
banana	banana
bank	ribanceira ; margem
bank protection	protecção de ribanceiras
banking	comércio bancário
bankruptcy	falência ; bancarrota
barium	bário
barley	cevada
barometer	barômetro
baron	barão
barrier beach	ilhas barreira
barrier reef	barreiras de recifes
base	base
baseline monitoring	controlo da linha de base
basement	cave
basic food requirement	necessidades alimentares básicas
basicity	basicidade
basidiomycete	basidiomicetos
basketball ; basketball game	basquetebol
bassoon	fagote
bastardisation of fauna	abastardamento da fauna
bastardisation of flora	abastardamento da flora
batch process	processo por lotes
bathing freshwater	águas balneares doces
bathing seawater	águas balneares salgadas
bathing water	água de banhos
battery	baterias
battery disposal	eliminação de baterias
bay	baías ; baía
beach	praias
beach cleansing	limpeza de praias
beak ; mouth	boca
bean ; edible bean	feijão
bear	urso
beatification	beatificação
beaver	castor
bed	cama
bee	abelhas ; abelha
bee conservation	protecção das abelhas
beef cattle	bovinos para abate
beehive	alvéolo
beekeeper ; apiculturist	abelheiro ; apicultor
beer	cerveja
beetle	besouros
behaviour	comportamento
behaviour of substances	comportamento das substâncias
behaviour pattern	padrões de comportamento
behavioural science	ciências do comportamento
belly button ; bellybutton ; navel ; omphalos ; omphalus ; umbilicus	umbigo
beneficial organism	organismos benéficos
benthic division	divisão bentónica
benthos	bentos
benzene	benzeno ; benzol
benzopyrene	benzopireno
berkelium	berkélio ; berquélio
beryllium ; glucinium	berílio
beta radiation	radiação beta
better	melhor
between	entre
beverage ; drink	bebidas ; bebida
beverage ; drink	bebida
beverage industry	indústria de bebidas
bibliographic information	informação bibliográfica
bibliographic information system	sistemas de informação bibliográfica
bibliography	bibliografias
bicycle ; bike ; cycle	bicicletas ; bicicleta
big ; large	grande
big game	caça grossa
bilateral	bilateral
bilateral convention	convenções bilaterais
bile	bile
bilge oil	óleos dos porões
bilge water	águas dos porões
binary star	sistema binário
bio-availability	biodisponibilidade
bioaccumulation	bioacumulação
bioaccumulative pollutant	poluentes bioacumulativos
biochemical method	métodos bioquímicos
biochemical oxygen demand	carência bioquímica de oxigénio
biochemical process	processos bioquímicos
biochemical substance	substâncias bioquímicas
biochemistry	bioquímica
biocide	biocidas
bioclimatology	bioclimatologia
biocoenosis	comunidades bióticas
bioconcentration factor	factores de bioconcentração
biodegradability	biodegradabilidade
biodegradable pollutant	poluentes biodegradáveis
biodegradation	biodegradação
biodiversity	biodiversidade
bioethics	bioética
biofiltration	biofiltração
biofuel	biocombustíveis
biogas	biogás
biogeochemical cycle	ciclos biogeoquímicos
biogeographical region	regiões biogeográficas
biogeography	biogeografia
biological analysis	análises biológicas
biological attribute	atributos biológicos
biological contamination	contaminação biológica
biological cycle	ciclos biológicos
biological development	desenvolvimento biológico
biological effect	efeitos biológicos
biological effect of pollution	poluição (efeitos biológicos)
biological engineering	engenharia biológica
biological heritage	património biológico
biological indicator	indicadores biológicos
biological monitoring	monitorização biológica
biological pest control	controlo biológico de pragas
biological pollutant	poluentes biológicos
biological pollution	poluição biológica
biological process	processos biológicos
biological production	produção biológica
biological reserve ; wildlife reserve	reservas biológicas
biological resource	recursos biológicos
biological test	testes biológicos
biological treatment	tratamento biológico
biological waste gas purification	tratamento biológico de biogás
biological waste treatment	tratamento biológico de resíduos
biological wastewater treatment	tratamento biológico das águas residuais
biological water balance	equilíbrio biológico da água
biological weapon	armas biológicas
biology ; biological science	biologia
bioluminescence	bioluminescência
biomarker	marcadores biológicos
biomass	biomassa
biomass energy	energia da biomassa
biome	bioma
biophysics	biofísica
bioreactor	reactores biológicos ; reactor biológico
biorhythm	biorritmo
biosafety	segurança biológica
biosphere	biosfera
biosphere reserve	reservas da biosfera
biosynthesis	biossíntese
biotechnological hazard	perigos biotecnológicos
biotechnology	biotecnologia
biotic factor	factores bióticos
biotic index	índices bióticos
biotope	biótopo
biotope network	redes de biótopos
biotope order	ordem de biótopo
biotope protection	protecção do biótopo
bird	ave ; pássaro
bird of prey	aves de rapina
bird sanctuary	refúgios ornitológicos
bird species	espécies de aves
birth ; birth ; birth ; childbirth ; childbirth ; childbirth ; parturition	nascimento ; nascimento
birth control	controlo de natalidade
birthday	aniversário
bishop	bispo
bismuth	bismuto
bitumen	betume
black	negro ; preto
black ; dark	escuro
black coal ; black coal ; black coal ; anthracite coal	hulha
blackbird	melro
blacksmith	ferreiro
blast furnace	altos-fornos
bleaching agent	agentes de branqueamento
bleaching clay	argila de branqueamento
bleaching process	processo de branqueamento
blind	cego
blister	bolha
blog ; weblog ; web log	blog
blood	sangue
blood plasma	plasma sanguíneo
blue	azul
blue-green alga ; cyanobacteria	algas azuis-verdes
boat	barco
boating	desportos náuticos
bocage	bocage (área natural) ; bocage
bog	turfeira
bohrium	bóhrio
boiler	caldeiras
boiling point	ponto de ebulição
bonsai	bonsai
book	livro
bookkeeping	contabilidade (execução)
border	fronteiras ; fronteira
boron	boro
botanical conservatory	estufas botânicas
botanical garden	jardim botânico
botany	botânica
botany ; phytology	botânica
bottle cap	tampas de garrafa ; tampa de garrafa
boundary	fronteira
boundary crossing	passagem de fronteira
boundary layer	camada limite
bow	arco
boy	rapaz ; moço ; menino ; garoto
brackish water	água salobra
branch	ramo
branch of activity	ramos de actividade
bread	pão
breakfast	pequeno-almoço ; pequeno-almoço
breast milk	leite materno
breeding	melhoramento de espécies
breeding bird	aves reprodutoras
breeding technique	técnicas de reprodução
brick	tijolos ; tijolo
bridge	pontes ; ponte
bring	trazer
broad-leaved tree	árvores folhosas
broader term ; broader terms ; hypernym ; holonym	termos mais gerais
broccoli	brócolis
bromine	bromo
brooding	incubação
brook	regatos
brushwood	matagais
bryophyte	briófitas
bubble policy (emissions trading) ; bubble policy	política de bolsas (permuta de taxas de emissão) ; política de bolsas
budget	orçamento
budget policy	política orçamental
bug ; põrnikas	hemípteros
building	edifícios ; edifício
building area	áreas de construção
building component	componentes de construção
building destruction	demolição de edifícios
building industry	construção civil
building land	terrenos para construção
building material	materiais de construção
building materials industry	indústria de materiais de construção
building permit	licenças de construção
building planning	planeamento de construção
building regulation	normas de construção civil
building related illness ; sick building syndrome	síndroma dos edifícios doentes
building restoration	restauro de edifícios
building service	serviços de construção
building site	sítios de construção ; canteiro de obra
building site preparation	preparação de sítios de construção
building technology	tecnologia de construção civil
building waste	resíduos de edifícios
built drainage system	sistemas de drenagem artificiais
built environment	áreas construídas
built structure	estrutura construída
built-up area	povoações
bulb cultivation	cultivo de bolbos
bulky waste	resíduos sólidos volumosos
bull	touro
bumblebee	zangão
bureaucracy	burocracia
bureaucratisation	burocratização
bus ; coach	autocarro ; machimbombo ; ônibus
bus station	terminal de autocarros
bush clearing	desbravamento de mato
business	negócios
business activity	actividades empresariais
business classification	classificação empresarial
business economics	economia empresarial
business organisation	organizações empresariais
business policy	política empresarial
butcher	homem do talho ; talhante
butter	manteiga
butterfly	borboletas ; borboleta
button ; clit ; clitoris	clítoris ; clitóris ; berbigão ; clitóride
button-cell battery	pilhas de mercúrio
buy ; purchase	comprar ; adquirir
buy ; purchase	aquisição
by-catch	pesca acessória
by-product	subprodutos
cable	cabos
cactus	cacto
cadmium	cádmio
caesium	césio
caffeine	cafeína
calcium	cálcio
calcium content	teor de cálcio
calculation	cálculos
calculation method	métodos de cálculo
calendar	calendário
caliber	calibre
calibration	calibração
californium	califórnio
calligraphy	caligrafia
camel	camelo
camera	câmera
camouflage	camuflagem
camp ; military camp ; army camp ; campsite	acampamentos ; acampamento
camping ; camping ground	campismo
camping site	parques de campismo
canal	canais ; canal
canal lock	comportas (canais) ; eclusa
cancer	câncer ; cancro
cancer risk	riscos de cancro
candle	vela
canid	canídeos
canyon	canhão
capital	capital
car ; automobile	automóveis ; automóvel ; carro ; carro
car park	parques de estacionamento
car tyre	pneus de carros
carbohydrate	hidratos de carbono
carbon	carbono
carbon dioxide	dióxido de carbono
carbon dioxide tax	taxas de dióxido de carbono
carbon monoxide	monóxido de carbono
carbonate	carbonatos
carcass disposal	eliminação de carcaças
carcinogen	agentes cancerígenos
carcinogenicity	carcinogenicidade
carcinogenicity test	testes de carcinogenicidade
cardinal	cardeal
cardiology	cardiologia
cardiovascular disease	doenças cardiovasculares
cardiovascular system	sistema cardiovascular
career	carriera
carnivore	carnívoros ; carnívoro
carpet	carpete ; tapete
carry-over effect	efeitos de prolongamento
cartography	cartografia
case ; lawsuit ; trial	julgamentos ; julgamento
cash crop	culturas de rendimento
castle	castelo
cat	gato
catalysis	catálise
catalyst	catalisadores
catalytic converter	conversor catalítico
catapult	catapulta
catastrophe	catástrofes
catch yield	produtos de captura (pesca)
catchment	reservatórios de água
catchment area	albufeiras ; albufeira
category	categoria
category of endangered species	espécies em vias de extinção (categorias)
cation	catião
cattle	gado bovino
cauliflower	couve-flor
cause-effect relation	relação causa-efeito
cave	grutas
caviar	caviar
celery	aipo ; salsão
celibacy	celibato
cell ; cell	células ; células
cell ; electrochemical cell ; energy cell ; Galvanic cell ; στοιχείο	pilhas
cellulose	celulose
cellulose industry	indústria da celulose
cement	cimento
cement industry	indústria cimenteira
cement manufacture	fabrico de cimento
census survey	recenseamento
central government	governo central
central park area	núcleos centrais de parques
centralisation	centralização
centrifugation	centrifugação
cephalopod	cefalópodes
ceramics	cerâmica
ceramics industry	indústria cerâmica
cerium	cério
certification	certificação
cetacean	cetáceos
chair	cadeira
chalk	giz
champagne	champagne
change in value	alteração de valores
channelling	sistemas de condutas
chaos theory	teoria do caos
chapter	capítulo
characteristic	característica
charcoal	carvão vegetal
chart	carta
chart ; nautical chart	cartas náuticas ; carta náutica
cheers ; thank you ; thanks	obrigado ; obrigada
cheese	queijo
cheetah ; chetah	chita
chelicerate	quelíceras
chemical	substâncias químicas ; substância química
chemical addition	adição
chemical analysis	análises químicas
chemical composition	composição química
chemical contamination	contaminação química
chemical corrosivity	corrosividade química
chemical decontamination	descontaminação química
chemical element ; element	elementos químicos ; elemento químico
chemical fallout	fallout químico
chemical fertiliser	fertilizantes químicos
chemical in the environment	substâncias químicas no ambiente
chemical industry	indústria química
chemical installation	instalações químicas
chemical measurement of pollution	medição química da poluição
chemical oxygen demand	carência química de oxigénio
chemical pest control	controlo químico de pragas
chemical plant	fábricas de produtos químicos
chemical policy	químicos (política)
chemical pollutant	poluentes químicos
chemical pollution	poluição química
chemical process	processos químicos
chemical product	produtos químicos
chemical property	propriedades químicas
chemical reaction	reacções químicas
chemical reduction	redução (química)
chemical risk	riscos químicos
chemical structure	estrutura química
chemical treatment	tratamento químico
chemical waste	resíduos químicos
chemical weapon	armas químicas ; arma química
chemicals act	substâncias químicas (legislação)
chemisorption	adsorpção química
chemist ; pharmacist	farmacêutico
chemist's ; chemist's shop ; pharmacy	farmácia
chemistry	química
cherry	cereja
chess	xadrez
chestnut	castanhas
chicken	galinha
child	infância ; criança
chimney	chaminés
chimney height	altura das chaminés
chimpanzee	chimpanzé ; chimpancé
chipmunk	tâmia
chiropteran	quirópteros
chloride	cloreto de sódio ; cloreto
chlorinated hydrocarbon	hidrocarbonetos clorados
chlorination	cloragem
chlorine	cloro
chlorophenol	clorofenóis
chlorophyll	clorofila
chlorosis	clorose
chocolate	chocolate
cholesterol	colesterol
chordate	cordados
chorology	corologia
chromatographic analysis	análises cromatográficas
chromatography	cromatografia
chromium	crómio
chrysophyta	Crisófita
church	igrejas
cigar	charuto
cigarette	cigarro
cinematographic film	película cinematográfica
circular mail	circulares (correio)
citizen	cidadãos
citizen awareness	consciência do cidadão
citizen initiative	iniciativa dos cidadãos
citizen rights	direitos do cidadão
city	cidades ; cidade
city centre	centro da cidade
civil air traffic	tráfego aéreo civil
civil engineering	engenharia civil
civil law	Direito civil
civil safety	segurança civil
civilian protection	protecção civil
claim for restitution	pedido de restituição
clarinet	clarinete ; clarineta
classification	classificação
clay	argila
clean air area	zonas de ar não poluído
clean air car	automóveis não poluentes
clean technology	tecnologias limpas ; tecnologia limpa
cleaning up	limpeza
cleanliness	asseio
cleansing department	serviços de limpeza
clearing sludge	separação de lamas (tratamento)
cliff	penhascos
climate	clima
climate protection	protecção do clima
climate resource	recursos climáticos
climate type	tipos de clima
climatic alteration	alterações climáticas
climatic change ; climate change	variação climática
climatic effect	efeitos climáticos
climatic experiment	experiências climáticas
climatic zone	zonas climáticas
climatology	climatologia
climax	climax
climbing plant (wall) ; climbing plant	plantas trepadeiras
clinical symptom	sintomas clínicos
cloning	clonagem
closing down	encerramento
closing down of firm	encerramento de firmas
clothing ; apparel	vestuário
clothing industry	indústria do vestuário
cloud	nuvem ; nuvem
co-incineration	co-incineração
co-operation	cooperação
co-operation policy	política de cooperação
co-operation principle	princípio de cooperação
co-ordinate system	sistemas de coordenadas
co-ordination	coordenação
coagulation	coagulação
coal	carvão
coal industry	indústria do carvão
coal liquefaction	liquefacção de carvão
coal mining	extracção de carvão
coal refining	refinação de carvão
coal technology	tecnologia do carvão
coal-based energy	energia térmica (carvão)
coal-fired power plant	centrais térmicas (carvão)
coast	costa
coast protection	protecção da costa
coastal area	zonas costeiras
coastal development	desenvolvimento costeiro
coastal ecosystem	ecossistema costeiro
coastal environment	ambiente costeiro
coastal fishing	pesca costeira
coastal pollution	poluição costeira
coastal water	águas costeiras
coastal zone planning	planeamento da zona costeira
coastguard	guarda costeira
coating	revestimento
cobalt	cobalto
cobweb	teia de aranha
cocaine	cocaína
cockroach	baratas ; barata
code	código
code of practice	código de conduta
codification	codificação
coelenterate	celenterados
coffee	café ; kawa
cogeneration	cogeração
coin ; money	moeda
coke	coque
cold	frio
coliform bacterium	bactérias coliformes
colina ; hill ; loma	colinas ; colina
collective wastewater treatment	tratamento  unitário de águas residuais
colloid	colóide
colloidal state	estado coloidal
colonisation	colonização
colony	colônia
colour ; colour ; colo(u)r	cor ; cor ; cor
colour composition	composição da cor
colourimetry	colorimetria
colubrid	colubrídeos
combination effect	efeitos combinados
combined cycle-power station	centrais combinadas
combined sewer system	águas residuais (sistema unitário)
combined transport	transporte combinado
combined waste water	águas residuais mistas
combustibility	inflamabilidade
combustion engine	motores de combustão
combustion gas	gases de combustão
combustion residue	resíduos de combustão
come	vir
comet	cometa
commercial fishery	pesca comercial
commercial law	Direito comercial
commercial noise	ruído do comércio
commercial traffic	tráfego comercial
commercial transaction	transacção comercial
commercial vehicle	veículos comerciais
commercialisation	comercialização
common agreement	acordos
common agricultural policy ; common agricultural policy of the EU	política agrícola comum
common commercial policy	política comercial comum
common tariff policy	política aduaneira comum
communications	comunicação
communications industry	indústria das comunicações
communications policy	política das comunicações
communications system	sistemas de comunicações
communism	comunismo
community facility ; public facility	recursos colectivos
community-pays principle	princípio do pagador comunitário
commuter traffic	tráfego domicílio-trabalho
compaction	compactação
company policy	política das companhias
company structure	estrutura empresarial
comparative law	Direito comparado
comparative test	testes comparativos
comparison	comparação
compensation	compensação
compensation for damage	compensação por danos
compensatory measure	medidas compensatórias
compensatory tax	taxas compensatórias
competition	competição biológica
competition law	direito da concorrência
competitive examination	exames (educação)
competitiveness	competitividade
complex formation	complexação
complexing agent	agentes complexantes
composite pollution	poluição combinada
composition of population	composição da população
compost	composto
compostable waste	resíduos compostáveis
composting	compostagem
composting by producer	compostagem pelo produtor
compound ; chemical compound	composto ; composto químico
compression	compressão
compressor	compressor
computer	computador
concentration	concentração
concept of environment	conceito de ambiente
concession	concessão
concrete	betão
concrete products industry	indústria de produtos de cimento
condensation (process) ; condensation	condensação (processo) ; condensação
condom ; prophylactic ; rubber ; safe ; safety	preservativo ; preservativo
conductivity ; electrical conductivity	condutividade ; condutividade elétrica
conference	conferência
conflict	conflitos ; conflito
conflict of aims	conflito de objectivos
conflict of interests	conflito de interesses
conflicting use	conflito de utilização
congress	congressos
conifer	coníferas
coniferous forest	floresta de coníferas
coniferous tree	árvores coníferas
conservation	conservação (processo industrial) ; conservação
conservation of monuments	conservação de monumentos
conservation policy	política de conservação
constellation	constelação
constitutional law	Direito constitucional
constructed language ; artificial language	língua artificial
construction equipment	equipamento de construção
construction noise	ruído de construção
construction policy	política de construção
construction technology	tecnologia de construção
construction with recycled material	construção com materiais reciclados
construction work	trabalho de construção
consultancy	consultas
consultation	consultadoria
consume ; eat ; swallow	comer
consumer behaviour	comportamento do consumidor
consumer goods	bens de consumo
consumer group	associações do consumidor
consumer information	informação ao consumidor
consumer product	produtos de consumo
consumer protection	defesa do consumidor
consumer waste	resíduos do consumidor
consumption	consumo
consumption pattern	padrões de consumo
container	contentores
containment (nuclear industry) ; containment	contenção (indústria nuclear) ; contenção
contaminated soil	solos contaminados
contamination	contaminação
continent	continentes ; continente
continental climate	clima continental
continental shelf	plataforma continental
continuing education	educação permanente
continuous load	poluição contínua
contour farming	plantações em socalcos
contract	contratos
control measure	medidas de controlo
controlled burning	fogos controlados
controlled hunting zone	áreas de caça controladas
controlling authority	entidades fiscalizadoras
conurbation	conurbação
convention	convenções
conventional energy	energia convencional
cooling	arrefecimento
cooling oil	óleos de arrefecimento
cooling tower	torres de arrefecimento
cooling water	águas de arrefecimento
copper	cobre
coppice	arvoredo (talhadia)
coppice with standards	arvoredo (talhadia composta)
coral	corais
coral reef	recifes de coral
coral reef lagoon	lagoas de recifes de coral
core meltdown	fusão do núcleo
cork	cortiça
corridor	corredores ecológicos ; corredor ecológico
corrosion	corrosão
corrosion inhibitor	produtos anti-corrosivos
corruption	corrupção
cosmetic industry	indústria de cosméticos
cosmic radiation	radiação cósmica
cosmology	cosmologia
cost	custos
cost increase	aumento de custos
cost reduction	redução de custos
cost-benefit	custo-benefício
cost-benefit analysis	análise custo-benefício
cotton	algodão
country ; nation ; state	Estado ; estado ; país ; nação
country lodge	casas de campo
county	condado
court	tribunal
court of justice	tribunal de justiça
cove	desfiladeiro
covering ; roofing	cobertura
cow	vaca
craft ; arts and crafts	artes e ofícios ; artesanato
creativity ; inventiveness	criatividade
credit	crédito
credit assistance	assistência ao crédito
credit policy	política de crédito
creek	enseadas
crime	crimes
criminal law	Direito penal
criminal law procedure	processos penais
criminal liability	responsabilidade criminal
criminality	criminalidade
crisis management	gestão de crises
critical level	nível crítico
critical load	carga crítica
crocodile	crocodilos
crop production	produção de culturas
crop protection	protecção das culturas
crop rotation	rotação de culturas
crop treatment	tratamento de culturas
crossing place	locais de travessia
crossing place for animals	locais de travessia para animais
crossword	palavras cruzadas
crucifix	crucifixo ; rosário
crude oil	crude
cruising	cruzeiros
crustacean	crustáceos
cryptogam	criptogâmicas
crystal	cristal
crystallisation	cristalização
crystallography	cristalografia
cucumber	pepino
cultivated plant	plantas cultivadas
cultivation ; tillage	cultivo
cultivation method	métodos de cultivo
cultivation of agricultural land	cultivo de terrenos agrícolas
cultivation system	sistemas de cultivo
cultural development	desenvolvimento cultural
cultural facility	infra-estruturas culturais
cultural heritage	património cultural
cultural indicator	indicadores socio-culturais
cultural policy	política cultural
culture	cultura
curium	cúrio
currency	divisa
curriculum	curricula
customs	alfândega
customs regulation	regulamentos aduaneiros
customs tariff	pautas aduaneiras
cutting	abate
cutting ; cutting (vegetative propagation)	estacas (agricultura) ; estacas ; muda
cyanate	cianato
cyanide	cianetos ; cianeto
cycle path	caminhos para ciclistas
cyclone	ciclone
cytology	citologia
cytotoxicity	citotoxicidade
dairy farm	exploração leiteira
dairy industry	indústria de lacticínios
dairy product	produtos lácteos
dam	barragens
dam draining	drenagem de barragens
damage	danos
damage assessment	avaliação de danos
damage from military manoeuvres	manobras militares (danos)
damage insurance	seguros contra danos
damage prevention	prevenção de danos
dance	dança
danger analysis	análise de perigo
dangerous goods	produtos perigosos
dangerous goods law	produtos perigosos (legislação)
dangerous goods regulation	regulamentos de produtos perigosos
dangerous installation	instalações perigosas
dangerous materials transport	transporte de substâncias perigosas
darmstadtium	darmstádtio ; darmstádio
data acquisition	aquisição de dados
data analysis	análise de dados
data carrier	suporte de dados
data centre	centros de dados
data exchange	intercâmbio de dados
data on the state of the environment	estado do ambiente (dados)
data processing	processamento de dados
data processing law	processamento de dados (legislação)
data processing system	sistemas de processamento de dados
data protection	protecção de dados
data recording technique	técnicas de registo de dados
database	bases de dados
dating	datação
daughter	filha
day ; daytime	dia
dazzle	encandear
de-inking	remoção de tintas
deaf	surda ; surdo
death penalty ; capital punishment ; death sentence	pena de morte ; pena capital
debit	debitar
debt	dívidas ; dívida
debt service	serviço de dívida
decay product	produtos de decaímento
decentralisation	descentralização
dechlorination	descloração
decibel	decibéis
deciduous forest ; deciduous wood	floresta caducifólia
deciduous tree	árvores de folhas caducas
decision	decisões ; decisão
decision making support	apoio à decisão
decision process	processo de decisão
decision-support system	sistemas de apoio à decisão
declaration ; statement	declaração
declaration of public utility	declaração de utilidade pública
decomposition	decomposição
decontamination	descontaminação
decree	decretos ; decreto
deep sea	alto mar
deep sea fishing	pesca do alto
deep sea mining	extracção mineira marítima
deep-sea disposal	descargas em alto mar
deer	veados
defence	defesa nacional
defendant ; accused	acusado
deflation	deflação
defoliation	desfoliação
deforestation	desflorestação
degradability	degradabilidade
degradation	degradação
degradation of natural resources	degradação dos recursos naturais
degradation of the environment	degradação do ambiente
degradation product	produtos de degradação
degreasing	desengorduramento
dehydrated sludge	lamas desidratadas
delegated management	administrador delegado
deliver	parir
delta	deltas
demand	procura (economia) ; procura
demesnial water	domínio hídrico
democracy	democracia
demographic development	desenvolvimento demográfico
demographic evolution	evolução demográfica
demography	demografia
demolition business	empresas de demolição
demolition waste	resíduos de demolição
demonstrability	demonstrabilidade (ciência)
dendrochronology ; tree-ring dating	dendrocronologia
dendrometry	dendrometria
dengue fever	dengue
denitrification	desnitrificação
denitrification of waste gas	desnitrificação de gás residual
density	densidade
dentist	dentista
dentistry	odontologia
deposition	deposição (poluição)
deregulation	desregulamentação
dermatology	dermatologia
desalination	dessalinização
desalination plant	instalações de dessalinização
desert	deserto
desert climate	clima desértico
desert locust	gafanhotos do deserto
desertification	desertificação
desertification control	controlo da desertificação
design (project) ; design ; project design	desenho (projectos) ; desenho
desk study	estudos teóricos
desorption	dessorção
destination of transport	destino dos transportes
desulphurisation	dessulfurização
desulphurisation of fuel	dessulfurização de combustíveis
detection	detecção
detector	detectores
detergent	detergentes
determination method	métodos de determinação
deterrence	dissuasão (administração)
deterrent	dissuasor
detoxification	desintoxicação
deuterium	deutério
developed country	países desenvolvidos
developing country	países em desenvolvimento
development aid	apoio ao desenvolvimento
development area	áreas de desenvolvimento
development co-operation	cooperação para o desenvolvimento
development model	modelos de desenvolvimento
development pattern	padrões de desenvolvimento
development plan	planos de desenvolvimento
devolution	descentralização de poderes
dialect	dialeto
dialysis	diálise
diarrhea	diarreia
diary	diário
diatom	diatomáceas
dice ; die ; die ; die	dado
dictionary	dicionário
didactics	didáctica
diesel engine	motores diesel
diesel fuel ; diesel	gasóleo
differentiation	diferenciação (biologia) ; diferenciação
difficult	difícil
diffuse pollution	poluição difusa
diffuse source	fontes difusas
diffusion	difusão
digested sludge	lamas digeridas
digester	digestores
digestion	digestão anaeróbia
digital image processing technique	técnicas de processamento de imagens digitais
digital land model	modelos terrestres digitais
digitising	digitalização de informação
diluted acid	ácido diluído
diocese ; diocese	diocese
dioxin	dioxina
diplomat	diplomata
dipteran	dípteros
direct discharger	descarregadores directos
directive	directivas
disabled person	deficientes ; deficiente
disaster	catástrofes ecológicas
disaster cleanup operation	operações de limpeza
disaster contingency plan	planos de acção (catástrofes)
disaster control service	serviços de emergência
disaster preparedness	preparação para emergências
disaster prevention	prevenção de catástrofes
disaster relief	assistência em caso de catástrofe
disaster zone	zonas de catástrofes
discharge regime	regime de descargas
discount	desconto
discrimination	discriminação
disease ; illness ; affliction	doenças ; doença
disease cause	causas de doença
disinfectant	desinfectantes
disinfection	desinfecção
dispatch note	notas de expedição
dispersion	dispersão (processos físico-químicos) ; dispersão
dispersion calculation	cálculos de dispersão
displaced person	refugiados políticos
disposal of the dead	deposição de cadáveres
disposal of warfare materials	eliminação de material de guerra
dissolution	dissolução
dissolved organic carbon	carbono orgânico dissolvido
dissolved oxygen	oxigénio dissolvido
distillation	destilação
distortion of competition	distorção da concorrência
distribution	distribuição
distribution area	áreas
distributive trade	comércio de distribuição
district heating	aquecimento distrital
district heating plant	centrais de aquecimento distrital
disused military site	zonas militares desactivadas
ditch	valas ; vala
divorce	divórcio
do	fazer
doctrine	doutrina
document	documentos
document lending	empréstimo de documentos
document type	tipos de documento
documentary film	documentários ; documentário
documentary system	sistemas documentais
documentation	documentação
documentation centre	centros de documentação
dog	cão ; cachorro
doll	boneca
dolphin	golfinho
domestic appliance	utensílos domésticos
domestic fuel	combustíveis domésticos
domestic fuel oil	fuelóleo doméstico
domestic noise	ruído doméstico
domestic pollution	poluição doméstica
domestic trade	comércio interno
domestic waste	resíduos domésticos
domestic waste landfill	aterros de resíduos domésticos
domestic waste water	águas residuais domésticas
domesticated animal	animais domesticados
donation	doação
donkey ; ass	asno
door	porta
dosage	dosagens
dose	dose
dose-effect relationship	relação dose-efeito
draft legislation	legislação (projectos)
dragonfly	libélulas ; libélula
drainage	drenagem
drainage system	sistemas de drenagem
drainage water	águas de drenagem
draining	escoamento
draught animal	animais de tiro
dream	sonhar
dredged material	resíduos de dragagem
dredging	dragagem
dress	vestido
dress ; clothe	vestir
drift net fishing	pesca de arrasto
drilling	perfuração
drilling for oil	perfuração petrolífera
drilling installation	torres de perfuração
drink ; gulp ; quaff ; sip	beber ; tomar
drinking water	água potável
drinking water protection area	depósitos de água potável (área protegida)
drinking water supply	abastecimento de água potável
drinking water treatment	tratamento de água potável
dromedary	dromedário
drought	secas
drought control	controlo de secas
drug	produtos farmacêuticos
drum kit	bateria
drunk ; drunkard ; boozer	bêbado ; borracho
dry	seco ; seca
dry cleaning	limpeza a seco
dry deposition	deposição por via seca
dry farming	culturas de sequeiro
dry lawn	relvados secos
drying	secagem
drying out	ressecação
dual economy	economia dual
dual waste management	gestão dupla de resíduos
dubnium	dúbnio
duck	pato
dumb	mudo
dumping	descargas não controladas
dune	dunas
durable goods	bens duradouros
duration of sunshine	duração da luz do sol
dust	poeiras ; pó ; poeira
dust removal	remoção de poeiras
dwelling	habitação
dye	corantes têxteis
dyke	diques
dyke reinforcement	reforço de diques
dyslexia	dislexia
dysprosium	disprósio
ear	orelha
early	cedo
early warning system	sistemas de alerta (imediato)
earth ; Earth ; the world ; Blue Planet	Terra
earth science	ciências da terra
earth's crust ; crust ; Earth's crust	crosta terrestre
earthquake	sismos ; sismo
earthworm	minhocas
earwig	bichas-cadelas
easement	servidão (legal)
easy ; piece of cake ; like shooting fish in a barrel	fácil
eat	comer
echinoderm	equinodermos
eco-paediatrics	doenças ambientais (pediatria)
ecocatastrophe	ecocatástrofes
ecodevelopment	ecodesenvolvimento
ecolabel	rótulo ecológico
ecolabelling	rotulagem ecológica
ecological abundance	abundância ecológica
ecological adaptation	adaptação de espécies
ecological assessment	avaliação ecológica
ecological balance	equilíbrio ecológico
ecological bookkeeping	registo de espécies
ecological carrying capacity	capacidade ecológica sustentada
ecological community	comunidades ecológicas
ecological factor	factores ecológicos
ecological inequality	desigualdade ecológica
ecological niche	nicho ecológico
ecological parameter	parâmetros ecológicos
ecological stocktaking	inventariação ecológica
ecologically sensitive area	zonas ecológicas sensíveis
ecologist movement	movimentos ecológicos ; movimento ecológico
ecology	ecologia
ecomarketing	ecomarketing
ecomuseum	museus ecológicos
economic activity	actividades económicas
economic analysis	análise económica
economic competition	competição económica
economic concentration	concentração económica
economic data	dados económicos
economic development	desenvolvimento económico
economic forecasting	previsão económica
economic geography	geografia económica
economic growth	crescimento económico
economic incentive	incentivos económicos
economic instrument	instrumentos económicos
economic management instrument	instrumentos de gestão económica
economic plan	planos económicos
economic planning	planeamento económico
economic policy	política económica
economic region	regiões económicas
economic rights	direitos económicos
economic science ; economics	economia ; economia (ciência)
economic sector	sector económico
economic situation	situação económica
economic structure	estrutura económica
economic support	apoio económico
economic system	sistemas económicos
economic theory	teoria económica
economic trend	tendências económicas
economic viability	viabilidade económica
economical-ecological efficiency	eficiência económico-ecológica
economy	economia
ecophysiology	ecofisiologia
ecosystem	ecossistemas
ecosystem analysis	análise de ecossistemas
ecosystem degradation	degradação de ecossistemas
ecosystem research	investigação de ecossistemas
ecosystem type	tipos de ecossistemas
ecotourism	ecoturismo
ecotoxicity	ecotoxicidade
ecotoxicological evaluation	avaliação ecotoxicológica
ecotoxicology	ecotoxicologia
ecotype	ecotipos
ecozone	zonas ecológicas
edaphology	edafologia
edible	comestível
edible fat	gorduras e óleos alimentares
education	educação
education policy	política educativa
educational institution	estabelecimentos de ensino
educational path	percursos educativos
educational planning	planeamento educativo
educational system	sistemas educativos
effect	efeitos
effect on health	efeitos na saúde
effect on man	efeitos no homem
effect on the environment ; environmental consequence	consequências ambientais ; efeitos no ambiente
efficiency criterion	critérios de eficácia
efficiency level	níveis de eficácia
effluent	efluentes
effort ; exertion	esforço
egg	ovos ; ovo
eight	oito
einsteinium	einstêinio ; einstênio
ejaculation	ejaculação
elasticity	elasticidade
elbow	cotovelo
elderly person	terceira idade
electric battery	pilhas eléctricas
electric line ; power line	linhas eléctricas
electric power	energia eléctrica ; potência eléctrica
electric power plant	centrais eléctricas
electric power supply	energia eléctrica (fornecimento)
electric vehicle	veículos eléctricos
electrical engineering	engenharia electrotécnica
electrical goods industry	indústria do material eléctrico
electrical industry	indústria da energia eléctrica
electricity	electricidade
electricity company	companhias de electricidade
electricity consumption	consumo de electricidade
electricity generation	produção de energia eléctrica
electricity generation cost	energia eléctrica (custos de produção)
electricity supply industry	indústria da energia eléctrica (distribuição)
electrokinetics	electrocinética
electrolysis	electrólise
electromagnetism	electromagnetismo
electron	elétron
electronic information network	redes electrónicas de informação
electronic mail ; email ; e-mail	correio electrónico
electronic material	materiais electrónicos
electronic scrap	sucata electrónica
electronic scrap regulation	sucata electrónica (regulamento)
electronics	electrónica
electrosmog	nevoeiro eléctrico
electrotechnical equipment	equipamento electrotécnico
electrotechnical industry	indústria electrotécnica
element of group 0 ; noble gas	elementos do grupo 0 ; elemento do grupo 0
element of group II (alkaline earth metals) ; alkaline earth metal ; element of group II	elementos do grupo II (metais alcalino-terrosos) ; elementos do grupo II ; metais alcalino-terrosos ; metal alcalino-terroso ; elemento do grupo II
element of group III	elementos do grupo III ; elemento do grupo III
element of group IV	elementos do grupo IV ; elemento do grupo IV
element of group V	elementos do grupo V ; elemento do grupo V
element of group VI	elementos do grupo VI ; elemento do grupo VI
element of group VII ; halogen	elementos do grupo VII ; elemento do grupo VII
elephant	elefante
emancipation	emancipação
embassy ; diplomatic mission	embaixada
embryo	embriões
embryogenesis	embriogénese
emergency	emergência
emergency law	legislação de emergência
emergency plan	planeamento de emergência
emergency relief	assistência à emergência
emergency shelter	abrigos de emergência
emission	emissões
emission control	controlo de emissões
emission data	dados de emissões
emission factor	factores de emissões
emission forecast	previsão de emissões
emission reduction	redução de emissões
emission reduction banking	redução de emissões (registo)
emission register	registo de emissões
emission situation	situação de emissões
emission source	fontes de emissão
emission standard	padrões de emissões
emission to water	emissões para cursos de água
employment	emprego
employment ; employment ; job ; job ; occupation ; work ; work	emprego ; emprego ; ocupação ; trabalho ; ofício
employment and environment	emprego e ambiente
employment level effect	níveis de emprego (efeitos)
employment structure	estrutura de emprego
empty	vazio ; vazio ; vazio ; vazio ; vazia ; vazia ; vazia
emulsification	emulsificação
emulsion	emulsão
encapsulation	encapsulamento
encephalitis	encefalite
encyclopaedia	enciclopédias ; enciclopédia
end-of-pipe technology	tecnologias limpas (descargas)
endangered animal species	espécies em vias de extinção (fauna)
endangered plant species	espécies em vias de extinção (flora)
endemic species	espécies endémicas
endocrine system	sistema endócrino
endocrinology	endocrinologia
enemy	inimigo
energy	energia
energy balance	balanço energético
energy consumption	consumo de energia
energy conversion	conversão de energia
energy demand	carência de energia
energy dissipation	dissipação de energia
energy distribution system	distribuição de energia
energy economics	economia de energia
energy efficiency	eficácia energética
energy industry	indústria energética
energy legislation	energia (legislação)
energy management	gestão de energia
energy market	mercado energético
energy policy	política energética
energy process	processo energético
energy production	produção de energia
energy resource	recursos energéticos
energy saving	poupanças de energia
energy source	fontes de energia
energy source material	fontes de energia (recursos)
energy storage	armazenagem de energia
energy supply	fornecimento de energia
energy technology	tecnologia energética
energy type	tipos de energia
energy utilisation ; energy use	utilização de energia
enforcement	cumprimento (legal)
engine	motores
engineer	engenheiro
engineering	engenharia
engineering work	trabalho de engenharia
enjoy your meal ; have a nice meal	bom proveito
enlargement policy	política de alargamento
enlargement programme	programas de alargamento
enriched uranium	urânio enriquecido
enrichment	enriquecimento (nutrientes)
enter	entrar
enterovirus	enterovírus
entrepreneur	empresário
environment	ambiente
environment friendly	amigo do ambiente
environment market	mercado de ambiente
environmental accident	acidentes ambientais
environmental accounting	contabilidade do ambiente
environmental administration institution	instituições ambientais
environmental analysis	análises ambientais
environmental anxiety	ânsia ambiental
environmental aspect of human settlements	aspectos ecológicos das povoações
environmental assessment	avaliação ambiental
environmental assessment criterion	critérios de avaliação ambiental
environmental auditing	auditorias ambientais
environmental awareness	consciência ambiental
environmental change	alterações ecológicas
environmental chemicals legislation	substâncias químicas presentes no ambiente (legislação)
environmental chemistry	química ambiental
environmental citizenship	cidadania ambiental
environmental compatibility	compatibilidade ambiental
environmental consequence	consequências ambientais
environmental conservation	conservação do ambiente
environmental contingency planning	catástrofes ambientais (planeamento de intervenção)
environmental control	controlo ambiental
environmental cost	custos ambientais
environmental crime	crimes ambientais
environmental criminal law	Direito penal do ambiente
environmental criminality	criminalidade ambiental
environmental criterion	critérios ambientais
environmental culture	cultura ambiental
environmental damage	danos ambientais
environmental data	dados ambientais
environmental development	desenvolvimento do ambiente
environmental economic valuation	avaliação económica (ambiente)
environmental economics	economia do ambiente
environmental economics of firms	economia do ambiente (empresas)
environmental economy issue	aspectos económicos (ambiente)
environmental education	educação ambiental
environmental engineering	engenharia do ambiente
environmental enterprise	empresas de ambiente
environmental ethics	ética ambiental
environmental friendly procurement	contratos públicos (tecnologias limpas)
environmental fund	fundos para o ambiente
environmental hazard	perigos ambientais
environmental health	saúde pública (ambiente)
environmental health hazard	perigos ambientais (saúde)
environmental health impact assessment	avaliação de impacte ambiental (saúde)
environmental health protection	protecção do ambiente (saúde)
environmental history	história do ambiente
environmental impact	impacte ambiental
environmental impact of agriculture	impacte ambiental (agricultura)
environmental impact of aquaculture	impacte ambiental (aquicultura)
environmental impact of energy	impacte ambiental (energia)
environmental impact of fishing	impacte ambiental (pescas)
environmental impact of forestry	impacte ambiental (florestas)
environmental impact of households	impacte ambiental (habitação)
environmental impact of industry	impacte ambiental (indústria)
environmental impact of recreation	impacte ambiental (recreio)
environmental impact of tourism	impacte ambiental (turismo)
environmental impact of transport	impacte ambiental (transportes)
environmental impact statement	análise do impacte ambiental
environmental impact study	estudos de impacte ambiental
environmental incentive	incentivos ambientais
environmental index	índices ambientais
environmental indicator	indicadores ambientais
environmental industry	empresas verdes (sector industrial)
environmental informatics	informática ambiental
environmental information	informação ambiental
environmental information network	redes de informação ambiental
environmental information system	sistemas de informação ambiental
environmental investment	investimentos no ambiente
environmental law	Direito do ambiente
environmental law enforcement	legislação de ambiente (cumprimento)
environmental legislation	legislação de ambiente
environmental legislation on agriculture	legislação de ambiente (agricultura) ; legislação ambiental sobre agricultura
environmental legislative process	processos legislativos (ambiente)
environmental liability	encargos ambientais
environmental licence	licenças ambientais
environmental management	gestão do ambiente
environmental medicine	medicina do ambiente
environmental misconduct	comportamento ambiental incorrecto
environmental monitoring	monitorização ambiental
environmental noise	ruído ambiental
environmental occupation	ocupação no ambiente
environmental perception	percepção ambiental
environmental plan	planos de ambiente ; plano ambiental
environmental planning	planeamento ambiental
environmental policy	política de ambiente
environmental policy instrument	instrumentos de política de ambiente
environmental pollution	poluição do ambiente
environmental priority	prioridades ambientais
environmental problem solving	problemas ambientais (resolução)
environmental programme	programas de ambiente
environmental protection	protecção do ambiente
environmental protection agency	agências de protecção do ambiente
environmental protection association	associações de defesa do ambiente
environmental protection cost	custos de defesa do ambiente
environmental protection in the enterprise	defesa do ambiente (empresas)
environmental protection order	protecção do ambiente (legislação)
environmental protection organisation	organizações de defesa do ambiente
environmental protection regulation	regulamentos de defesa do ambiente
environmental protection technology	tecnologia de protecção do ambiente
environmental psychology	psicologia ambiental
environmental quality	qualidade do ambiente
environmental quality criterion	critérios de qualidade do ambiente
environmental quality objective	objectivos de qualidade do ambiente
environmental quality standard	padrões de qualidade do ambiente
environmental report	relatórios de ambiente
environmental research	investigação ambiental
environmental risk	riscos ambientais
environmental risk assessment	avaliação de riscos ambientais
environmental science	ciências do ambiente
environmental security	segurança ecológica
environmental specimen bank	bancos de espécimes ambientais
environmental statement (eco-audit) ; environmental statement ; eco-audit	declaração ambiental (eco-auditoria) ; declaração ambiental ; eco-auditoria
environmental statistics	estatísticas ambientais
environmental stock exchange	bolsa de valores ambientais
environmental study	estudos ambientais
environmental subsidy	subsídios ambientais
environmental sustainable architecture	arquitectura ambiental sustentada
environmental tax	ecotaxas
environmental teaching	ensino ambiental
environmental technology	tecnologia do ambiente
environmental terminology	terminologia do ambiente
environmental training	formação ambiental
environmental warfare	guerra ambiental
environmentalism	ambientalismo
environmentally dangerous substance	substâncias perigosas  (ambiente)
environmentally friendly management	gestão ambientalmente correcta
environmentally friendly product	ecoprodutos
environmentally related disease	doenças ambientais
environmentally responsible behaviour	comportamento ecológico
environmentally unfriendly firm	empresas não amigas do ambiente
enzyme	enzimas
ephemeral	efémero
epicentre	epicentro
epidemic	epidemias
epidemiology	epidemiologia
epilepsy	tpilepsia ; epilepsia
equation	equação
equatorial climate	clima equatorial
equine	equídeos
equipment	equipamentos
equivalent dose	dose equivalente (radiação) ; dose equivalente
erbium	érbio
ergonomics	ergonomia
erosion	erosão
erosion control	controlo de erosão
estate rental	aluguer de imóveis
estimate	estimativa
estuarine biology	biologia estuarina
estuarine conservation area	áreas estuarinas (conservação)
estuary	estuários
estuary pollution	poluição de estuários
etching	decapagem
etching substance	substâncias corrosivas
ethanol	etanol
ether	éter
ethics	ética
ethnography	etnografia
ethnology	etnologia
ethology	etologia
europium	európio
eutrophication	eutrofização
evaluation	avaliação
evaluation criterion	critérios de avaliação
evaluation method	métodos de avaliação
evaluation of technology	avaliação da tecnologia (ciência)
evaporation	evaporação
evapotranspiration	evapotranspiração
evolution	evolução das espécies
exact science	ciências exactas
excavated hole	buracos escavados
excavation (process) ; excavation ; earthworks ; digging	movimentação de terras ; terraplenagem
excavation heap	montículos de detritos de escavação
excavation side	lado da escavação
excavation site	locais de escavação
exception	excepção
exceptional tax	impostos extraordinários
excessive height of chimney stacks	chaminés fabris excessivamente altas
exchange policy	política de trocas
executioner	carnífice
executive order	despachos (administração) ; despachos
exhaust device	tubos de escape
exhaust gas	gases de escape
exhibit	exposição
existing chemical	substâncias químicas existentes
exotic species	espécies exóticas
expenditure	despesas (economia) ; despesas
experiment	experiências (ciência)
experimental study	estudos experimentais
expert system	sistemas periciais ; sistema pericial
exploitation of underground water	extracção de água subterrânea
exploration	exploração
explosion	explosões ; explosão
explosive	substâncias explosivas
export	exportação
export licence	licenças de exportação
export of hazardous wastes	exportação de resíduos perigosos
exposure	exposição (saúde)
expropriation	expropriação
extensive cattle farming	criação extensiva de gado
externality	externalidades
extinct species	espécies extintas
extinction (ecological) ; extinction	extinção (ecológica) ; extinção
extraction	extracção
extractive industry	indústria extractiva
eye	olho
eyebrow	sobrancelha
fabric	produtos têxteis ; tecido
face	cara ; face ; rosto
facility	facilidade
factor market	mercado de factores de produção
factory farming	complexo agroindustrial
faecal bacterium	bactérias fecais
fallout	fallout
fallow area	pousio
family	família
family law	Direito da família
family planning	planeamento familiar
famine	fome
farm	quintas ; quinta
farm animal	animais domésticos
farm building	edifícios rurais
farm price	preço de produtos agrícolas
farming technique	técnicas agrícolas
fascism	fascismo
fast reactor	reactores rápidos
fast traffic	tráfego rápido
fat ; obese	gordo ; obeso
father	pai ; painho ; papá ; papai
fault	falha (litosfera) ; falha
fauna	fauna
fauna restoration	recuperação da vida selvagem
feather	pena
federal authority	autoridades federais
federal government	governo federal
federal law	legislação federal
fee	remunerações
feeding of animals	alimentação de animais
feeling for nature	respeito pela natureza
felid	felinos
female ; woman	mulher
fen	paúis
fermentation	fermentação
fermium	férmio
fern	pteridófitas
ferry	balsa
fertilisation ; fecundation	fecundação
fertiliser	fertilizantes
fertiliser law	fertilizantes (legislação)
fibre	fibras
fibreglass	fibra de vidro
field ; land ; land ; acre ; patch	campos
field damage	deterioração de terrenos
field experiment	experiências de campo
field study	estudos de campo
filling material	materiais de enchimento
filling station	bombas de gasolina
film	filmes ; filme ; filme ; filme ; filme ; filme ; filme ; filme ; filme ; filme ; filme ; filme ; filme ; filme ; filme ; filme ; filme ; filme ; filme
film	filmes ; filme ; filme ; filme ; filme ; filme ; filme ; filme ; filme ; filme ; filme ; filme ; filme ; filme ; filme ; filme ; filme
filter	filtros
filter cake	bolo de filtração
filtration	filtração
final storage	armazenagem final
finances	finanças
financial aid	ajuda financeira
financial assistance	apoio financeiro
financial compensation	compensação financeira
financial contribution	contribuição financeira
financial fund	fundos financeiros
financial instrument	instrumentos financeiros
financial law	legislação financeira
financial management	gestão financeira
financial market	mercado financeiro
financing	financiamento
fine	coimas
fine dust	pó fino
finger	dedo ; dedo ; dedo da mão
fire	fogo ; incêndio
fire precaution	prevenção de incêndios
fire protection	protecção contra incêndios
fire safety requirement	segurança contra incêndios
fire service	bombeiros
firefighter ; fireman ; firewoman ; fire fighter ; fire-eater	bombeiro
fireproofing agent	agentes anti-fogos
firework	fogo de artifício
firing	cozedura
firm ; corporation ; enterprise ; company ; venture	empresas
first	primeiro ; primeira
fish	peixes ; peixe
fish disease	doenças dos peixes
fish farming	viveiros de peixes
fish kill	mortandade de peixes
fish stock	existências de peixe
fish toxicity	toxicidade do peixe
fisheries management	gestão das pescas
fisheries structure	estrutura das pescas
fishery	pescaria
fishery economics	economia das pescas
fishery policy	política de pescas
fishery resource	recursos de pesca
fishing	pescas
fishing ground	pesqueiros
fishing industry	indústria pesqueira
fishing law	pescas (legislação)
fishing licence	licenças de pesca
fishing preserve	áreas de pesca protegidas
fishing vessel	embarcações de pesca
fitting (plumbing) ; fitting ; plumbing equipment ; plumbing fixtures	canalizações
five	cinco
flag of convenience	bandeira de conveniência
flammable product	produtos inflamáveis
flaring	chaminés (indústria)
flavouring	aromatizantes
flea	pulgas ; pulga
flexible approach to environmental protection	protecção do ambiente (instrumentos)
flint ; flintstone	sílex
flocculant	floculadores
flocculation	coagulação-floculação
flood	cheias
flood control	controlo de cheias
flood forecast	previsão de cheias
flood protection	protecção contra cheias
flood runoff	runoff superficial (cheias)
flooding	inundações
flora (biology) ; flora	flora
flora (document) ; flora	flora ; flora (sistemática)
flora restoration	recuperação do coberto vegetal
flotation	flotação
flow	fluxos ; fluxo
flow field	campo de fluxo
flower ; bloom ; blossom	flor
flowering plant	plantas de flor
flowing water	água corrente
flue gas	gás de fornalha
fluidics	mecânica de fluidos
fluidisation	fluidificação
fluidised bed	leitos fluidificados
fluoridation	fluorização
fluorine	flúor
flushing	lavagem a jacto
flute	flauta
fluvial resource	recursos fluviais
fly ash	cinzas volantes
foaming agent	agentes espumíferos
fodder ; provender ; forage	forragens
fodder plant	plantas forrageiras
fog	nevoeiro
foliage	folhagem
folk tradition	tradição popular
folklore	folclore
food	alimentos ; comida
food additive	aditivos alimentares
food chain	cadeias alimentares
food commerce	comércio de alimentação
food contamination	contaminação de alimentos
food hygiene	higiene alimentar
food industry	indústria da produção alimentar
food irradiation	irradiação de alimentos
food pollutant	poluentes de alimentos
food preservation	conservação de alimentos
food processing industry	indústria de processamento de alimentos
food production (agriculture) ; food production	produção de alimentos (agricultura) ; produção de alimentos
food quality	qualidade dos alimentos
food requirement	necessidades alimentares
food science	bromatologia
food storage	armazenagem de alimentos
food technology	tecnologia alimentar
food transport	transporte de alimentos
foodstuff	produtos alimentares
foot	pé
football	futebol
footpath	trilhos ; trilho
forage contamination	contaminação de forragens
forage crop	culturas forrageiras
forage law	forragens (legislação)
ford	vau
forecast	previsão (ciência)
foreclosure	execução hipotecária
foreign	estrangeiro
foreign economic relations	relações económicas externas
foreign policy	política externa
foreign trade	comércio externo
forest	florestas ; floresta
forest biological reserve	reservas biológicas (florestas)
forest cover destruction	destruição das florestas
forest damage	danos florestais
forest deterioration	deterioração das florestas
forest ecology	ecologia florestal
forest ecosystem	ecossistema florestal
forest exploitation	exploração florestal
forest fire	incêndios florestais
forest industry	indústria florestal
forest management	gestão florestal
forest pest	pragas florestais
forest policy	política florestal
forest product	produtos florestais
forest production	produção florestal
forest protection	protecção florestal
forest reserve	reservas florestais
forest resource	recursos florestais
forestry	silvicultura
forestry economics	economia florestal
forestry law	Direito florestal
forestry legislation	legislação florestal
forestry practice	prática florestal
forestry unit	unidades florestais
fork	garfo
form of government	formas de governo
forwarding agent	transitários
fossil	fósseis
fossil fuel	combustíveis fósseis
fouling growth	incrustação biológica (navios)
fountain	fontes (água) ; fontes
four	quatro
four stroke engine	motores a quatro tempos
fracture	fractura
framework legislation	lei orgânica
francium	frâncio
fraud	fraude
free movement of capital	livre circulação de capital
free trade	comércio livre
freedom	liberdades civis
freedom ; liberty	iberdade ; liberdade
freedom of speech ; freedom of speech	liberdade de expressão
freight transport	transporte de carga
freon	fréons
freshwater	água doce
freshwater degradation	degradação da água doce
freshwater ecosystem	ecossistema de água doce
freshwater organism	organismos de água doce
freshwater pollution	poluição da água doce
freshwater resource	recursos de água doce
frog	rãs
frost	geada
fruit	fruta
fruit cultivation	fruticultura
fruit tree	pomares
fuel	combustíveis
fuel additive	aditivos de carburantes
fuel alcohol	álcoois combustíveis
fuel cell	célula combustível
fuel composition	composição dos combustíveis
fuel consumption	consumo de combustível
fuel oil	fuelóleo
fuel tank installation	depósitos de combustível (montagem)
fuel wood	lenha
full	cheio
fume	vapores
fumigation	fumigação
functional substance	agentes protectores (substâncias preservantes)
fundamental	fundamental
funeral	funeral
fungicide	fungicidas ; fungicida
fungus	fungos ; fungo
fur	peles
fur animal	criação de animais (peles)
furan	furano
furnace	fornalhas
furniture	mobiliário
furniture industry	indústria do mobiliário
furriery	pelarias
gadolinium	gadolíneo ; gadolínio
gallbladder	vesícula biliar
gallinacean	galináceos
gallium	gálio
galvanisation	galvanização
game	jogos
game	animais de caça
gamma radiation	radiação gama
gangrene	gangrena
garage	garagem
garden	jardim
garden waste	resíduos de jardins
gardener	jardineiro
gas	gás
gas chromatography	cromatografia de gás
gas company	companhias de gás
gas engine	motores a gás
gas liquefaction	liquefacção de gás
gas mixture	mistura de gás
gas network	redes de gás
gas pipeline	gasoduto
gas powered plant	centrais a gás
gas purification	purificação de gás
gas reservoir	reservatórios de gás
gas supply	fornecimento de gás
gaseous air pollutant	poluentes gasosos
gaseous state	estado gasoso
gasification	gaseificação
gasohol	mistura gasolina-álcool
gasoline engine	motores a gasolina
gastrointestinal tract ; alimentary canal	aparelho digestivo
gastropod	gastrópodes
gaswork	fábricas de gás
gene	genes
genealogy	genealogia
general	generalidades
general	general
general administrative order	despachos administrativos
general chemistry	química geral
general education	educação de base
genetic diversity	diversidade genética
genetic effect	efeitos genéticos
genetic engineering	engenharia genética
genetic engineering legislation	engenharia genética (legislação)
genetic information	informação genética
genetic modification	modificação genética
genetic pool ; gene pool	bancos de genes (global)
genetic resource	recursos genéticos
genetic variation	variação genética
genetically modified organism	organismos geneticamente modificados
genetics	genética
genocide	genocídio
genome	genoma
genotoxicity	genotoxicidade
genotype	genótipo
geo-referenced data	dados geo-referenciados
geo-referenced information	informação geo-referenciada
geodesy	geodesia
geogenic factor	factores geogénicos
geographic information system	sistemas de informação geográfica
geographical distribution of population	distribuição geográfica da população
geographical projection	projecções geográficas
geography	geografia
geological disaster	catástrofes geológicas
geological process	processos geológicos
geology	geologia
geometric correction	correcção geométrica
geometry	geometria
geomorphic process	processo geomorfológico
geomorphology	geomorfologia
geophysical environment	ambiente geofísico
geophysics	geofísica
geotechnics	geotecnia
geotechnology	geotecnologia
geothermal energy	energia geotérmica
geranium	gerânio
germ	germes
germ plasm	plasma do germe
germanium	germânio
germination	germinação
geyser	géiser
giraffe	girafa
girl	moça ; menina ; garota
glacier	glaciares ; glaciar
glaciology	glaciologia
gland	glândula
glass	vidro
glass industry	indústria do vidro
glasses ; spectacles	óculos
glaucoma	glaucoma
glaze	gelo vítreo
global aspect	aspectos globais
global convention	convenções globais
global model	modelos globais
global warming	aquecimento global
glossary	glossários
glue	colas
glycolysis	glicólise
go	ir
goal of individual economic business	objectivos micro-económicos
gold	oiro ; ouro
golf	golfe
gonorrhea	gonorréia
good evening	boa tarde
good management	gestão eficiente
goods	bens (economia) ; bens
goods and services	bens e serviços
goose	ganso
gorilla	gorila
government (cabinet)	governo
government advisory body	órgãos consultivos do governo
government building	edifícios governamentais
government liability	responsabilidade governamental
government policy	política governamental
grain	cereais ; cereal
graminaceous plant	gramíneas
grammer ; grammar	gramática
grandchild	neto
grandfather	avô
grandson	neto
granite	granito
granulometry	granulometria
grape	uva
grass	ervas ; erva
grass fire	incêndios de pastagens
grasshopper	gafanhotos
grassland	prados naturais
gravel	cascalho
gravel extraction	extracção de cascalho
gravel pit	saibreira
graviton	gravitão
grazing	pastos
green building	ecoedifícios
green corridor	corredores verdes
green manure	adubos verdes
green revolution	revolução verde
green space	espaços verdes
green tide	marés verdes
green vegetable	vegetais verdes
greenhouse cultivation	estufas
greenhouse effect	efeito de estufa
greenhouse gas	gás de estufa
gridding	execução de grelhas
grinding	trituração
gross national product	produto nacional bruto
groundwater	águas intersticiais
groundwater endangering	águas subterrâneas ameaçadas
groundwater extraction	águas subterrâneas (extracção)
groundwater pollution	poluição de águas subterrâneas
groundwater protection	protecção de águas subterrâneas
groundwater quality	qualidade das águas subterrâneas
group behaviour	comportamento de grupo
guillotine ; guillotine ; guillotine	guilhotina ; guilhotina ; guilhotina
guinea pig	cobaia ; porquinho-da-índia
guitar	guitarra
gulf	golfos
gull	gaivota
gymnosperm	gimnospérmicas
gypsum	gesso
habitat	habitats
habitat destruction	destruição do habitat
haematology	hematologia
haemorrhage ; bleeding	hemorragia
hafnium	háfnio
haiku	Haikai ; Haïku ; Haicai
hail	granizo
hair	pelo ; pêlo
hairdresser ; barber	cabeleireiro
half-life	semivida
haloform	haloformes
halogenated biphenyl	bifenilos halogenados
halogenated compound	compostos halogenados
halogenated hydrocarbon	hidrocarbonetos halogenados
halogenated phenol	fenóis halogenados
halogenated pollutant	poluentes halogenados
handicraft	artesanato
handicraft business	empresas de artesanato
handkerchief	lenço
harbour	portos ; porto
hard disk drive ; hard disk ; HD	disco rígido ; disco duro
hard-to-dispose-of waste	resíduos volumosos
hardness	dureza
harem	harém
harmonisation of law	harmonização da legislação
harpoon	arpão
harvest	colheitas ; colheita
hassium	hássio
hate ; hatred	ódio
hazard	perigos (segurança no trabalho) ; perigo
hazard area	zonas perigosas
hazard of pollutants	perigos dos poluentes
hazardous chemical export	produtos químicos perigosos (exportação)
hazardous substance	substâncias perigosas
hazardous substances legislation	substâncias perigosas (legislação)
hazardous waste	resíduos perigosos
hazardous waste dump	resíduos perigosos (lixeiras)
hazardous working material	materiais de trabalho perigosos
haze	bruma
he	ele
head	cabeça
headland	promontório
headland	cabeceiros
health	saúde
health care	cuidados de saúde
health care profession	profissionais de saúde
health effect of noise	efeitos do ruído na saúde
health facility	estabelecimentos de saúde
health hazard	perigos para a saúde
health legislation	saúde (legislação)
health regulation	regulamentos de saúde
health service	serviços de saúde
health-environment relationship	relações saúde-ambiente
health-related biotechnology	saúde (biotecnologia)
hearing	audição
hearing acuity	acuidade auditiva
hearing impairment	deficiência auditiva
hearing procedure	audiências (justiça)
hearing protection	protecção do ouvido
hearing system	sistema auditivo
heart	coração
heat	calor
heat and power station	centrais termoeléctricas
heat pump	bombas de calor
heat storage	armazenagem de calor
heat supply	fornecimento de calor
heater	aquecedores ; aquecedor
heathen ; infidel ; pagan	pagão
heathland	charnecas
heating	aquecimento
heating plant	centrais de aquecimento
heaven ; sky	céu
heavy	pesado
heavy goods vehicle traffic	transporte de cargas pesadas
heavy metal	metais pesados ; metal pesado
heavy metal load	carga de metais pesados
hedge	sebes
hedgehog	ouriço
hedonism	hedonismo
helicopter	helicóptero
helium	hélio
hello ; hey ; hi ; howdy	olá
herbicide	herbicidas ; herbicida
herbivore ; plant eater	herbívoros ; herbívoro
here	aqui
heroin	heroína
heterocyclic compound	compostos heterocíclicos
hierarchy	hierarquia
high mountain	montanhas altas
high tide water	maré alta
high voltage line	linhas de alta tensão
high-rise building	arranha-céus
high-speed railway	tráfego ferroviário (de alta velocidade)
high-speed train	combóios de alta velocidade ; TGV
higher education	ensino superior
highway	autoestradas
hiking trail	percursos pedestres
historic centre	centros históricos
historical evolution	evolução histórica
historical monument	património histórico
historical research	investigação histórica
historical site	zonas de interesse histórico
historiography	historiografia
history	história
holiday ; opor-garai	férias
holiday camp	campos de férias
holmium	hólmio
home ; home ; house	casa
home garden	jardins particulares
homeostasis	homeostase
homepage	páginas pessoais
homologation	homologação
homonym	homónimo
honey	mel
hope	esperança
horizon	horizonte
hormone	hormona
horse	cavalo
horticulture	horticultura
hospital ; clinic	hospital
hospital waste	resíduos hospitalares
hostage	refén ; refém
hot water	água quente
hotel industry	indústria hoteleira
hour	hora
household	agregado familiar
household chemical	químicos domésticos
household expenditure	despesas domésticas
household goods	bens domésticos
housing	alojamentos
housing density	densidade habitacional
housing improvement	melhoria das habitações
housing legislation	habitação (legislação)
housing programme	programas de habitação ; programa de moradia ; programa habitacional
housing quality standard	padrões de qualidade de habitação
huckleberry ; blueberry	mirtilo
human body	corpo humano
human disease	doenças humanas
human ecology	ecologia humana
human habitat	habitats humanos
human health	saúde humana
human migration	migrações humanas
human physiology	psicologia humana
human population	população humana
human rights	direitos humanos
human science	ciências humanas
human settlement	aglomerados humanos
human settlement management	aglomerados humanos (gestão)
human-made disaster	catástrofes causadas pelo homem
humanitarian aid	ajuda humanitária
humus	adubos orgânicos
hundred	cem
hunger ; hunger ; hunger	fome
hunting	caça
hunting licence	licenças de caça
hunting reserve	reservas de caça
hurricane	furacão
husband ; spouse	marido ; esposo
hybridisation	hibridização
hydraulic construction	construção hidráulica
hydraulic engineering	engenharia hidráulica
hydraulics	hidráulica
hydrobiology	hidrobiologia
hydrocarbon	hidrocarbonetos
hydrocarbon storage tank	depósitos de hidrocarbonetos
hydrochloric acid ; muriatic acid	ácido clorídrico
hydroculture	hidrocultura
hydroelectric energy	energia hidroeléctrica
hydroelectric power plant	centrais hidroeléctricas
hydrogen	hidrogénio
hydrogen sulphide	sulfureto de hidrogénio
hydrogeology	hidrogeologia
hydrographic basin	bacias hidrográficas (desenvolvimento)
hydrographic network	redes hidrográficas
hydrography	hidrografia
hydrologic balance	equilíbrio hidrológico
hydrologic cycle	ciclos hidrológicos
hydrologic disaster	catástrofes hidrológicas
hydrologic flow	fluxos hidrológicos
hydrology	hidrologia
hydrolysis	hidrólise
hydrometeorology	hidrometeorologia
hydrometry	hidrometria
hydrosphere	hidrosfera
hyena	hiena
hygiene	higiene
hymenopteran	himenópteros
hypertext	hipertexto
hyponym ; narrower terms ; narrower term	termos mais específicos
ice	gelo
ice cream	gelado
ice hockey	hóquei no gelo
ice pack	bancos de gelo flutuante
iceberg	icebergue
ideology	ideologia
illiterate	analfabeto
image classification	classificação de imagens
image enhancement	melhoria da imagem (informática)
image filtering	filtração de imagens
image processing digital system	sistemas digitais de processamento de imagens
image registration	registo de imagens
immission	imissões
immission control	controlo das imissões
immission control law	controlo de imissões (legislação)
immission damage	danos de imissões
immission forecast	previsão de imissões
immission limit	limites de imissões
immission load	carga de imissões
immune system	sistema imunitário
immunity	imunidade
immunoassay	análise imunológica
immunological disease	doenças imunológicas
immunology	imunologia
impact assessment	avaliação de impacte
impact minimisation	minimização de impacte
impact prevention	prevenção de impacte
impact reversal	inversão de impacte
impact source	fontes de impacte
impactor	destroçadores
implementation law	diplomas de regulamentação
import	importação
import licence	licenças de importação
impoverishment	empobrecimento
impregnating agent	massas de enchimento
impregnation	enchimento (materiais) ; enchimento
improvement of efficiency	aumento da eficácia
impulsive noise	ruído impulsivo
in situ	in situ
in vitro assay	ensaios in vitro
in vivo assay	ensaios in vivo
incentive fund	fundos de incentivo
incentive tax	incentivos fiscais
incidental pollution	poluição acidental
incineration	incineração
incineration of waste	incineração de resíduos
incineration residue	escórias (incineração)
incinerator	incineradores
income	rendimento ; rendimentos
income tax	impostos sobre o rendimento
incorporation	incorporação (processos industriais) ; incorporação
indefinite legal concept	conceito jurídico indefinido
indemnity	indemnizações
independence	independência
index	índices (parâmetros) ; índices
indexing of documentation	indexação de documentação
indicator	indicadores
indicator of environmental quality	indicadores de qualidade do ambiente
indigenous knowledge	conhecimentos indígenas
indigenous technology	tecnologia indígena
indirect discharger	descarregadores indirectos
indium	índio
individual	indivíduo
individual wastewater treatment	tratamento individual de águas residuais
indoor air pollution	poluição do ar interior
indoor environment	ambiente interior
industrial activity	actividades industriais
industrial area	áreas industriais
industrial association	associações industriais
industrial building	edifícios industriais
industrial crop	culturas industriais
industrial development	desenvolvimento industrial
industrial dumping	lixeiras industriais
industrial economics	economia industrial
industrial effluent	efluentes industriais
industrial emission	emissões industriais
industrial environment	ambiente industrial
industrial environmental policy	política ambiental (indústria)
industrial equipment	equipamento industrial
industrial installation	instalações industriais
industrial legislation	indústria (legislação)
industrial manufacturing	manufactura industrial
industrial material	materiais industriais
industrial medicine	medicina industrial
industrial noise	ruído da indústria
industrial planning	planeamento industrial
industrial plant (building) ; industrial plant	instalações industriais ; instalações industriais (edifícios)
industrial plant (organism) ; industrial plant	produtos industriais (plantas)
industrial policy	política industrial
industrial pollution	poluição industrial
industrial process	processos industriais
industrial product	produtos industriais ; produto industrial
industrial production	produção industrial
industrial production statistics	estatísticas industriais
industrial property right	direito de propriedade industrial
industrial safety	segurança industrial
industrial site	zonas industriais
industrial sludge	lamas industriais
industrial society	sociedade industrial
industrial structure	estrutura industrial
industrial waste	resíduos industriais
industrial waste gas	gases industriais
industrial waste water	águas  residuais industriais
industrial wasteland	terrenos industriais abandonados
industrial zoning	zonagem industrial
industrialisation	industrialização
industry	indústria
inert waste	resíduos inertes
inertisation	inertização da atmosfera
infant	primeira infância
infant mortality	mortalidade infantil
infection	infecção
infectious disease	doenças infecto-contagiosas
infectious disease ; communicable diseases	doença infecciosa
infestation of crops	infestação de colheitas
infestation of food	infestação de alimentos
infiltration	infiltração
inflammable substance	substâncias inflamáveis
inflation	inflação
inflow	influxo
influenza ; flu	gripe
info ; information	informação
informal negotiation	negociação informal
informatics ; computer science ; information science	informática ; computação
information centre	centros de informação
information clearing-house	centros de recolha e distribuição de informação
information exchange	intercâmbio de informação
information infrastructure	infra-estruturas da informação
information kit	kits de informação
information network	redes de informação
information processing	processamento de informação
information service	serviços de informação
information source	fontes de informação
information system	sistemas de informação
information technology ; IT	tecnologia da informação
information technology industry	indústria das tecnologias de informação
information transfer	transferência de informação
infraction	contra-ordenações
infrared radiation	radiação infravermelha
infrasound	infra-sons
infrastructure	infra-estruturas ; infra-estrutura
inhabitant	habitantes ; habitante
initial training	formação inicial
injury	ferimentos
ink	tinta ; tintas de escrever e imprimir
inland fishery	pesca em rios
inland navigation	navegação fluvial
inland water	águas interiores
inland waterways transport	transporte por vias de navegação interiores
innovation	inovação
inorganic chemistry	química inorgânica
inorganic fertiliser	fertilizantes inorgânicos
inorganic pollutant	poluentes inorgânicos ; poluente inorgânico
inorganic substance	substâncias inorgânicas ; substância inorgânica
insect	insecto
insecticide	insecticidas
insectivore	insectívoros
insoluble substance	substâncias insolúveis
inspection	inspecção
inspection of records	inspecção de registos
inspection service	serviços de inspecção
installation optimisation	optimização de instalações
installation requiring approval	instalações por aprovar
installation restoration	restauração de edifícios
instep	dorso do pé ; peito do pé
institutional activity	actividades institucionais
institutional structure	estrutura institucional
institutionalisation	institucionalização
instrument ; musical instrument	instrumento ; instrumento musical
instrument manufacture	fabrico de instrumentos
instrumentation	instrumentação
insulation	isolamento
insurance	seguros
insurance business	companhias de seguros
insurance coverage	cobertura de seguros
integral natural reserve	reservas naturais (integrais)
integrated environmental protection technology	tecnologia integrada (protecção do ambiente)
integrated management	gestão integrada
integrated pest control	controlo integrado de pragas
integrated pollution control	controlo integrado da poluição
intensive animal husbandry	pecuária intensiva
intensive farming	exploração agrícola intensiva
inter-library loan	empréstimo entre bibliotecas
interaction of pesticides	interacção de pesticidas
interchange of electronic data	intercâmbio de dados electrónicos
interdisciplinary research	investigação interdisciplinar
interest	interesses ; juros ; juro
interest group	grupos de interesse
interim decision	decisões provisórias
interlaboratory comparison	comparação inter-laboratorial
intermediate goods	bens inacabados
intermittent noise	ruído intermitente
internal European market	Mercado Único
internal migration	migrações internas
internalisation of external costs	internalização de custos externos
international agreement	acordos internacionais
international assistance	assistência internacional
international balance	equilíbrio internacional
international co-operation	cooperação internacional
international competitiveness	competitividade internacional
international conflict	conflito internacional
international convention	convenções internacionais
international distribution	distribuição internacional (economia)
international division of labour	divisão internacional do trabalho
international economic law	Direito internacional económico
international environmental relations	relações ambientais internacionais
international harmonisation	harmonização internacional
international law	Direito internacional
international organisation	organizações internacionais
international politics	política internacional
international relations	relações internacionais
international safety	segurança internacional
international standardisation	padronização internacional
international trade	comércio internacional
international transaction	comparação internacional
international watercourse	cursos de água internacionais
internationally important ecosystem	ecossistema internacionalmente importante
internet search service	serviços de pesquisa na Internet
internet service provider ; ISP ; Internet access provider ; Internet service provider	fornecedores de acesso à Internet
interpolation	interpolação
interpretation method	métodos de interpretação
interpreter	intérprete
intertidal zone	zona intertidal
intervention fund	fundos de intervenção
intervention in nature and landscape	intervenção na natureza e na paisagem
intervention on land	intervenção nas terras
intoxication	intoxicação
introduction of animal species	espécies animais (introdução)
introduction of plant species	espécies vegetais (introdução)
inventory	inventários
inventory of forest damage	danos florestais (inventário)
inversion	inversão térmica
inversion layer	camada de inversão
invertebrate	invertebrados ; invertebrado
investment	investimentos
iodine	iodo
ion	iões
ion exchange	permuta de iões
ion exchanger	permutadores de iões
ionising radiation	radiação ionizante
ionosphere	ionosfera
iridium	irídio
iron	ferro
iron and steel industry	indústria do ferro e do aço
iron industry	indústria de metais ferrosos
iron scrap	sucata de ferro
ironwork industry	siderurgia
irradiation	irradiação
irreversibility of the phenomenon	irreversibilidade dos fenómenos
irrigation	irrigação
irrigation farming	exploração de regadio
irrigation system	sistemas de irrigação
island ; isle	ilhas ; ilha
island ecosystem	ecossistema insular
isomer	isómero
isotope	isótopos
ivory	marfim
jackal	chacal
jade	jade
jaguar	jaguar
jazz	jazz
joint ; articulation	articulação
joint debtor	devedor comum
joint implementation	implementação comum
journalism	jornalismo
journalist	jornalista
judgement (sentence) ; sentence ; judgement	julgamentos ; julgamentos (sentenças) ; sentenças ; julgamento ; sentença
judicial assistance	apoio judiciário
judicial body	corpo judiciário
judicial system	sistema judicial
judiciary rule	regras judiciárias
judo	judô
juridical act	actos jurídicos
jurisdiction	jurisdição
jurisprudence	jurisprudência
justice	Justiça ; justiça
karate	caratê
karst	karst
kerosene	querosene
kettle	chaleira
keyboard	teclado
kidney	rim
kleptomania	cleptomania
knife	faca
knight ; knight	cavalo
kokosnoot ; coconut	côco
krypton	crípton
labelling	rotulagem
laboratory	laboratórios ; laboratório
laboratory experiment	experiências laboratoriais
laboratory research	investigação laboratorial
laboratory technique ; laboratory techniques	técnicas laboratoriais
laboratory test	testes laboratoriais
laboratory waste	resíduos laboratoriais
labour	trabalho
labour force	força de trabalho
labour law	Direito do trabalho
labour market	mercado de trabalho
labour relations	relações de trabalho
lacquer	lacas
lagoon	lagunas
lagooning	lagunagem
lake	lagos
lake basin	bacias lacustres
lake pollution	poluição dos lagos
lamp ; light	lâmpadas
land	terra ; terras
land allotment	arrendamento de terras
land clearing	limpeza de terras
land conservation	conservação de terras
land consolidation	emparcelamento rural
land cover	cobertura do solo
land development	valorização de terras
land disposal	deposição no solo
land ecology	ecologia do solo
land forming	formação de terras
land mammal	mamíferos terrestres
land management and planning	gestão e planeamento de terrenos
land occupation	ocupação do solo
land planning	planeamento do território
land pollution	poluição da terra
land reclamation	conquista de terras
land register	cadastro rural
land restoration	recuperação de solos
land restoration in mountain areas	recuperação de solos (zonas montanhosas)
land setup	preparação de terras
land tax	impostos fundiários
land transportation	transporte terrestre
land use	uso da terra
land use classification	classificação de solos
land use plan	planos de ordenamento
land use planning	ordenamento do território
land use regime	uso da terra (regime)
land value	valor da terra
land-based activity	actividades terrestres
land-based marine pollution	poluição marinha (origem terrestre)
land-management intervention area	gestão de terras (áreas de intervenção)
landfill	aterros
landfill base sealing	aterros (impermeabilização)
landfill covering	cobertura de aterros
landfill degasification	desgaseificação de aterros
landfill gas	gases de aterros
landfill leachate	lixiviador de aterros
landform	configuração do terreno
landscape	paisagem
landscape after mining	paisagem (actividade mineira)
landscape alteration	alteração da paisagem
landscape architecture	arquitectura paisagista
landscape component	componentes paisagísticos
landscape conservation	conservação da paisagem
landscape conservation policy	conservação da paisagem (política)
landscape consumption	deterioração da paisagem
landscape ecology	ecologia paisagística
landscape management	gestão da paisagem
landscape planning	planeamento da paisagem
landscape protection	protecção da paisagem
landscape protection area	áreas de paisagem protegida
landscape utilisation	utilização da paisagem
landslide	derrocadas
language	língua ; idioma
lantern	lanterna
lanthanum	lantânio
large combustion plant	grandes instalações de combustão
laser ; Light Amplification by Stimulated Emission of Radiation	laser
latitude	latitude
laugh	rir
laundering	lavagem (roupa)
lavender ; lavander	lavanda
law	leis ; lei
law	direito (ordenamento jurídico) ; direito
law ; law (science)	ciências jurídicas
law amendment	alterações à  lei
law branch	ramos do Direito
law draft	projectos-de-lei
law enforcement	execução da lei
law relating to prisons	prisões (legislação)
lawrencium	laurêncio
lawyer	advogado
leaching	lixiviação
lead	chumbo
lead compound	compostos de chumbo
lead level in blood	teor de chumbo no sangue
lead-in-petrol law	teor de chumbo na gasolina (legislação)
leaf	folhas
leakage	fuga
leap year	ano bissexto
learn	aprender
lease	escrituras de arrendamento
leather	couro
leather industry	indústria de curtumes
leg	perna
legal basis	base legal
legal form of organisations	organizações (forma jurídica)
legal procedure	procedimentos legais
legal profession	profissões ligadas à justiça
legal regulation	regulamentação
legal remedy	recursos legais
legal system	sistema legal
legal text	textos legais
legally protected right	direitos legais
legislation	legislação
legislation on pollution	poluição (legislação)
legislative authority	autoridades legislativas
legislative competence	competência legislativa
legislative information	informação legislativa
legislative procedure	procedimentos legislativos
legislature	legislatura
leisure activity	actividades recreativas
leisure centre	centros de actividades recreativas
leisure time	tempos livres
lemon	limão
lens	lente
leopard	leopardo
lepidopteran	lepidópteros
less developed country	países subdesenvolvidos
lethargy ; sluggishness ; languor	letargia
letter	letra
lettuce	alface
leukaemia	leucemia
level of education	nível de educação
levy	colectas
lexicon	léxico
liability	obrigação
liability legislation	responsabilidade (legislação)
liberalism	liberalismo
librarian	bibliotecário
library	bibliotecas
library service	serviços de biblioteca
licencing procedure	processo de licenciamentos
lichen	líquenes
life cycle	ciclos de vida
life science	ciências da vida
life-cycle management	gestão do ciclo de vida
lifeguard	salva-vidas
lifestyle	estilo de vida
light	luz
lighting	iluminação
lignite	lenhite
lignite mining	extracção de linhite
lime	cal
limestone	calcário
limit value	valor limite
limnology	limnologia
line	linhas (parâmetro)
line source	fontes lineares
linear source of sound	fontes lineares de som
liner material	materiais de revestimento (aterros)
linguistics	linguística
lion	leão
lip	lábio
lipid	lípidos
lipophilic substance	substâncias lipofílicas
lipstick	batom
liquefied gas	gases liquefeitos
liquid	líqüido
liquid manure	adubos líquidos
liquid state	estado líquido
liquid waste	resíduos líquidos
literature	literatura
literature data bank	bancos de dados (literatura)
literature evaluation	literatura (avaliação)
literature study	estudos literários
lithium	lítio
lithography	litografia
lithosphere	litosfera
litigation	litígio
litter	lixos ; lixos ; cama de palha para animais ; cama de feno para animais
little finger ; pinkie	dedo mindinho
littoral	litoral
liver	fígado
livestock	gado
livestock breeding	criação de gado
livestock farming	exploração pecuária
living condition	condições de vida
living environment	biota
living space	espaço vital
living standard	nível de vida
lizard	lagartos ; lagarto
load bearing capacity	capacidade de sustentação de carga
local afforestation	florestação local
local authority	autoridades locais
local development	desenvolvimento local
local finance	finanças locais
local government	governo local
local government policy	governo local (política)
local heat supply	fornecimento local de calor
local passenger service	transporte de passageiros (local)
local recreation	actividades recreativas locais
local resource utilisation	utilização de recursos locais
local traffic	tráfego local
location of industries	localização de indústrias
locomotive	locomotivas
locust	locustídeo
lodging	alojamentos temporários
long	alto
long-distance traffic	tráfego de longa distância
long-distance transport	transporte de longa distância
long-term effect	efeitos a longo prazo
long-term experiment	experiências a longo prazo
longitude	longitude
lorry	camiões
loss	perdas ; prejuízo ; perda
loss of biotope	perdas de biótopos
lottery	loteria
loudness	intensidade sonora
love	amor
love	amar
low flow	estiagem
low-cost housing	habitação social
low-level flight	vôo a baixa altitude
low-level technology	tecnologia de baixo nível
lubricant	lubrificantes
lumberjack	madeireiro
luminosity	luminosidade
lunch ; lunch ; lunch ; lunch ; luncheon	almoço ; almoço ; almoço ; almoço ; almoço
lung	pulmão
lutetium	lLutécio ; lutécio
lye	lixívia
lymphatic system	sistema linfático
lynx	lince
lysimetry	lisimetria
machine gun	metralhadora
machine manufacture	indústria de máquinas
machinery ; mechanism	maquinaria
macroeconomic goal	metas macro-económicas
macroeconomics	macroeconomia
macrophyte	macrófitas
macroscopic	nacroscópico
magnesium	magnésio
magnetic tape	fitas magnéticas
magnetism	magnetismo
maintenance (technical) ; maintenance	manutenção
maintenance of environment	manutenção do ambiente
major accident	acidentes graves ; acidente grave
major risk	riscos graves
major risk installation	instalações de alto risco
malaria	malária ; paludismo
male ; man	homem ; macho
malformation	malformação
malnutrition	subnutrição
mammal	mamíferos ; mamífero
man	homem
man-made climate change	variação climática artificial
management	gestão
management accounting	contabilidade de gestão
management contract	contratos de gestão
management of natural resources	gestão de recursos naturais
management plan	planos de gestão
management technique	técnicas de gestão
mandarin ; Mandarin ; Standard Mandarin	mandarim
mandate	mandatos
manganese	manganês ; manganésio
mango	manga
mangrove	mangais
manpower	mão-de-obra
manufacturing activity	actividades de produção
manufacturing trade	comércio de produtos manufacturados
manure	adubos
manure production	produção de adubo
map	mapas ; mapa
map chart	cartas geográficas
mapping	levantamentos cartográficos
mapping of lichens	inventários da distribuição de líquenes
maquis	maquis
marble	mármore
mare	égua
marginal land	terrenos envolventes
mariculture	culturas marinhas
marina	marinas
marine biology	biologia marinha
marine ecology	ecologia marinha
marine ecosystem	ecossistema marinho
marine engineering	engenharia naval
marine environment	ambiente marinho
marine fauna	fauna marinha
marine fishery	pesca marinha
marine geology	geologia marinha
marine mammal	mamíferos marinhos
marine monitoring	monitorização marinha
marine organism	organismos marinhos
marine park	parques marinhos
marine pollution	poluição marinha
marine reserve	reservas marinhas
marital status	estado civil
maritime law	Direito do mar
maritime navigation	navegação marítima
maritime transport	transporte marítimo
marker	marcadores
market ; marketplace	mercado
market economy	economia de mercado
market form	formas de mercado
market gardening	horticultura de mercado
market price	preço de mercado
market research	pesquisa de mercado
market study	estudos de mercado
marketing	marketing
marsh	pântanos turfosos
marsupial	marsupiais
mason ; bricklayer ; stonemason	pedreiro
masonry	alvenaria
mass	massa
mass media	comunicação social
mass recreation	actividades recreativas (povo)
mass transport	transporte de massa
material ; materials	materiais
material life cycle	ciclo de vida dos materiais
materials science	ciências dos materiais
mathematical analysis	análise matemática
mathematical method	métodos matemáticos
mausoleum	mausoléu
maximum admissible concentration	concentração máxima admissível
maximum immission concentration	concentração máxima de imissão
mayonnaise	maionese
mayor	prefeito
meadow	prados
means of agricultural production	meios de produção agrícola
means of communication	meios de comunicação
measuring	medição
measuring instrument	instrumentos de medição
measuring method	métodos de medição
measuring programme	programas de medição
meat	carne
mechanical equipment	equipamento mecânico
mechanical industry	indústria mecânica
mechanical vibration	vibrações mecânicas
medical science	ciências médicas
medicinal plant	plantas medicinais
medicine ; medicine (practice)	medicina
megabyte	megabyte
meitnerium	meitnério
melody ; tune	melodia
melting	fusão
membrane	membrana
mendelevium	mendelévio
meningitis	meningite
menorah	menorá
merchant	mercador ; comerciante
merchant shipping	navios mercantes
mercury	mercúrio
metabolism	metabolismo
metabolite	metabolito
metainformation	metainformação
metal	metal
metal oxide	óxido metálico
metal product	produtos metálicos
metal products industry	indústria de metais
metal waste	resíduos de metais
metallic mineral	minerais metálicos
metallurgical industry	indústria metalúrgica
metallurgy	metalurgia
metaphor	metáfora
metaphysics	metafísica
meteor ; meteor ; meteor ; meteor ; meteor ; shooting star ; falling star	estrela cadente ; meteoro
meteorite	meteorito
meteorological disaster	catástrofes meteorológicas
meteorological parameter	parâmetros meteorológicos
meteorological phenomenon	fenómenos meteorológicos
meteorological research	investigação meteorológica
meteorology	meteorologia
methane ; marsh gas ; methyl hydride	metano
methanisation	metanização
methanol	metanol
method	métodos
methodology	metodologias
metrology	metrologia
metronome	metrônomo
metropolis	metrópoles
micro-organism	microrganismos
microbiological analysis	análises microbiológicas
microbiology	microbiologia
microclimate	microclima
microclimatology	microclimatologia
microcomputer	microcomputadores
microecosystem	microecossistema
microelectronics ; microminiaturization ; microsystem electronics	microelectrónica
microfiltration	microfiltragem
microphone	microfone
micropollutant	micropoluentes
microscopy	microscopia
microwave	microondas
migrant labour	mão-de-obra migrante
migratory bird	aves migratórias
migratory fish	peixes migratórios
military activities	actividades militares
military air traffic	tráfego aéreo militar
military aspects	aspectos militares
military equipment	equipamento militar
military zone	zonas militares
milk	leite
mill	moinhos
millet	milhete
mine	minas
mine filling	terraplanagem de minas
mineral	minerais
mineral conditioner	condicionadores minerais
mineral deposit	jazigos minerais
mineral extraction	extracção mineira
mineral fibre	fibras minerais
mineral industry	indústria mineral
mineral matter	matéria mineral
mineral oil	óleos minerais
mineral pollution	poluição mineral
mineral resource	recursos minerais
mineral waste	resíduos minerais
mineral water	água mineral
mineralisation	mineralização
mineralogy	mineralogia
minimal cost planning	planeamento de custo mínimo
minimisation of damage	minimização de prejuízos
mining district	zonas mineiras
mining industry	indústria mineira
mining law	minas (legislação)
mining product	produtos mineiros ; produto mineiro
mining regulation	regulamentos de minas
mining site restoration ; mine reclamation	recuperação de minas
mining waste	escórias de minas
miniskirt ; mini-skirt	mini-saia
minister competence	conferências ministeriais
ministerial decree	decretos-lei
ministry	ministério
ministry ; ministry building	edifícios ministeriais
minor	menor
minority	minorias
minute	minuto
miscellaneous product	produtos diversos
miscibility	miscibilidade
mist	névoa
mistral	mistral
mite	ácaros
mitigation measure	medidas de mitigação
mitosis	mitose
mixed farming	agricultura mista
mixed forest	floresta mista
mixed use area	áreas de utilização múltipla
mixing	mistura
mobile home	caravanas
mode of transportation	modo de transporte
model	modelos ; modelo
model	modelo
modelling	modelação
moisture	humidade
molar ; tooth	dente
molecular biology	biologia molecular
mollusc	moluscos
molybdenum	molibdênio
monetary assessment	avaliação monetária
monetary economics	economia monetária
monetary relations	relações monetárias
money market	mercado monetário
monitoring	monitorização
monitoring criterion	critérios de monitorização
monitoring data	dados de monitorização
monitoring equipment	equipamento de monitorização
monitoring network	redes de monitorização
monitoring station	estações de monitorização
monitoring technique	métodos de monitorização
monopoly	monopólio
month	mês
monument	monumentos
moon ; Luna ; Moon	lua
moon ; moon ; satelite ; satelite	lua
morphine	morfina
morphology	morfologia
mortality	mortalidade
mosaic	mosaicos
mosque	mesquita
moss	musgos
mother	mãe
mother-in-law ; mother in law	sogra
motherhood ; maternity	maternidade
motor fuel	carburantes
motor vehicle	veículos motorizados
motor vehicle exhaust gas	gases de escape (veículos motorizados)
motor vehicle industry	indústria de veículos motorizados
motor vehicle pollution	poluição por fontes móveis
motorcycle ; motorbike	motocicletas ; motocicleta
motorway ; pike ; expressway ; freeway ; state highway ; superhighway ; throughway ; thruway	vias rápidas
mountain	montanhas
mountain climate	clima de montanha
mountain forest	floresta de montanha
mountain management	gestão das montanhas
mountain protection	protecção das montanhas
mountain range	cordilheiras ; cordilheira
mountain resort	estâncias de montanha
mountainous area	áreas montanhosas
mouse	rato
mowing	ceifa
mud	lama
mud flat	planícies lodosas
mulch	camada protectora do solo
mule	mula
multilateral agreement	acordos multilaterais
multimedia technology	tecnologia multimédia
multinational firm	empresas multinacionais
multispectral scanner	scanner multi-espectro
mumps	caxumba
municipal cleansing service	serviços de limpeza municipais
municipal dumping	lixeiras municipais
municipal environment plan	planos municipais (ambiente)
municipal environmental policy	política ambiental municipal
municipal law	autarquias (legislação)
municipal level	hierarquia municipal
municipal waste	resíduos urbanos
municipal water distribution system	redes de abastecimento de água
municipal water management	gestão das águas municipais
municipality	autarquias ; autarquia
muscular system	sistema muscular
museum	museus
mushroom	cogumelos
music	música
musquito ; mosquito	mosquito
mussel farming	mitilicultura
mustelid	mustelídeos
mutagen	mutagénio
mutagenicity	mutagénese
mutagenicity testing	mutagénese (ensaio)
mutant	mutantes
mutated micro-organisms release	microrganismos mutantes (libertação)
mutation	mutação
mycete	micetes
mycology	micologia
mycorrhiza	micorrizas
mysterious	misterioso
myth	mito
nadir	nadir
name ; proper name ; proper noun	nome
napkin	guardanapo
nappy	cueiro
national accounting	contabilidade nacional
national boundary	fronteiras nacionais
national economy	economia nacional
national environmental accounting	contabilidade nacional  (ambiente)
national fishing reserve	reservas de pesca
national legislation	legislação nacional
national park	parque nacional
national planning	planeamento nacional
nationalisation	nacionalização
natural area	áreas naturais
natural areas protection	protecção de áreas naturais
natural disaster	catástrofes naturais
natural environment	ambiente natural
natural fertiliser	fertilizantes naturais
natural fibre	fibras naturais
natural forest	floresta natural
natural gas	gás natural
natural gas exploration	gás natural (exploração)
natural gas extraction	extracção de gás natural
natural hazard	perigos naturais
natural heritage	património natural
natural heritage assessment	património natural (avaliação)
natural material	produtos naturais
natural monument	monumentos naturais
natural park	parque natural
natural radioactivity	radioactividade natural
natural regeneration	regeneração natural
natural resource	recursos naturais
natural resource conservation	recursos naturais (conservação)
natural risk	riscos naturais
natural risk analysis	riscos naturais (análise)
natural risks prevention	prevenção de riscos naturais
natural scenery	paisagens naturais ; cenário natural
natural science	ciências naturais
natural stone	pedras preciosas
natural value	valor natural
nature conservation	conservação da natureza
nature conservation legislation	conservação da natureza (legislação)
nature conservation organisation	conservação da natureza (organizações)
nature conservation programme	conservação da natureza (programa)
nature protection	protecção da natureza
nature reserve	reservas naturais
nausea	náuseas
navigation	navegação
navigational hazard	riscos para a  navegação
necrosis	necrose
need	carência
neighbour ; vecino	vizinho
neighbourhood noise	ruído da vizinhança
nematode	nemátodes
neodymium	neodímio
neologism	neologismo
neon	néon
neoplasm ; tumour	tumores
nepotism	nepotismo
neptunium	neptúnio
nervous system	sistema nervoso
nesting	nidificação
nesting area	áreas de nidificação
netting policy (emissions trading) ; netting policy	política de compensação interna (emissões)
neurology	neurologia
neurotoxicity	neurotoxicidade
neutralisation	neutralização
new ; novel	novo
new community	novas comunidades
new installation	novas instalações
new material	novos materiais
new technology	novas tecnologias
newsgroup	newsgroup
newsletter	newsletter
newspaper	jornal
nickel	níquel
niobium	nióbio
nitrate	nitratos
nitrification	nitrificação
nitro compound	compostos de azoto
nitrogen	azoto ; nitrogénio
nitrogen cycle	ciclo do azoto
nitrogen dioxide	dióxido de azoto
nitrogen fixation	fixação de azoto
nitrogen monoxide	monóxido de azoto
nitrogen oxide	óxido de azoto
nitrogen oxides	óxidos de azoto
nitrogenous fertiliser	fertilizantes azotados
nitrosamine	nitrosaminas
no	não
nobelium	nobélio
noise	ruído
noise ; noise, vibrations ; racket	ruído
noise abatement	redução do ruído
noise analysis	análise do ruído
noise barrier	barreiras acústicas
noise control	controlo de ruído
noise disturbance ; noise pollution	perturbações sonoras ; poluição sonora
noise emission	emissões sonoras
noise emission levy	emissões sonoras (taxas)
noise exposure plan	planos de exposição ao ruído
noise immission	imissões de ruído
noise legislation	normas de ruído
noise level	níveis de ruído
noise measurement	medição do ruído
noise pollutant	poluentes sonoros
noise pollution	poluição sonora
noise protection	protecção do ruído
noise reduction	redução do ruído (indústria)
noise spectrum	espectro do ruído
noise-free technology	tecnologia livre de ruído
nomad	nómadas ; nómada
nomenclature	nomenclatura
non-biodegradable pollutant	poluentes não-biodegradáveis
non-built-up area	áreas não construídas
non-conventional energy	energia não-convencional
non-demesnial water	águas internacionais
non-durable goods	produtos perecíveis
non-ferrous metal	metais não-ferrosos
non-ferrous metal industry	indústria de metais não-ferrosos
non-governmental organisation	organizações não-governamentais
non-ionising radiation	radiação não-ionizante
non-metal	não-metais ; não-metal
non-metallic mineral	minerais não-metálicos
non-polluting energy source	fontes de energia não-poluentes
non-polluting fuel	combustíveis não-poluentes
non-renewable energy resource	recursos energéticos não-renováveis
non-renewable resource	recursos não-renováveis
non-residential building	edifícios não-residenciais
non-returnable container	taras perdidas ; tara perdida
non-target organism	organismos não atingíveis
non-volatile substance	substâncias não-voláteis
norm	normas
nose	nariz
nosotros ; we	nós
nostril	venta
not	não
note	nota
nothing	nada
notice	avisos ; aviso
notification	notificação
noun ; substantive	substantivo
novel	romance
nuclear accident	acidentes nucleares
nuclear debate	debates nucleares
nuclear energy	energia nuclear
nuclear energy legislation	energia nuclear (legislação)
nuclear energy use	energia nuclear (utilização)
nuclear explosion (accident) ; nuclear explosion	explosões nucleares (acidentes) ; explosões nucleares
nuclear facility	instalações nucleares
nuclear fission	fissão nuclear
nuclear fuel	combustíveis nucleares
nuclear fuel element	elementos combustíveis nucleares
nuclear fusion	fusão nuclear
nuclear hazard	perigos nucleares
nuclear physics	física nuclear
nuclear power plant	centrais nucleares
nuclear reaction	reacções nucleares ; reacção nuclear
nuclear reactor	reactores nucleares
nuclear research centre	centros de investigação nuclear
nuclear risk	riscos nucleares
nuclear safety	segurança nuclear
nuclear test	testes nucleares ; teste nuclear
nuclear weapon	armas nucleares ; arma nuclear
nucleic acid	ácidos nucleicos
nursery (plant breeding) ; nursery ; plant nursery	viveiros de plantas
nutcracker	quebra-nozes
nutrient	nutrientes
nutrient balance	equilíbrio de nutrientes
nutrient content	teor de nutrientes
nutrient cycle	ciclos de nutrientes
nutrient medium	elementos nutrientes
nutrient removal	remoção de nutrientes
nutrition	nutrição
nutritive value of food	alimentos (valor nutritivo)
oak	carvalhos ; carvalho
obesity	obesidade
obey	obedecer
objection	objecções
obligation to inform	obrigatoriedade de informar
obligation to label	obrigatoriedade de rotular
observation	observação
observation satellite	satélites de observação
observatory	observatório
obstacle ; obstruction	obstáculo
occupational disease	doenças profissionais
occupational health	saúde ocupacional
occupational health care	cuidados de saúde (trabalho)
occupational medicine	medicina do trabalho
occupational safety	segurança no trabalho
occupational safety regulation	normas de segurança no trabalho
occupational status	estatuto profissional
ocean ; sea ; body of water ; bounding main	oceanos ; oceano
ocean circulation	circulação dos oceanos
ocean current	correntes oceânicas
ocean dumping	descargas no oceano
ocean exploitation	exploração dos oceanos
ocean temperature	temperatura dos oceanos
ocean-air interface	interface mar-ar
oceanic climate	clima oceânico
oceanography	oceanografia
octave	oitava
octopus	polvo
odour	odores ; odor
off-peak travelling	viagens (fora das horas de ponta)
off-site	off-site
offence against the environment	agressões contra o ambiente
office	escritórios ; escritório
official duty	deveres oficiais
official hearing	audiências oficiais
official language	língua oficial
offset policy (emissions trading)	política externa (taxas de emissão)
offshore mining	extracção mineira offshore
ohm	ohm
oil and fat industry	indústria de óleos e gorduras
oil binding agent	aditivos de ligação (óleo)
oil boom	barreiras contentoras
oil disaster	derrames de petróleo ; derrames de petróleo (catástrofes)
oil exploration	exploração de petróleo
oil extraction	extracção de petróleo
oil pipeline	oleoduto
oil pollution	poluição por hidrocarbonetos
oil pollution abatement	diminuição de poluição por hidrocarbonetos
oil production (chain)	produção de petróleo
oil recovery vessel	navios recuperadores de petróleo
oil refinery	refinarias de petróleo
oil residue recuperation	resíduos petrolíferos (recuperação)
oil slick	manchas de óleo
oil spill	derrames de petróleo
oil tanker	petroleiros
oil-based energy	energia convencional (hidrocarbonetos)
old hazardous site	locais antigos perigosos
old landfill site	aterros encerrados
olfactory pollution	poluição olfactiva
oligarchy	oligarquia
oligopoly	oligopólio
olive	azeitona
olive oil mill wastewater	águas ruças
omega	omêga
on-line service	serviços on-line
on-site wastewater treatment	tratamento de águas residuais (no local)
oncology	oncologia
one	um
onion	cebola
ontogenesis ; ontogenesis ; ontogeny	ontogénese ; ontogénese
ontology	ontologia
open lawn	relvados
open sea	mar alto
open sea fishing	pesca no mar alto
opencast mining ; open-pit mining	minas a céu aberto
opera	ópera
operating data	dados operacionais
operetta	opereta
ophthalmology	oftalmologia
opinion ; stance	opinião
opinion survey	sondagens de opinião
opium	ópio
optics	óptica
or	ou
oral sex	sexo oral
orange	laranja
orchestra	orquestra
orchid	orquídea
order	normas jurídicas
ordinance	posturas minicipais
ore	minérios
organ	órgão
organelle	organelo
organic carbon	carbono orgânico
organic chemistry	química orgânica
organic farming	agricultura biológica
organic matter	matéria orgânica
organic nitrogen	azoto orgânico
organic pollutant	poluentes orgânicos
organic pollution	poluição orgânica
organic solvent	solventes orgânicos
organic substance	substâncias orgânicas
organic waste	resíduos orgânicos
organisation (law)	organização (direito) ; organização
organisation of teaching	organização do ensino
organisation of the legal system	organização do sistema jurídico
organism	organismos (taxonomia) ; organismos
organochlorine compound	compostos organoclorados
organohalogen compound	compostos organohalogenados
organoleptic property	propriedades organolépticas
organometallic compound	compostos organometálicos
organonitrogen compound	compostos orgânicos azotados
organooxygen compound	compostos orgânicos oxigenados
organophosphorous compound	compostos organofosforados
organosulphur compound	compostos organosulfurados
ornithology	ornitologia
orography	orografia
orphan	órfão
orthography	ortografia
orthopteran	ortópteros
osmium	ósmio
osmosis	osmose
ostrich	avestruz
outer space (allocation plan) ; outer space	espaço extra-atmosférico
ovary	ovário
oven	fornos
overburden	sobrecarga
overexploitation	sobreexploração
overfertilisation	sobrefertilização
overfishing	sobrepesca
overflow (outlet)	extravasamento (emissários)
overgrazing	sobrepastoreio
overhead power line	linhas eléctricas aéreas
overpopulation	sobrepopulação
overturn (limnology)	overturn (limnologia)
overwintering	invernada
ovine	ovinos
owner	proprietário
ownership	detenção de bens
oxidation	oxidação
oxidation-reduction	oxidantes/redução
oxide	óxidos ; óxido
oxidisable material	materiais oxidáveis
oxidising agent	agentes oxidantes
oxygen	oxigénio
oxygen content	teor em oxigénio
oxygenation	oxigenação
oyster	ostra
oyster farming	ostreicultura
ozone	ozono
ozone depletion potential	redução do ozono (potencial)
ozone layer	camada do ozono
ozone layer depletion	redução da camada de ozono
ozonisation	ozonização
pacifist	pacifista
packaging	embalagens
packaging waste	resíduos de embalagens
packing industry	indústria de embalagens
paediatrician	pediatra
page	página
paint	tinta
paint room	câmara de pintura
paint shop	oficinas de pintura
painting business	empresas de pintura
palaeoclimatology	paleoclimatologia
palaeoecology	paleoecologia
palaeontology	paleontologia
palladium	paládio
palm	palma ; palmeira
palm	palma ; palma da mão
pancreas	pâncreas
pandemic	pandemia
paper	papel
paper industry	indústria do papel e do cartão
parabola	parábola
parachute	pára-quedas
parameter	parâmetros
parasite	parasitas
parasitology	parasitologia
parking provision	locais de estacionamento (temporário)
parliamentary debate	debates parlamentares
parliamentary report	relatórios parlamentares
parrot	papagaio
part of speech ; lexical category	classe gramatical
partially halogenated chlorofluorohydrocarbon	clorofluorhidrocarbonetos halogenados
participation	participação
particle	partículas ; partícula
particle separator	separadores de partículas
party ; political party	partidos políticos
passenger transport	transporte de passageiros
paste-like waste	resíduos pastosos
pasture	pastagens
patent	patentes
path	caminhos
pathogen	microrganismos patogénicos
pathogenic organism	organismos patogénicos
pathologic effect	efeitos patológicos
pathology	patologia
patrimonial management	gestão do património
pattern recognition	reconhecimento de padrões (ciência)
pay policy	política salarial
peace	paz
peacekeeping	manutenção da paz
pear	pêra
peat	turfa
peat extraction	extracção de turfa
pedagogy	pedagogia
pedestrian zone ; pedestrian area ; car-free zone ; auto-free zone ; pedestrianised zone	faixas de peões
pedosphere	pedosfera
penalty	penalizações
penalty for environmental damage	penalizações por danos ambientais
pencil	lápis
peninsula	península
pentachlorophenol	pentaclorofenol
people	gente
per capita data	dados per capita
percolating water	água de infiltração
perineum	períneo
periodic table	tabela periódica
peripheral park area	parques de estacionamento periféricos
periphyton	perífito
periurban space	espaço periférico-urbano
permeability	permeabilidade
permissible exposure limit	limites de exposição
permission	permissão
peroxyacetylnitrate	nitrato peroxiacetílico
persistant organic pollutant	poluentes orgânicos persistentes
persistence	persistência
persistence of pesticides	persistência de pesticidas
person	pessoa
personal responsibility	responsabilidade pessoal
pest	infestantes
pest control	controlo de pragas
pest infestation	pragas
pesticide	pesticidas
pesticide control standard	padrões de controlo de pesticidas
pet	animais de estimação ; animal de estimação
petition	petição
petition right	direito de petição
petrochemical	petroquímicos
petrochemical industry	indústria petroquímica
petrol	gasolina
petroleum	petróleo
petroleum consumption	consumo de petróleo
petroleum industry	indústria petrolífera
phanerogam ; spermatophyte	fanerogâmicas
pharmaceutical industry	indústria farmacêutica
pharmaceutical waste	resíduos farmacêuticos
pharmacokinetics	cinética farmacológica
pharmacology	farmacologia
pheasant	faisăo ; faisão
phenol	fenóis
pheromone	feromonas
philology	filologia
philosophy	filosofia
phishing	phishing
phobia	fobia
phone ; telephone	telefone
phosphate	fosfatos
phosphate removal	desfosfatação
phosphate substitute	substitutos de fosfatos
phosphatic fertiliser	fertilizantes fosfatados
phosphorus	fósforo
photo ; photograph	fotografia
photochemical agent	agentes fotoquímicos
photochemical oxidant	oxidantes fotoquímicos
photochemical pollution	poluição fotoquímica
photochemical product	produtos fotoquímicos
photochemical reaction	reacções fotoquímicas
photochemical smog	nevoeiro fotoquímico
photodegradation	fotodegradação
photogrammetry	fotogrametria
photography	fotografia
photon	fóton ; fotão
photosynthesis	fotossíntese
physical alteration	alterações físicas
physical chemistry	química física
physical conditions	condição física
physical geography	geografia física
physical measurement of pollution	medição física da poluição
physical planning	planeamento físico
physical pollutant	poluentes físicos
physical pollution	poluição física
physical process	processos físicos
physical property	propriedades físicas
physical science	ciências físicas
physical treatment	tratamento físico
physicochemical analysis	análises físico-químicas
physicochemical process	processos físico-químicos ; processo físico-químico
physicochemical purification	purificação físico-química
physicochemical treatment	tratamento físico-químico
physics	física
physiology	fisiologia
phytomass	fitomassa
phytopathology	fitopatologia
phytoplankton	fitoplâncton
phytosanitary treatment	tratamentos fitossanitários
phytosociology	fitossociologia
phytotoxicity	fitotoxicidade
piano ; pianoforte	piano
pickling plant	oficinas de decapagem
pigeon ; dove	pombo
piggery	pocilgas
pike ; spear	lança
pilot plant	fábricas piloto
pilot project	projectos-piloto
pilotage	pilotagem
pinniped	pinípedes
pino ; pine	pinheiro
pipe	condutas
pipeline	pipeline
pituitary gland	hipófise
pity ; compassion	compaixão
pixel	pixel
place ; location	lugar
placenta	placenta
plain	planícies
plan	planos
plane	plano
plane source	fontes móveis (poluição)
planet	planeta
plankton	plâncton
planning	planeamento
planning law	lei do ordenamento
planning measure	medidas de planeamento
planning permission	autorizações de planeamento
plant	planta
plant biology	biologia vegetal
plant breeding	melhoramento de plantas
plant community	comunidades vegetais
plant component	componentes das plantas
plant disease	doenças das plantas
plant ecology	ecologia vegetal
plant equipment	equipamento fabril
plant heritage	património vegetal
plant physiology	fisiologia vegetal
plant population	população vegetal
plant production	produção vegetal
plant protection	protecção vegetal
plant protection product	fitofármacos
plant reproduction	reprodução vegetal
plant resource	recursos vegetais
plant selection	selecção vegetal
plant species	espécies vegetais
plant species reintroduction	espécies vegetais (reintrodução)
plant textile fibre	fibras de origem vegetal
plant trade	comércio de plantas
planting	plantações
plasma technology	tecnologia do plasma
plastic	plásticos
plastic waste	resíduos de plásticos
platinum	platina
platitude ; cliche ; cliché	chavão ; cliché
pleasure cruising	cruzeiros (recreio)
plough	arado
plutonium ; plutonium ; plutonium	plutónio ; plutónio ; plutónio
point	ponto
point source	fontes pontuais
poison	peçonha ; venenos ; veneno
poisoning	envenenamentos ; envenenamento
polar bear	urso polar
polar region	Região Polar
polder	polders
police	polícia
police law	forças policiais (legislação)
police power	poder policial
policy	política
policy guideline	orientação política
policy instrument	instrumentos políticos
policy integration	integração de políticas
policy planning	planeamento político
political counselling	consultoria política
political doctrine	doutrina política
political ecology	ecologia política
political geography	geografia política
political ideology	ideologia política
political organisation	organizações políticas
political power	poder político
politics	política
pollen	pólen
pollutant	poluentes
pollutant absorption	absorção de poluentes
pollutant accumulation	acumulação de poluentes
pollutant analysis	análise de poluentes
pollutant assessment	avaliação de poluentes
pollutant concentration	concentração de poluentes
pollutant degradation	degradação de poluentes
pollutant deposition	deposição de poluentes
pollutant dispersion	dispersão de poluentes
pollutant distribution	distribuição de poluentes
pollutant elimination	eliminação de poluentes
pollutant emission	emissões de poluentes
pollutant evolution	evolução de poluentes
pollutant exposure	exposição a poluentes
pollutant flow	fluxos de poluentes
pollutant formation	formação de poluentes
pollutant immission	imissões de poluentes
pollutant immobilisation	imobilização de poluentes
pollutant migration	migrações de poluentes
pollutant monitoring	monitorização de poluentes
pollutant pathway	trajecto de poluentes
pollutant reduction	redução de poluentes
pollutant remobilisation	remobilização de poluentes
polluted matter	matéria poluída
polluted site	zonas poluídas
polluter-pays principle	princípio do poluidor-pagador
pollution	poluição
pollution abatement	diminuição progressiva da poluição
pollution abatement equipment	diminuição progressiva da poluição (equipamento)
pollution abatement waste	matéria residual (tratamento de resíduos)
pollution control	controlo da poluição
pollution control equipment	controlo da poluição (equipamento)
pollution control investment	investimentos antipoluição
pollution control measure	poluição (medidas de controlo)
pollution control technology	tecnologia de controlo da poluição
pollution cost	custos da poluição
pollution effect	efeitos da poluição
pollution indicator	indicadores da poluição
pollution insurance	seguros de poluição
pollution liability	responsabilidade por danos causados pela poluição
pollution load	carga poluente
pollution measurement	medição da poluição
pollution monitoring	monitorização da poluição
pollution norm	normas de controlo de poluição
pollution prevention	prevenção da poluição
pollution risk	riscos de poluição
pollution type	tipos de poluição
polonium	polónio
polybrominated biphenyl	bifenilos polibromados
polychlordibenzo-p-dioxin	policlorodibenzo
polychlorinated biphenyl	bifenilos policlorados
polychlorinated dibenzofuran	policlorodibenzofurano
polychlorinated terphenyl	terfenilopoliclorados
polycyclic aromatic hydrocarbon	hidrocarbonetos policíclicos aromáticos
polycyclic hydrocarbon	hidrocarbonetos policíclicos
polyethylene terephtalate	tereftalatos de polietileno
polygon	polígonos ; polígono
polymer	polímeros ; polymero
polymerisation	polimerização
polyvinyl chloride	cloreto de polivinilo
pomegranate	romã
pond	tanques
pool ; puddle ; puddle	charcos
pope	papa
population	população ; populações
population density	densidade populacional
population dynamics	dinâmica de populações
population ecology	ecologia de populações
population growth	crescimento demográfico
population movement	movimentos da população
population structure	estrutura da população
population trend	tendências demográficas
porcelain	porcelana
poriferan	espongiários
posidonia ; neptunegrass	posidónias
positron	pósitron
possession	possessão
post-treatment	pós-tratamento (qualidade da água)
posterity	posteridade
postman	carteiro
potash	potássio
potassium	potássio
potassium fertiliser	fertilizantes de potássio
potato ; patato	batata
poultry	aves de capoeira
poultry farming	aviários
poverty	pobreza
power (physics) ; power	potência
power company	companhias eléctricas
power station	estações de electricidade
power station derating	redução de capacidade (centrais eléctricas)
power-heat relation	relação calor-energia
pragmatics	pragmática
praseodymium	praseodímio
pre-emption	preempção
pre-emption zone	zonas de preempção
precautionary principle	princípio de precaução
precipitation ; precipitation (chemical)	precipitação química ; precipitação
precipitation enhancement	intensificação da precipitação
precision engineering	mecânica de precisão
predator	predadores
prefabricated building	edifícios pré-fabricados
pregnancy	gravidez
prelate	prelado
preliminary proceedings	processos preliminares
premium	prémios
preparation for market	acondicionamento de produtos
preposition	preposição
prescription	prescrição
preservation of evidence	preservação de provas
preservative	conservantes
preserve	conservas
press	imprensa
pressing	prensagem
pressure	pressão
pressure equipment	equipamento de pressão
pressure group	grupos de pressão
prevention measure	medidas de prevenção
prevention of forest fires	prevenção de fogos florestais
preventive health measure	medidas preventivas (saúde)
preventive information	informação preventiva
price	preços
prices policy	política de preços
pricing policy of resources	política de preços (recursos naturais)
primary education	ensino básico
primary energy consumption	consumo de energia primária
primary forest	florestas primárias
primary sector	sector primário
primary treatment	tratamento primário
primate	primatas
prince	príncipe
principle of sustainability	princípio da sustentabilidade
printing work	trabalho tipográfico
prisoner of war ; POW ; PoW ; PW	prisioneiro de guerra
private car	automóveis particulares
private domain	propriedades privadas
private forest	florestas privadas
private household	residências particulares
private international law	Direito internacional privado
private law	Direito privado
private sector	sector privado
private transport	transportes privados
privatisation	privatização
problem	problema
proboscidean	proboscídeos
procaryote	procariotas
procedural law	Direito processual
process analysis	análise de processo
process technology	tecnologia de processos
process water	águas de processo
processed agricultural produce	produtos agrícolas processados
processed foodstuff	produtos alimentares processados
processing	processamento
producer liability	responsabilidade do produtor
product	produtos
product advertising	publicidade de produtos
product comparison	comparação de produtos
product evaluation	avaliação de produtos
product identification	identificação de produtos
product information	informação de produtos
product liability	responsabilidade pelos produtos
product life cycle	ciclo de vida dos produtos
product standard	padrões de produtos
production policy	política de produção
productivity	produtividade
productivity trend	tendências da produtividade
profit	lucros
prognostic data	dados de previsão
programme	programas ; programa
progress line	variação de caudais
prohibition	proibições
project	projectos
promethium	promécio
promotion of trade and industry	comércio e indústria (promoção)
pronunciation	pronúncia
propagation process	processos de propagação
propellant	propulsores
properties of materials	propriedades dos materiais
property ; asset	propriedade
property protection	protecção da propriedade
propulsion technique	técnicas de propulsão
prosecution	acusação
prosperity	prosperidade
prostate	próstata
prostitution	prostituição
protactinium	protactínio
protected area	áreas protegidas
protected landscape	paisagens protegidas
protected marine zone	zonas marinhas protegidas
protected species	espécies protegidas
protection from neighbours	protecção da privacidade
protection of animals	protecção da fauna
protection of birds	protecção das aves
protection of species	protecção das espécies
protection system	sistemas de protecção
protective measure	medidas de protecção
protein ; poly peptide	proteínas ; proteína
protein product	produtos proteicos
protocol	protocolos
protozoan	protozoários
proverb ; saying ; maxim	provérbio ; ditado
province	províncias ; província
provincial/regional authority (D) ; regional authority ; provincial authority	autoridades provinciais
provincial/regional law (D) ; regional legislation	legislação provincial
pruning	poda
psychiatrist	psiquiatra
psychic effect	efeitos psíquicos
psychological effect	efeitos psicológicos
psychological stress	stress psicológico
psychology	psicologia
psychosomatic effect	efeitos psicossomáticos
psychosomatic illness	doenças psicossomáticas
public	público
public access to land	acesso público à terra
public action	acções públicas
public aid	auxílio público
public attendance	frequência do público
public awareness campaign	campanha de sensibilização do público
public bath	banhos públicos
public benefit inquiry	inquéritos de utilidade pública
public building	edifícios públicos
public contract	contratos públicos
public debt	dívida pública
public discussion	debates públicos
public domain	domínio público
public expenditure	despesas públicas
public finance	finanças públicas
public financing	financiamento público
public function	função pública
public health	saúde pública
public hearing	audiências públicas
public information	informação das populações
public inquiry	inquéritos públicos
public institution	instituições públicas
public institution of administrative nature	instituições públicas de natureza administrativa
public institution of industrial and commercial nature	instituições públicas de natureza industrial e comercial
public international law	Direito público internacional
public law	Direito público
public maritime domain	domínio público marítimo
public opinion	opinião pública
public opinion polling	sondagens de opinião pública
public park	parques públicos
public participation	participação das populações
public procurement	contratos de fornecimento (serviço público)
public prosecutor's office	Ministério Público
public relations	relações públicas
public sector	sector público
public transport	transportes públicos
public transport vehicle	veículos de transportes públicos
public utility	serviços de utilidade pública
public waterways domain	domínio público hídrico
public works	obras públicas
public-private partnership	empresas mistas
pulmonary disease	doenças pulmonares
pump	bombas ; bomba ; bomba d'água ; bomba de combustível
pumping	bombagem
purification	depuração
purification facility	instalações de depuração
purification plant	centrais de depuração
purification through the soil	depuração pelo solo
purifying power	poder de depuração
purin	purina
putsch ; coup d'état	golpe de estado
pyralene	piraleno
pyrolysis	pirólise
quality assurance	garantia de qualidade
quality certification	certificação de qualidade
quality control	controlo de qualidade
quality objective	objectivos de qualidade
quality of life	qualidade de vida
quality standard	padrões de qualidade
quarry	pedreiras
quarrying	exploração de pedreiras
quartering	carcaças de animais (eliminação) ; carcaças de animais
queen	rainha
question	pergunta ; questão
rabbi	rabino
rabbit	coelho
race relations	relações inter-raças
racking	decantação
radar	radar
radiation ; radiations	radiações
radiation damage	danos causados pelas radiações
radiation dose	dose de radiação
radiation effect	efeitos radiológicos
radiation exposure	exposição às radiações
radiation physics	física das radiações
radiation protection	protecção radiológica
radiation protection law	lei da  protecção radiológica
radiation sickness	doenças das radiações
radio	rádio
radio programme	programas radiofónicos
radioactive contamination	contaminação radioactiva
radioactive decontamination	descontaminação radioactiva
radioactive dumping	descargas de resíduos radioactivos
radioactive emission	emissões radioactivas
radioactive fallout	precipitação radioactiva
radioactive pollutant	poluentes radioactivos ; poluente radioactivo
radioactive substance	substâncias radioactivas
radioactive tracer	traçadores radioactivos
radioactive waste ; nuclear waste	resíduos radioactivos
radioactivity ; radioactive decay	radioactividade
radioelement	elementos radioactivos
radiology	radiologia
radionuclide	radionuclídeos
radium	rádio
radon	radão ; rádon
rag	desperdícios
rail traffic	tráfego ferroviário
rail transport	transporte ferroviário
railroad vehicle ; carriage ; wagon	vagões
railway	caminhos de ferro
railway network	redes ferroviárias
railway station	estações ferroviárias ; estação ferroviária
rain	chuva
rain forest	floresta equatorial
rain water	águas pluviais
rain water sewer system	redes de esgotos (águas pluviais)
rainbow	arco-íris
rainout	rainout
raising a site	construção de obra
random test	testes aleatórios
rape	colza
rapid test	testes rápidos
rapid transit train	combóios rápidos
rare species	espécies raras
raster	raster
raster to vector	raster para a vectorial
rate	taxas
raw material	matérias-primas
raw material consumption	consumo de matérias-primas
raw material securing	aquisição de matérias-primas
raw water	água natural
reaction kinetics	cinética de reacção
reactor	reactores
reactor safety	segurança dos reactores
read	ler
reality	realidade
reasonableness	razoabilidade
recipe	receita
reclamation industry	indústria de valorização
recombinant DNA technology	ADN recombinante (tecnologia)
recommendation	recomendações
recorder	flauta doce
recording of substances	registo de substâncias
recovery of landscape	recuperação da paisagem
recovery plan	planos de recuperação
recreation	recreio
recreational area	áreas de recreio
recyclability	capacidade de reciclagem (materiais)
recyclable plastic	plásticos recicláveis
recycled material	materiais reciclados
recycled paper	papel reciclado
recycling	reciclagem
recycling management and waste law	reciclagem e gestão de resíduos (legislação)
recycling potential	potencial de reciclagem
recycling ratio	taxas de reciclagem
red kite	milhafre-real
red tide	marés vermelhas
redress	reparação (legal)
reed	juncos
reef	recifes
reference service	serviços de referência
referendum ; plebiscite	referendo
referral information	informação de referência
referral information system	sistemas de informação de referência
refinery	refinarias
refining	refinação
reflection	reflexão
reflectometry	reflectómetria
reforestation	reflorestação
refrigerant	refrigerante (mecânica)
refrigeration	refrigeração
refrigeration industry	indústria de refrigeração
refrigerator	frigoríficos
refrigerator ; fridge	refrigerador
refuge	refúgios (ecologia) ; refúgios
refugee	refugiados
refuse collection vehicle	veículos de recolha de lixo
refuse derived fuel	combustíveis à base de desperdícios
refuse shredder	resíduos de desfibrador
refuse-sludge compost	compostos de lixos e lamas
regeneration	regeneração
region	regiões ; região
regional authority	autoridades regionais
regional convention	convenções regionais
regional development	desenvolvimento regional
regional law	legislação regional
regional natural park	parque natural regional
regional plan	planos regionais
regional planning	planeamento regional
regional regulation	regulamentos regionais
regional statistics	estatística regional
regional structure	estrutura regional
registered site	sítios registados
registration	registos ; cadastro
registration obligation	obrigação de registo
registration proceeding	procedimentos de inscrição
regulation	regulamentos
regulation of agricultural production	produção agrícola (regulamentos)
regulation on maximum permissible limits	limites máximos admissíveis (regulamento)
regulative law	legislação regulamentar
rehousing	realojamentos
reindeer	rena
reintroduction	reintrodução
relational database	bases de dados relacionais
release of organisms	libertação de organismos
relief (land)	relevo (geografia)
religion	religião
remote sensing	detecção remota
remote sensing centre	centros de teledetecção
removal	eliminação
renaissance	renascimento
renaturation	renaturação
renewable energy source	fontes de energia renovável
renewable raw material	matérias-primas renováveis
renewable resource	recursos renováveis
repair business	empresas de reparação
replacement	substituição (processos químicos)
replacement cost	custos de substituição
report on the state of the environment	relatórios do estado do ambiente
report to the minister	relatórios para o governo
reporting process	apresentação de relatórios (processo)
representation	representação oficial
repression	repressão
reprocessing	reprocessamento
reproduction	reprodução (biologia)
reproductive manipulation	manipulação da reprodução
reptile ; reptile ; reptile	répteis ; réptil
rescue service	serviços de salvamento
rescue system	sistemas de salvamento
research	investigação
research centre	centros de investigação
research of the effects	investigação dos efeitos
research policy	política de investigação
research project	projectos de investigação
reserve	reservas (ecologia) ; reservas
reservoir	depósitos
residential area	áreas residenciais
residential area with traffic calmings	zonas residenciais (controlo de velocidade)
residential building	edifícios residenciais
residual amount of water	nível mínimo de água
residual pesticide	resíduos de pesticidas
residual risk	riscos residuais
residual waste	detritos residuais
residual waste sludge	lamas residuais
residue analysis	análise de detritos
residue of grinding	resíduos (trituração)
residue recycling	reciclagem de detritos
resin	resina
resinous plant	plantas resinosas
resistance (biological) ; resistance	resistência (biologia) ; resistência
resolution	resoluções
resolution ; resolution (parameter)	resolução (parâmetro) ; resolução
resorption	ressorção
resource ; resources	recursos ; recurso
resource appraisal	avaliação de recursos
resource conservation	conservação de recursos
resource exploitation	exploração de recursos
resource reserve	reservas de recursos
resource utilisation	utilização de recursos
resources management	gestão de recursos
respiration	respiração
respiratory air	ar (respiração)
respiratory disease	doenças respiratórias
respiratory system	sistema respiratório
retaining reservoir	depósitos de retenção
reverse osmosis	osmose inversa
rhenium	rênio
rhino ; rhinoceros	rinoceronte
rhodium	ródio
rhombus ; rhomb	losango
rice	arroz
rising sea level	elevação do nível das águas do mar
risk communication	comunicação sobre riscos
river	rios ; rio
river bed	leitos de rios
river water	água dos rios
road	estradas
road network	redes rodoviárias
road salt	sal para degelar estradas
rock	rochas
rodent	roedores ; roedor
roentgenium	roentgênio
rolling noise	ruído reverberante
roof ; roof ; roof	telhado
root	raizes ; raiz
rosary	rosário
rose	rosa
rotary furnace	fornos rotativos
route	itinerários
rubber	borracha
rubidium	rubídio
ruby	rubi
rural area	áreas rurais
ruthenium	ruténio
rutherfordium	rutherfordio ; rutherfórdio
sacrifice	sacrificio
safety ; security	segurança
safety measure	medidas de segurança
sahara	deserto do Saara
sailing ship	veleiro
salamander	salamandras ; salamandra
salary	salário
salmon	salmão
salt	sais
salt	sal
salt water	água salgada
samarium	samário
sand	areias
sand dune	dunas de areia ; duna de areia
sanitary fitting	equipamento sanitário
sapphire	safira
sardine	sardinha
satellite	satélites
sawdust	serradura
saxophone	saxofone
say	dizer
scandium	escândio
school	escolas ; escola
science	ciência
scientific co-operation	cooperação científica
scientific dispute	discussões científicas
scientific research	investigação científica
scientist	cientista
screwdriver	chave de fenda
sculptor	escultor
sea	mares ; mar
sea level	nível do mar
sea water	água do mar
seaborgium	seabórgio
seashore	orla marítima
season	estações ; estação
secondary education	ensino secundário
sediment	sedimentos ; sedimento
sedimentation (geology) ; sedimentation	sedimentação (geologia) ; sedimentação
sedimentology	sedimentologia
see	ver ; ver
seed	semente
seismic activity	actividades sísmicas ; actividade sísmica
seismic sea wave ; tsunami	maremotos
selenium	selénio ; selênio
sell	vender
semantics	semântica
semi-metal	semimetais ; semimetal
semiconductor	semicondutores
separator	separador
server	servidor
sew	coser ; costurar
sewage farm	aplicação de lamas ; aplicação de lamas
sex ; gender	sexo
sexology	sexologia
sextant	sextante
shark	tubarão
sheep	ovelha
shellfish ; shellfish	mariscos
shepherd	pastor ; pegureiro
ship	navios
shoe	sapato
shop	lojas
shopping centre	centros comerciais
short ; small	pequeno
shrub	arbustos
side effect	efeito secundário (química)
siemens	siemens
sign language	língua de sinais
silicon	silicone ; silício
silk	seda
silt	sedimentos finos
silver	prata
simulation	simulação
skeleton	esqueleto
ski run	pistas de esqui ; pista de esqui
skiing	esqui
skin	pele
skull	crânio
slag	jorra
slaughter	abater
slaughter-house	matadouro
slaughterhouse ; slaughter-house ; abattoir ; butchery ; shambles	matadouros
sleep	sono
sleep disturbance	distúrbios do sono
slipper	chinelopor ; chinelo
slope	declives
slow	lento
sludge	lamas ; borra
smallpox	varíola
smile	sorriso
smog	smog
smog warning	smog (aviso)
smoke	fumos
smoking	acto de fumar
snake	cobras ; serpente ; cobra
snow	neve
snowslide	deslizamento de neve
soaking	impregnação
soap	sabões
social behaviour	comportamento social
social group	grupos sociais
social protection	protecção social
social psychology	psicologia social
social science	ciências sociais
social survey	inquéritos sociais
social welfare	assistência social
society	sociedade
socioeconomic aspect of human settlements	aspectos socioeconómicos
sociolinguistics ; sociology of language	sociolingüística
sociology	sociologia
sock	meia
sodium	sódio
software	software
software development	desenvolvimento de software
soil	solos ; solo
soil fertilisation	fertilização do solo
soil fertility	fertilidade do solo
soil science	ciência dos solos
solar cell	pilhas solares
solar collector	colectores solares
solar energy	energia solar
solar energy technology	energia solar (tecnologia)
solar power station	centrais solares ; central solar
solar radiation	radiação solar
solubility	solubilidade
solvent	solventes
songbird	aves canoras
soot	fuligem
sorption	sorção (processos químicos) ; sorção
sound	som
sound measurement	medição do som
space ; space ; space (interplanetary) ; interplanetary space	espaço ; espaço (interplanetário)
space travel	viagens espaciais
spasmodic croup	crupe espasmódico
species	espécies
speech	discursos
speed	velocidade
sphinx	esfinge
spider	aranha
spider	aranhas ; aranha
spinach	espinafre
spleen	baço
spoon	colher
sport	desporto
spring	Primavera ; primavera
spring ; spring (hydrology, land)	nascentes ; nascente
spring water	água das nascentes
square	praças ; praça
stage	palco
standard	padrões
staple food	alimentos de consumo geral
star	estrela
starch	amido
station	estações ; estação
statistics	estatística
steam generator	geradores de vapor
steel	aço
sterilisation	esterilização
steroid	esteróides
stocking	estoque (manutenção)
stomach	estômago
stone	pedras
stork	cegonha
storm ; tempest	tempestades ; borrasca ; vendaval ; tempestade
story	história
stove	fogões
strange ; odd	estranho
strawberry	morango
stress	stress
strontium	estrôncio
subject ; topic	temas
submarine	submarinos
subsidence	subsidência
subsidy	subsídios
suburb	subúrbios
sudden ; abrupt ; precipitous	repentino
sugar	açúcar
suicide	suicídio
sulphur	enxofre
sulphur concentration	concentração de enxofre
sulphur dioxide	dióxido de enxofre
summer	verão
supermarket	supermarket ; supermercado
supernova	supernova
supply	fornecimento
supply and demand	oferta e procura
surface tension	tensão superficial
surgeon	cirurgião
surgery	cirurgia
surprise	surpreender
swans, geese and ducks	anatídeos
sweet	doce
sweetener	adoçantes
swimming pool	piscina
sword	espada
symbiosis	simbiose
symphony	sinfonia
synagogue	sinagoga
syndrome	síndrome
synecology	sinecologia
syphilis	sífilis
syringe	seringa
table	mesa
tadpole ; polliwog	girino
tailor	alfaiate
takeover	aquisição
tanker	camiões-cisterna
tanker ; tanker (ship)	navios-tanques
tannin	tanino
tantalum	tantálio ; tântalo ; tántalo
target group	grupos-alvo
tax	impostos
taxonomy	taxonomia
tea	chá
teach	ensinar
teacher	professor ; mestre
teaching	ensino
technetium	tecnécio
technology	tecnologia
technology transfer	transferência de tecnologia
telecommunications ; telecommunication	telecomunicações
telemetry	telemetria
television	televisor
television	televisão
television programme	programas televisivos
tellurium	telúrio
temperature	temperatura
ten	dez
tennis	ténis
teratogen	teratógeno
terbium	térbio
terminology	terminologia
termite	térmites
terracotta ; terracotta ; terracotta ; terra cotta	terracota
territory	território
terrorism	terrorismo
terrorist	terrorista
tertiary sector	sector terciário
test	testes
testosterone	testosterona
textile industry	indústria têxtil
textile plant	plantas têxteis
thallium	tálio
thank you	agradecimento
theocracy	teocracia
theology	teologia
therapy	terapia
thermal equipment	equipamento térmico
thermal power plant	centrais térmicas
thermodynamics	termodinâmica
thesis	teses
thirst	sede
thorium	tório
thousand	mil
three	três
thulium	túlio
thumb	polegar ; dedo polegar
thunder	trovão
thunderstorm	trovoadas
thyroid	tiróide
tidal power station	centrais maremotrizes
tidal water	água das marés
tiger	tigre
timber forest	florestas para abate
time	tempo ; tempo (parâmetro)
timezone	fuso horário
tin	estanho
tissue	tecido celular
titanium	titânio
titanium dioxide	dióxido de titânio
toad	sapos ; sapo
tobacco	tabaco
toe	dedo ; dedo do pé
together	juntos
tomato	tomate
tomorrow	amanhã
tongue	língua
topography	topografia
topology	topologia
tornado	tornados
torpedo	torpedo
tortoise	tartarugas
tourism	turismo
toxic metal	metais tóxicos ; metal tóxico
toxic substance	substâncias tóxicas
toxicity	toxicidade
toxicology	toxicologia
toxin	toxinas
trace element	microelementos
tracheophyte ; vascular plant	traqueófitos
trade	comércio
trade and consumption	comércio e consumo
trades union	sindicatos
traditional	tradicional
traffic	tráfego
traffic noise	ruído do tráfego
train	combóio
training	formação
training centre	centros de formação
trajectory	trajectória (parâmetro) ; trajectória
transition element ; transition metal	elementos de transição ; elemento de transição
translate ; interpret	traduzir
translation	tradução
transpiration	transpiração (flora) ; transpiração
transport	transporte
transport ; transportation	transporte (tráfego)
travel	viagem
treaty	tratados
tree	árvore
triangle	triângulo
trigonometry	trigonometria
tritium	trítio
trolley bus ; trolleybus	trólebus
trombone	trombone
trophic level	nível trófico
tropical forest	floresta tropical
tropical plant	plantas tropicais
tropical rain forest	floresta tropical húmida
tropics ; torrid zone	trópicos
trousers	calça
trout	truta
trumpet	trombeta
truth	verdade
tulip	tulipa
tunafish	atum
tundra	tundra
tungsten	tungstênio ; volfrâmio
tunnel	túneis ; túnel
turbidity	turvação
turbine	turbinas
turkey	peru
twin	gêmeos ; gémeo
two	dois
two	dois ; um
typhoon	tufão
tyre	pneus ; pneu
ultraviolet radiation	radiação ultravioleta
underground railway	metropolitano
underground train	metropolitano ; metropolitano (carruagens)
unemployment	desemprego
ungulate	ungulados
university ; university ; academy	universidade ; universidade
ununbium	ununbio
ununhexium	ununhexio
ununoctium	ununóctio
ununpentium	ununpentio
ununquadium	ununquadio
ununseptium	ununséptio
ununtrium	ununtrio
upbringing	educação familiar
uranium	urânio
urbanisation	urbanizações
urine	urina
ursid	ursídeos
useful	útil
user	utilizador
usurp	usurpar
vaccination	vacinação
vacuum cleaner	aspirador
valley	vales (geografia)
valuable	valioso ; precioso
vampire	vampiro
vanadium	vanádio
vandalism	vandalismo
vapour pressure	pressão do vapor
vector	vectores
vegetable	vegetais ; vegetal
vegetable oil	óleos vegetais
vehicle	veículos
ventilation	ventilação (processos industriais)
verb	verbo
vertebrate	vertebrados
veteran	veterano
veterinarian ; veterinary	alveitar
viable ; viable ; feasible	factível
village	aldeias
vinasse	resíduos da destilação do vinho ou das beterrabas ; resíduos da destilação
vinegar	vinagre
vineyard	vinhedo ; vinha
virology	virologia
virus	vírus
viscosity	viscosidade
vitamin	vitaminas ; vitamina
vocabulary	vocabulário
volatile substance	substâncias voláteis
volatility	volatilidade
volcanic eruption	erupções vulcânicas ; erupção vulcânica
volcanism	vulcanismo
volcano	vulcão
voltage	voltagem
voting	votação
vowel	vogal
vulcanisation	vulcanização
waiter	garçom
wall	paredes
walrus	morsa
war	guerra
warm-blooded animal	animais de sangue quente
wasp	vespa
waste	resíduos
waste bin	baldes do lixo
waste disposal act	eliminação de resíduos (legislação)
waste dump	descargas descontroladas de resíduos ; descargas descontroladas de resíduos (local)
waste paper	resíduos de papel
waste water	águas residuais
waste water purification	purificação de águas residuais
water	água
water ; body of water	água
water aeration	arejamento da água
water cost	custo da água
water desalination	dessalinização da água
water flea	pulgas de água
water level	nível de água
water mill	moinhos de água
water polo	pólo aquático
water protection legislation	protecção das águas (legislação)
water pump	bombas de água
water reservoir	depósitos de água
water resource	recursos hídricos
water salination	salinização de aquíferos
water supply	fornecimento de água
water treatment	tratamento de água
water well	poços de água
waterfall	cascatas
waterfowl	aves aquáticas
watershed	bacias hidrográficas (linhas de separação) ; linhas de separação
weapon	armas
weather	tempo
web ; spider web	teia
weed	ervas daninhas
week	semana
weekend	final de semana ; fim de semana
weight	peso (aspectos físicos) ; peso
welding	soldadura
well	poços ; poço
whale	baleias ; baleia
whaling	pesca da baleia
wheat	trigo
wheelchair	cadeira de rodas
whey	soro de leite
white	branco
wife ; spouse	esposa
wiki	wiki
wild animal	animais selvagens
wild fauna ; wildlife ; wild animals	fauna selvagem
wild plant	plantas selvagens
wildlife ; 野生生物	vida selvagem
willow	salgueiro
wind	vento
wind power	energia eólica
windmill	moinhos de vento
window	janela
wine	vinho
winter	inverno
witch	bruxa
witness	testemunha
wizard ; sorcerer ; magician	feiticeiro ; mago ; mágico
wolf	lobo
wood	bosque
wood	madeira
wood product	produtos de madeira
wool	lã
word	palavra ; vocábulo
work accident	acidentes de trabalho ; acidente de trabalho
workplace	locais de trabalho
world	mundo
world heritage site	sítio de património mundial
world war	guerra mundial
wound	ferimento ; ferida ; lesão ; mágoa
write	escrever
wrongful act	actos ilícitos
xenon	xenónio
xylophone	xilofone
y'all ; you ; you lot ; yous	vós
yacht	iate
yak	iaque
year ; solar year	ano
yeast	leveduras ; levedura
yellow	amarelo
yield	rendimento
young	jovens
ytterbium	itérbio
yttrium	ítrio
zebra	zebra
zero ; null	zero
zinc	zinco
zirconium	zircônio
zodiac	zodíaco
zoological garden	jardim zoológico
zoology	zoologia
zoonosis	zoonose
Åland Islands	Ilhas Åland
återställande ; rehabilitation	reabilitação
