English	Bulgarian
AIDS	Спин
AOX value	AOX стойност
ASEAN ; Association of Southeast Asian Nations	Asean
Abidjan	Абиджан
Abkhaz ; Abkhazian ; Abkhazian	абхазски
Abkhazia	Абхазия
Abuja	Абуджа
Aegean Sea	Егейско море ; Бяло море
Afghanistan ; Transitional Islamic State of Afghanistan	Афганистан
Africa	Африка
Afrikaans	Африкански ; африкански
Albania ; Republic of Albania	Албания
Algeria ; People's Democratic Republic of Algeria	Алжир ; Алжирска народно-демократична република
American Samoa	Американска Самоа
American football ; American football	американски футбол
Americas	Америка
Ames test	тест на еймс
Amsterdam	Амстердам
Andorra ; Principality of Andorra	Андора
Angola ; Republic of Angola	Ангола
Anguilla	Ангуила
Antarctic Ocean ; Southern Ocean	; Южен океан
Antarctic ecosystem	антарктична екосистема
Antarctica	Антарктида
Antigua and Barbuda	Антигуа и Барбуда
April	април
Aquarius	Водолей
Arabic ; Standard Arabic	арабски
Arctic Ocean	Северен ледовит океан
Arctic ecosystem	арктическа екосистема
Argentina ; Argentine Republic	Аржентина
Aries	Овен
Arizona	Аризона
Armenia	Армения
Armenian	арменски
Articulata	Членестоноги ; членестоноги
Aruba	Аруба
Asia	Азия
Athens	Атина
Atlantic Ocean	Атлантически океан
August	август
Australia ; Commonwealth of Australia	Австралия
Austria ; Republic of Austria	Австрия
Austria-Hungary ; Austro-Hungarian Empire	Австро-Унгария
Azerbaijani ; Azeri ; Azerbaijani Cluster	Азербайджански ; азербайджански
BBS ; bulletin board system	компютърна мрежа
Bahamas ; Commonwealth of the Bahamas ; Bahama Islands	Бахамски острови
Bahrain	Бахрейн
Balearic Islands	Балеарски острови
Bangladesh ; People's Republic of Bangladesh	Бангладеш
Barbados	Барбадос
Basque ; Basque	баски
Bavaria	Бавария
Beijing	Пекин
Belarus ; Republic of Belarus	Беларус
Belarusan ; Belarusan ; Belarusian ; Belorussian ; Byelorussian	белоруски
Belgium ; Kingdom of Belgium	Белгия
Belgrade	Белград
Belize	Белиз
Belmopan	Белмопан
Benin ; Benin ; Republic of Benin	Бенин ; Бенин
Berlin	Берлин
Bermuda	Бермуда
Berne	Берн\ ; Берн
Bhutan ; Kingdom of Bhutan	Бутан
Birmingham	Бирмингам
Black Sea	Черно море ; Черно море ; черно море
Bokmål	букмол
Bonn	Бон
Borneo ; Kalimantan	Борнео
Bosnia and Herzegovina ; Republic of Bosnia and Herzegovina	Босна и Херцеговина
Botswana ; Republic of Botswana	Ботсвана
Bouvet Island	Буве
Boötes	Воловар
Bratislava	Братислава
Brazil	Бразилия
Breton ; Breton	бретонски
Brunei ; Negara Brunei Darussalam	Бруней
Brussels	Брюксел
Bucharest	Букурещ
Bulgaria ; Republic of Bulgaria	България
Bulgarian	българин ; българин ; българка
Bulgarian ; Bulgarian	български
Burkina Faso	Буркина Фасо
Burundi ; Republic of Burundi	Бурунди
CD-ROM	cd-rom
CD-ROM search service	услуга cd-rom търсене
CFC ; chlorofluorocarbon	хлорофлуоровъглеводород
CFC and halons prohibition	Забрана над хлорфлуорвъглеводороди и халони ; забрана над хлорфлуорвъглеводороди и халони
California	Калифорния
Cambodia ; Kingdom of Cambodia	Камбоджа
Cameroon ; Republic of Cameroon	Камерун
Canada	Канада
Cancer	Рак
Capricorn	Козирог
Caribbean Area ; Caribbean	Карибски район
Caribbean Sea	Карибско море
Caspian Sea	Каспийско море
Cassiopeia	Касиопея
Castilian ; Spanish ; Spanish	испански език ; испански
Catalan ; Catalan	Каталонски ; каталонски
Cayman Islands	Кайманови острови
Central Africa	Централна африка
Central America	Централна америка
Central Asia	Централна азия
Chad ; Republic of Chad	Чад
Chile ; Republic of Chile	Чили
Christmas	Рождество Христово
Chuvash ; Chuvash ; Chuwash ; Chovash ; Chavash ; Chttash	чувашки
Cologne	Кьолн
Colombia ; Republic of Colombia	Колумбия
Community act	Акт на Общността ; акт на общността
Community budget	Бюджет на Общността ; бюджет на Общността
Community finance	финанси на общността
Community law	закон на общността
Community legal system	правна система на общността
Community ruling	управление на общността
Comoros ; Union of the Comoros	Комори
Copenhagen	Копенхаген
Court of Justice of the European Communities	Съд на Европейските общности
Croatia ; Republic of Croatia	Хърватска
Croatian ; Croation	хърватски
Cyprus ; Republic of Cyprus	Кипър
Czech ; Czech	чешки
Czech Republic ; Czechia	Чехия
DDT ; dichloro-diphenyl-trichloroethane	Ддт
DNA ; deoxyribonucleic acid	днк ; Дезоксирибонуклеиновата киселина ; дезоксирибонуклеиновата киселина
Dagestan	дагестан ; Дагестан
Dakar	Дакар
Danish	датски
December	декември
Delaware	Делауеър
Denmark ; Kingdom of Denmark	Дания
Dominican Republic	Доминиканска република
Dublin	Дъблин
Dutch	холандски
EC Council of Ministers	Съвет (на министрите) на Европейския съюз (предишно наименование Съвет на Европейската общност)
EC Treaty	Договор на Европейската общност
EC directive	директива на европейската общност
EC directive on biocides	директива на европейската общност за биоцидите
EC directive on waste disposal	директива на европейската общност за изхвърляне на отпадъците
EC directive on water protection	директива на европейската общност за опазване на водите
EC ecolabel	еко-етикет на европейската общност
EC policy	политика на европейската общност
EC regulation	регламент на европейската общност
EC regulation on eco-management and audit	регламент на европейската общност за управление и одит на околната среда
EC regulation on existing chemicals	регламент на европейската общност за съществуващи химикали
EIA (local)	ОВОС (местна) ; ОВОС (Оценка за въздействието върху околната среда, местна)
EIA ; environmental impact assessment	ОВОС ; оценка за въздействието върху околната среда
EIA directive	директива за овос
EIA law	закон за овос
EU ; European Union	Европейски съюз
EU Council	Съвет на Европейския съюз
Earth-Sun relationship	взаимодействие земя-слънце
East Africa	Източна африка
East Timor ; Democratic Republic of Timor-Leste	Източен Тимор
East-West relations	отношения изток-запад
East-West trade	търговия между изтока и запада
Easter	Великден
Eastern Asia ; East Asia	Източна азия
Eastern Europe	Източна европа
Egypt ; Arab Republic of Egypt	Египет
El Salvador ; Republic of El Salvador	Салвадор
England	Англия
English	английски
English garden	Английска градина ; английска градина
Erevan ; Yerevan	Ереван
Eritrea	Еритрея
Esperanto ; Esperanto	есперанто
Estonia ; Republic of Estonia	Естония
Estonian	естонски
Ethiopia ; Federal Democratic Republic of Ethiopia	Етиопия
Euratom	Евратом
Europe	Европа
European Commission	Европейска комисия
European Communities	Европейски общности
European Court of Justice	Европейски съд
European Environment Agency	Европейска агенция за околната среда
European Environmental Council	Европейски съвет за околната среда
European Monetary Fund	Европейски валутен фонд
European Monetary System ; EMS	Европейска валутна система
European Parliament	Европейски парламент
European nature reserve	европейски природен резерв
European standard	европейски стандарт
Falkland Islands	Фолкландски острови
Faroe Islands	Фарьорски острови
February	февруари
Fiji ; Republic of the Fiji Islands	Фиджи
Finnish	финландски
Flanders ; Flemish region	Фландрия
France	Франция
French ; French	френски
French Guiana	Френска Гвиана
French Polynesia	Френска Полинезия
French Southern Territories ; French Southern and Antarctic LandsA ; French Southern and Antarctic Lands ; Territory of the French Southern and Antarctic Lands	Френски южни и антарктически територии
French formal garden	френска класическа градина
Frisian ; Western Frisian	Фризийски ; фризийски
GDP ; gross domestic product	Брутен вътрешен продукт ; брутен вътрешен продукт
GDR ; German Democratic Republic	ГДР ; Германска демократична република
GIS digital format	ГИС цифров формат
GIS digital system	ГИС цифрова система
GIS digital technique	ГИС цифрова техника
GIS laboratory	ГИС лаборатория
Gabon ; Gabonese Republic	Габон
Galician ; Galician	галисийски
Gambia ; Gambia ; Gambia ; Gambia ; The Gambia ; Republic of The Gambia	Гамбия
Gaza Strip	Ивица Газа
Gemini	Близнаци
Georgia	Грузия
Georgia	Джорджия
Georgian ; Georgian	Грузински ; грузински
German	немски
German	немец ; германец ; немкиня ; германка
German	немски ; германски
Ghana ; Republic of Ghana	Гана
Global Environment Facility ; GEF	Улеснение за глобалната околна среда (GEF) ; Улеснение за глобалната околна среда
Great Britain ; Britain	Великобритания
Greece ; Hellenic Republic	Гърция
Greek ; Greek	гръцки
Greenland	Гренландия
Grenada	Гренада
Guadeloupe	Гваделупа
Guam ; Guam ; Guam	Гуам
Guinea-Bissau ; Republic of Guinea-Bissau	Гвинея-Бисау
Gujarati ; Gujarati	гуджаратски ; гуджарати
Haiti ; Republic of Haiti	Хаити
Hanover	Хановер
Happy New Year	честита нова година
Hebrew	еврейски
Hercules	Херкулес
Hindi ; Hindi	хинди
Holland ; Kingdom of the Netherlands ; The Netherlands	Холандия
Honduras ; Republic of Honduras	Хондурас
Hungarian	унгарски ; угорська
Hungary ; Republic of Hungary	Унгария
I	аз ; аз
IMCO code	IMCO код
IMF ; International Monetary Fund	Международен паричен (монетарен) фонд
ISO standard	ISO стандарти
Iceland ; Republic of Iceland	Исландия
Icelandic	исландски
Ido ; Ido	идо
Iliad	Илиада
India ; Republic of India	Индия
Indian Ocean	Индийски океан
Indonesia ; Republic of Indonesia	Индонезия
International Court of Justice	Международен съд
Internet	Интернет
Iran ; Islamic Republic of Iran	Иран
Iraq ; Republic of Iraq	Ирак
Ireland ; Republic of Ireland	Ирландия
Irish ; Irish ; Irish Gaelic ; Irish	ирландски
Israel ; State of Israel	Израел
Italian ; Italian	италиански
Italian Republic ; Italy	Италия
Ivory Coast ; Cote d'Ivoire ; Republic of Cote d'Ivoire	Кот д'Ивоар
Jakarta ; Djakarta ; DKI Jakarta	Джакарта
Jamaica	Ямайка
January	януари
Japan ; State of Japan	Япония
Japanese ; Japanese	японски
Jersey ; Bailiwick of Jersey	Джърси
Jordan ; Hashemite Kingdom of Jordan	Йордания
Judaism	юдаизъм
July	юли
June	юни
Kalaallisut	гренландски
Kazakhstan ; Republic of Kazakhstan	Казахстан
Kenya ; Republic of Kenya	Кения
Khartoum	Хартум
Khmer ; Central Khmer	кхмерски
Kiribati ; Republic of Kiribati	Кирибати
Korean ; Korean	корейски
Kosovo	Косово
Kuwait ; State of Kuwait	Кувейт
Kyoto	Киото
Kyrgyzstan ; Kyrgyz Republic	Киргизстан
Lagos	Лагос
Laos ; Lao People's Democratic Republic	Лаос
Latin ; Latin	латински
Latvia ; Republic of Latvia	Латвия
Latvian ; Latvian	латвийски
Lausanne	Лозана
Leningrad ; Petrograd ; Saint Petersburg ; St. Petersburg	Санкт Петербург
Leo	Лъв
Lesotho ; Kingdom of Lesotho	Лесото
Liberia ; Republic of Liberia	Либерия
Libra	Везни
Libya ; Great Socialist People's Libyan Arab Jamahiriya	Либия
Liechtenstein ; Principality of Liechtenstein	Лихтенщайн ; Княжество Лихтенщайн
Lisbon	Лісабон ; Лисабон
Lithuania ; Republic of Lithuania	Литва
Lower House	Долна камара
Lower Saxony	Долна Саксония
Luxembourg ; Grand Duchy of Luxembourg	Люксембург
Luxembourgish ; Luxemburgish ; Luxembourgian	Люксембургски ; люксембургски
Macedonia ; Republic of Macedonia	Македония
Macedonian ; Macedonian	македонски
Malawi ; Republic of Malaŵi	Малави
Malta ; Republic of Malta	Малта
Marathi ; Marāthi ; Marāthi ; MarÄthi	маратхи ; марати
March	март
Markov chain ; Markoff chain	марковска верига
Marshall Islands ; Republic of the Marshall Islands	Маршалови острови
Martinique	Мартиника
Massachusetts	Масачузетс
May	май
Mayotte	Майот
Mecca	Мека
Mediterranean Area	средиземноморие
Mediterranean Sea	Средиземно море
Mediterranean climate	средиземноморски климат
Mediterranean forest	средиземноморска гора
Mediterranean wood	ниски средиземноморски гори
Mercury	Меркурий
Merry Christmas	Весела Коледа
Milan	Милано
Milky Way ; Galaxy	Млечен път
Milwaukee	Милуоки
Moldova	Молдова
Monaco	Монако
Monday	понеделник
Montenegro	Черна гора
Montserrat	Монсерат
Morocco ; Kingdom of Morocco	Мароко
Moscow	Москва
Mount Fuji	Фуджи ; Фуджи-сан
Mozambique	Мозамбик
Mumbai ; Bombay	Мумбай ; Бомбай
Munich	Мюнхен
Myanmar	Мианмар
NIMBY aptitude ; NIMBY attitude	поведение "нвмзд"
NOEL	(NOEL)-ННЕ
Nagorno-Karabakh	Нагорни Карабах
Nairobi	Найроби
Namibia	Намибия
Naples	Неапол
Nauru ; Republic of Nauru	Науру
Neapolitan ; Neapolitan	неаполитански
Nepal	Непал
Nepali ; Nepali	непалски ; непалси ; непали
Neptune	Нептун
New Caledonia	Нова Каледония
New York	Ню Йорк
New Zealand	Нова Зеландия
Nicaragua	Никарагуа
Niue	Ниуе
North Africa	Северна Африка
North America	Северна Америка
North Atlantic Ocean	северен атлантически океан
North-South relationship	отношение север-юг
Northern Ireland	Северна Ирландия
November	ноември
Nuuk	Нуук
Oceania	Океания
October	октомври
Oklahoma	Оклахома
Orleans	Орлеан
Pacific Ocean	Тихи океан
Pakistan ; Islamic Republic of Pakistan	Пакистан
Palau	Палау
Panama	Панама
Papua New Guinea	Папуа Нова Гвинея
Parliament	парламент
Persian ; Western Farsi ; Farsi	фарси ; персийски
Peru ; Republic of Peru	Перу
Phobos	Фобос
Poland	Полша
Polish ; Polish	полски
Portugal	Португалия
Portuguese ; Portuguese	португалски
Puerto Rico	Пуерто Рико
Pyrrhic victory	пирова победа
Qatar	Катар
Republic of the Congo ; Congo-Brazzaville	Република Конго
Romanian ; Romanaian	румънски
Russia ; Russian Federation	Русия ; Руска федерация
Russian ; Russian	руски
Sagittarius	Стрелец
Saint-Pierre and Miquelon	Сен Пиер и Микелон
Sakhalin ; Saghalien	Сахалин
Samoa	Самоа
Sanskrit ; Sanskrit	санскрит
Saturn	Сатурн
Saudi Arabia ; Kingdom of Saudi Arabia	Саудитка Арабия
Saxony	Саксония
Scorpio	Скорпион
Scotland	Шотландия
Seine	Сена
Senegal	Сенегал
September	септември
Serbia	Сърбия
Serbia and Montenegro	Сърбия и Черна гора
Serbian ; Serbian	сръбски
Sicilian ; Sicilian	сицилиански
Slovak ; Slovak	Словашки ; словашки
Slovakia	Словакия
Slovene ; Slovenian ; Slovenian	словенски
Sochi	Сочи
Solomon Islands	Соломонови острови
South Africa	Република Южна Африка
South America	Южна Америка
Southeast Asia	Югоизточна Азия
Southern Asia ; South Asia	Южна Азия
Sri Lanka	Шри Ланка
Sudan	Судан
Suriname	Суринам
Swahili	суахили
Swedish	шведски
Switzerland	Швейцария
Syria ; Syrian Arab Republic	Сирия
Taiwan	Тайван
Tajik	таджикски
Tamil ; Tamil	тамилски
Tanzania	Танзания
Tatar ; Tatar	татарски
Taurus	Бик
Tehran	Техеран
Tennessee	Тенеси
Thai ; Thai	тайландски
Thailand	Тайланд
The Hague	Хага
Thuringia	Тюрингия
Togo	Того
Tokyo	Токио
Tonga	Тонга
Toronto	Торонто
Tswana	тсуана
Turkey	Турция
Turkish ; Turkish	Турски ; турски
Turkmenistan	Туркменистан
UN ; United Nations	Обединени нации
Uganda ; Republic of Uganda	Уганда
Ukraine	Украйна
Ukrainian ; Ukrainian	украински
United Arab Emirates	Обединени Арабски Емирства
United Kingdom ; United Kingdom of Great Britain and Northern Ireland ; UK	Обединеното кралство ; Обединено кралство Великобритания и Северна Ирландия
United States ; United States of America ; America ; US ; U.S. ; U.S.A. ; U.S. of A. ; States	Америка ; Съединени американски щати ; Съединените щати ; Щатите ; САЩ
Urdu ; Urdu	Урду ; урду
Vaduz	Вадуц
Vatican City ; The Holy See ; State of the Vatican City	Ватикан
Venezuela	Венецуела
Venice	Венеция
Venus	Венера
Vienna	Виена
Vietnamese ; Vietnamese	Виетнамски ; виетнамски
Wales	Уелс
Wallis and Futuna ; Territory of the Wallis and Futuna Islands	Уолис и Футуна
Welsh ; Welsh	Уелски ; уелски
Western Asia ; Southwest Asia	Западна Азия
Western Europe	Западна Европа
Wikipedia	Уикипедия
Wiktionary	Уикиречник
World Wide Web ; WWW	Световна уеб система
Wyoming	Уайоминг
Xhosa	кхоса
Yemen ; Republic of Yemen	Йемен
Yiddish	идиш
Yugoslavia	Югославия
Zambia ; Republic of Zambia	Замбия
Zanzibar	Занзибар
Zimbabwe ; Republic of Zimbabwe	Зимбабве
Zulu	зулуски
aAmplitude ; amplitude	aмплитуда
abandoned industrial site	Изоставен индустриален обект
abandoned vehicle ; car wreck	Изоставено превозно средство
abbreviation	съкращение
abiotic environment	нежива околна среда
abiotic factor	Абиотичен фактор ; абиотичен фактор
absorption	Попиване, всмукване, абсорбция
acceptable daily intake	Допустима дневна доза
acceptable risk level	Допустимо ниво на риска
access road	път за достъп
access to administrative documents	достъп до административни документи
access to culture	Достъп до култура
access to information	достъп до информация
access to the courts	достъп до съдилищата
accident	Злополука (инцидент) ; Злополука
accident source ; cause of the accident	Причина за инцидент ; причина за инцидент
accidental release of organisms	Случайно изпускане (отделяне) на организми
accordion ; squeeze box ; piano accordion	хармоника
account	сметка
accounting	счетоводство
accounting system	счетоводна система
accumulator	aкумулатор
acid	Киселина ; киселина
acid deposition	Киселинно утаяване
acid rain	Киселинен дъжд
acidification	Подкиселяване ; подкиселяване
acidity	Киселинност ; киселинност
acidity degree	Степен на киселинност ; степен на киселинност
acoustic comfort	Акустичен комфорт ; акустичен комфорт
acoustic filter ; audio filter	Акустичен (звуков) филтър ; акустичен филтър
acoustic insulation	Звукова изолация
acoustic level ; sound pressure level	Акустично ниво ; акустично ниво
acoustic property	Акустично свойство ; акустично свойство
acoustical quality	качество на звука
acoustics	акустика
acquisition	придобивам
act ; deed	акт ; действие ; Действие
actinide	Актиноиди ; актиноиди
actinium	Актиний (ас) ; актиний
action group ; action committee	Група за действие (активисти) ; група за действие
activated carbon	Активен въглен ; активен въглен
activated sludge	Активна утайка ; активна утайка
active participation	Активно участие ; активно участие
active population	Активно население ; активно население
adaptation period	Период на приспособяване
addition	събиране
additional packaging	Допълнителна опаковка
additive	Добавка, модификатор
adequate food supply	достатъчни хранителни запаси
adhesive	Лепило (свързващо вещество)
adjective ; describing word	прилагателно ; прилагателно име
adjust	приравнявам
administration ; direction ; management	Администрация ; администрация
administrative body ; administrative organ	административен орган ; административен орган
administrative boundary	Административна граница ; административна граница
administrative competence ; administrative ability	Административна компетентност ; административна компетентност
administrative deed	Административен акт ; административен акт
administrative fiat	Административно разрешение ; административно разрешение
administrative instructions	Административни инструкции ; административни инструкции
administrative law	Административно право ; административно право
administrative occupation	Административна длъжност ; административна длъжност
administrative organisation	административен орган
administrative procedure	Административна процедура ; административна процедура
administrative sanction	Административно наказание ; административно наказание
adoption	осиновяване
adsorption	Адсорбция ; адсорбция
adult	Възрастен ; възрастен
adult education	Обучение на възрастни ; обучение на възрастни
adverb	наречие
advertisement ; promotion	Реклама
advice	Съвет, препоръка ; Съвет ; препоръка ; съвет
aeration	Аерация, вентилиране ; аерация ; вентилиране
aerial photograph	Въздушна снимка
aerial photography	въздушна фотография
aerobic process	Аеробен процес ; аеробен процес
aerobic treatment	Аеробно третиране (обработка) ; аеробно третиране
aerobiology	Аеробиология ; аеробиология
aerodynamic noise	Аеродинамичен шум ; аеродинамичен шум
aeroplane ; bird ; plane	аероплан ; самолет
aerosol	Аерозол ; аерозол
aesthetics	Естетика
afforestation ; tree planting ; afforestment	Залесяване
afterburning ; afterburning ; afterburner	Доизгаряне ; доизгаряне
age	Възраст ; възраст
aggressive	нападателен
agoraphobia ; agoraphobia ; agoraphobia ; agoraphobia	агорафобия ; агорафобия ; агорафобия ; агорафобия
agreement	Договор ; договор
agreement	Постигане на споразумение, договор
agreement	Споразумение
agri-foodstuff	хранителна промишленост
agricultural biotechnology	Агробиотехнология ; агробиотехнология
agricultural building	Земеделски постройки
agricultural disaster	земеделско бедствие
agricultural ecology ; agroecology	Агроекология ; агроекология
agricultural economics	Икономика на земеделието
agricultural effluent	Отоци от земеделието ; отоци от земеделието
agricultural engineering	Агротехника ; агротехника
agricultural equipment	Земеделско оборудване
agricultural equipment ; agricultural machinery ; farm machinery	Земеделски машини ; земеделско оборудване ; земеделски машини
agricultural exploitation	Земеделско ползване
agricultural hydraulics	поливно земеделие
agricultural land	Земеделска земя
agricultural landscape	Земеделски ландшафт
agricultural legislation	Закон за селското стопанство ; закон за селското стопанство
agricultural management	Управление на селското стопанство ; управление на селското стопанство
agricultural method	Селскостопански метод
agricultural pest	Земеделски вредители ; земеделски вредители
agricultural planning	Земеделско планиране ; земеделско планиране
agricultural policy	Земеделска политика ; земеделска политика
agricultural pollution	Земеделско замърсяване ; земеделско замърсяване
agricultural product	Земеделски продукт ; земеделски продукт
agricultural production ; farm production ; agricultural output	Земеделско производство
agricultural real estate	земеделска собственост
agricultural storage	Земеделски склад
agricultural structure	земеделска структура
agricultural undervaluation	недооценяване (подценяване) на земеделието
agricultural waste	Земеделски отпадък
agriculture	Селско стопанство ; селско стопанство
agriculture ; agriculture	селско стопанство ; селско стопанство
agriculture and cattle industry	Земеделие и животновъдство
agriculture framework plan	Земеделски рамков план
agritourism	Агротуризъм (селски туризъм) ; агротуризъм
agrochemical	Агрохимикали ; агрохимикали
agroforestry	Агролесовъдство ; агролесовъдство
agroindustry	Агроиндустрия (агропромишленост) ; агроиндустрия ; агропромишленост
agrometeorology	Агрометеорология ; агрометеорология
agronomic value	Агрономична стойност ; агрономична стойност
agronomy	Агрономство ; агрономство
agrosystem	Агросистема ; агросистема
aid policy	политика за подпомагане (оказване на помощ)
air	Въздух ; въздух
air conditioning ; AC ; air-conditioning	Климатизиране (кондициониране) на въздуха ; климатизиране на въздуха ; кондициониране на въздуха
air movement	Движение на въздуха
air pollutant	Замърсител на въздуха
air pollution	Замърсяване на въздуха ; замърсяване на въздуха
air quality	Качество на въздуха
air quality control	Контрол върху качеството на въздуха
air quality management	Управление качеството на въздуха
air quality monitoring	мониторинг на качеството на въздуха
air sac ; alveolus	Алвеола ; алвеола
air safety	Въздушна защита
air temperature	Температура на въздуха
air traffic	Въздушен трафик
air traffic law	Закон за въздушното движение
air transportation	Въздушен превоз
air-water interaction	взаимодействие "въздух-вода"
airborne noise	въздушен шум
aircraft	Летателен апарат, самолет ; самолет ; летателен апарат
aircraft noise	Шум от летателен апарат ; шум от летателен апарат
airport	Летище
airspace planning	Въздушно планиране
alarm ; alert ; warning	аларма ; сигнал за тревога
albinism	албинизъм
alchemy	алхимия
alcohol	Алкохол ; алкохол
alcoholism	алкохолизъм
alga	Вадорасло ; вадорасло
algal bloom	цъфтеж на водорасли
algebra	алгебра
algicide ; algaecide	алгицид
alicyclic compound	Ацикличен разтвор ; ацикличен разтвор
alicyclic hydrocarbon	Ациклични въглеводороди ; ациклични въглеводороди
alignment	регулиране, настройка
aliphatic compound	Алифатно съединение ; алифатно съединение
aliphatic hydrocarbon	Алифатни въглеводороди ; алифатни въглеводороди
alkali soil	Алкални почви ; алкални почви
alkaline ; element of group I ; alkaline metal ; alkali metal	алкални ; елементи от първа група
alkaline battery	Алкална батерия ; алкална батерия
alkane ; paraffin ; methane series ; alkane series	Алкан, парафин ; алкан ; парафин
alkyl compound	Алкилно съединение ; алкилно съединение
all-terrain vehicle	всъдеход
allegory	алегория
allergen	алерген
allergy	Алергия ; алергия
allocation ; allotment ; resource allotment	Разпределена сума ; разпределена сума
allocation plan	план за разпределение
allowance	добавка
alloy	сплав
alluvial plain	Алувиална равнина ; алувиална равнина
alluvion ; flood ; overflowing ; inundation	Наводнение, нанос ; наводнение ; нанос
almost	почти
alpha radiation	Алфа лъчение ; алфа лъчение
alphabet	азбука
alternative material	Алтернативни материали ; алтернативни материали
alternative technology	Алтернативна технология ; алтернативна технология
altitude	височина
alumina	двуалуминиев триоксид
aluminium	Алуминий ; алуминий
aluminium container	Алуминиев контейнер ; алуминиев контейнер
aluminium content	Алуминиево съдържание ; алуминиево съдържание
aluminium industry	Алуминиева промишленост ; алуминиева промишленост
amalgam	Амалгама ; амалгама
ambassador	посланик
amethyst	аметист
amine	Амини ; амини
amino acid	Аминокиселина ; аминокиселина
ammonia	Амоняк ; амоняк
ammonification	насищане с амоняк
ammonium	Амониев радикал ; амониев радикал
amphibian	Амфибия ; амфибия
amphitheatre	амфитеатър
amusement park	увеселителен парк
anaerobic process	Анаеробен процес ; анаеробен процес
anaerobic treatment	анаеробно третиране ; анаеробно третиране
anagram	анаграма
analogy	аналогия ; подобие
analysis	Анализ ; анализ
analysis programme	програма на нализа
analytical chemistry	Аналитична химия ; аналитична химия
analytical equipment	Аналитично оборудване ; аналитично оборудване
analytical method	Аналитичен метод ; аналитичен метод
anarchism	анархизъм
anarchy	анархия
anatomy	Анатомия ; анатомия
anchor	котва
and ; as well as ; in addition to ; together with ; too	и
angiosperm ; flowering plant	покритосеменно растение ; цъфтящо растение
angling ; fishing ; line-fishing	риболов
animal	Животно ; животно
animal behaviour	животинско поведение
animal biology	зоология
animal conservatory	животински резерват
animal corridor	Животински коридор
animal damage	Щети, причинени от животни ; щети ; причинени от животни
animal disease	Болест по животните ; болест по животните
animal displacement	движение на животни
animal ecology	животинска екология
animal excrement	животински екскремент, тор
animal experiment	експеримент с животни
animal foodstuff	Храна за животни ; xрана за животни
animal for slaughter	кланични животни
animal habitat	животински ареал
animal heritage	животинско наследство
animal husbandry	животновъдство
animal manure	животинска тор
animal migration	миграция на животни
animal noise	Шум от животни ; шум от животни
animal nutrition	хранене при животните
animal physiology	животинска физиология
animal population	животинска популация
animal product	животински продукт
animal production	производство на животни (животинска продукция)
animal protection	защита на животните
animal reproduction	животинско възпроизводство
animal resource	животински ресурс
animal rights	права на животните
animal shelter	животински подслон
animal species	животински видове
animal species reintroduction	Реинтродукция (повторно въвеждане) на животински видове ; реинтродукция на животински видове ; повторно въвеждане на животински видове
animal trade	търговия с животни
animal waste	животински отпадък
anime	аниме
anion	Анион ; анион
anise	анасон
annelid	прешленести червеи
ant	мравка
antagonism	Антагонизъм ; антагонизъм
anthropic activity	Антропогенна дейност ; антропогенна дейност
anthropologic reserve	Антропологичен резерват ; антропологичен резерват
antibiotic	антибиотик
antibody	Антитяло ; антитяло
anticipation of danger	предвиждане на опасност
antifouling agent	средство против обрастване
antipollution incentive	механизми срещу замърсяването
antiquated plant	остарял завод
antiseismic regulation	противоземетръсни правила
antithesis	антитеза
apartheid	апартейд
apartment block	жилищен блок
apiculture ; beekeeping	пчеларство
apoptosis	апоптоза
appeal	обжалване
appeal procedure	Апелативна процедура ; апелативна процедура
apple	ябълка
applied ecology	приложна екология
applied nutrition	приложно хранене
applied research	приложно изследване
applied science	Приложна наука ; приложна наука
appraisal	оценка
approach	подход
appropriate technology	съответстваща (подходяща) технология
approval ; approbation	Одобрение ; одобрение
approval of installations	одобряване на инсталации (съоръжения)
aquaculture	водни култури
aquamarine	аквамарин
aquarium	аквариум
aquatic animal	водно животно
aquatic ecology	водна екология
aquatic ecosystem	водна екосистема
aquatic environment	водна околна среда
aquatic mammal	воден бозайник
aquatic organism	воден организъм
aquatic plant	водни растения
aqueduct	Аквадукт, водопровод ; аквадукт ; водопровод
aquifer	водоносен пласт
arable farming	земеделие
arboretum	дървесен разсадник
arboriculture	лесовъдство
archaeological site	Археологически обект ; археологически обект
archaeology ; archeology ; archæology	Архиология ; архиология
archbishop	архиепископ
archduke	ерцхерцог
archipelago	Архипелаг ; архипелаг
architect	архитект
architecture	Архитектура ; архитектура
area of potential pollution	район с потенциално замърсяване
area under stress	стресов район
argon	аргон
argument	кавга
arid land	Безводни земи ; безводни земи
arm	ръка
armament	въоръжение
armament conversion	оръжейна конверсия
armed forces	въоръжени сили
armistice	примирие
aromatic compound	Ароматно съединение ; ароматно съединение
aromatic hydrocarbon	Ароматни въглеводороди ; ароматни въглеводороди
aromatic substance	Ароматно вещество ; ароматно вещество
arrange ; adapt ; adjust ; conform ; accommodate ; suit	приспособявам
arrangement for a deposit on packaging	депозит за опаковки
arsenic	Арсен ; арсен
art	Изкуство ; изкуство
arthropod	Артропод ; артропод
article	член
artificial lake	изкуствено езеро
artificial reproductive technique	изкуствено репродуктивна техника
artificial satellite	изкуствен спътник
artist ; creative person	артист
asbestos	азбест
asbestos cement	Азбесто-цимент ; азбесто-цимент
asbestosis	Азбестоза ; азбестоза
ash	Пепел ; пепел
assay	съдържание/състав
assignment	поръчение
assimilation	Асимилация/поглъщане ; асимилация ; поглъщане
association	Асоциация ; асоциация
astatine	астатий
asthenosphere	астеносфера
astronautics	Астронавтика ; астронавтика
astronomy	Астрономия ; астрономия
asymptote	асимптота
atlas	Атлас ; атлас
atmosphere	Атмосфера ; атмосфера
atmospheric aerosol	Атмосферен аерозол ; атмосферен аерозол
atmospheric chemistry	химия на атмосферата
atmospheric circulation	Атмосферна циркулация ; атмосферна циркулация
atmospheric component	компоненти на атмосферата
atmospheric composition	Атмосферен състав ; aтмосферен състав
atmospheric correction	атмосферна корекция ; атмосферна корекция
atmospheric emission	емисии в атмосферата
atmospheric fallout	Атмосферно отлагане ; атмосферно отлагане
atmospheric layering	Атмосферен слой ; атмосферен слой
atmospheric monitoring	Атмосферен мониторинг ; атмосферен мониторинг
atmospheric ozone	атмосферен озон ; атмосферен озон
atmospheric particulate	Атмосферни частици ; атмосферни частици
atmospheric physics	Атмосферна физика ; атмосферна физика
atmospheric pollution	Атмосферно замърсяване ; атмосферно замърсяване
atmospheric precipitation ; precipitation	Атмосферни валежи ; атмосферни валежи
atmospheric process	Атмосферен процес ; атмосферен процес
atmospheric science	наука за атмосферата
atmospheric structure	Атмосферна структура ; атмосферна структура
atoll	атол
atrazine	Атразин ; атразин
attribute	Свойство, качество ; качество ; свойство
audio-visual presentation	Аудио-визуално представяне ; аудио-визуално представяне
audiovisual equipment	Аудио-визуално оборудване ; аудио-визуално оборудване
audiovisual media	Аудио-визуална медия ; аудио-визуална медия
audit	одит (ревизия)
authorisation	оторизиране (даване на правомощие) ; оторизиране
authority body	орган на властта
autoecology	Автоекология ; автоекология
automobile industry	Автомобилна индустрия ; автомобилна индустрия
avalanche	лавина, срутване
avalanche protection	защита от лавини/срутване
aviation law	закон за авиацията
aviculture	птицевъдство
avifauna	птици ; птича фауна
aye ; yeah ; yep ; yes	да
background level	фоново ниво
background noise	фонов шум
background radiation	фонова радиация
bacterial bed	Бактериален слой, биологично стъпало ; бактериален слой ; биологично стъпало
bactericide	Бактерицид ; бактерицид
bacteriological pollution	Бактериологично замърсяване ; бактериологично замърсяване
bacteriology	Бактериология ; бактериология
bacterium	Бактерии ; бактерии
bagpipes	гайда
baker	пекар
balance	баланс
balance of matter	Баланс на наличностите ; баланс на наличностите
balancing of interests	Баланс на интересите ; баланс на интересите
banana	банан
bank	Бряг ; бряг
bank protection	Брегова защита ; брегова защита
banking	Банкерство, банково дело ; банкерство ; банково дело
barium	Барий ; барий
barley	ечемик
barometer	барометър
barrier beach	Бариерен бряг ; бариерен бряг
barrier reef	Бариерен риф ; бариерен риф
base	основа
baseball ; baseball game	бейзбол
baseline monitoring	Базов мониторинг ; базов мониторинг
basic food requirement	основна хранителна необходимост
basicity	основност
basidiomycete	basidiomycete
basketball ; basketball game	баскетбол
bassoon	фагот
bastardisation of fauna	хибридизиране на фауната
bastardisation of flora	хибридизиране на флората
batch process	сериен процес
bathing freshwater	сладководни бани
bathing seawater	морски бани
bathing water	Бани ; бани
battery	Батерия, акумулатор ; батерия ; акумулатор
battery disposal	депониране на акумулатори
bay	залив
beach	полегат морски бряг
beach cleansing	Брегово почистване ; брегово почистване
beak ; mouth	уста
bear	мечка
beaver	бобър
bee	пчела
bee conservation	консервация на пчелите
beef cattle	кланични говеда
beer	бира
beetle	Бръмбар ; бръмбар
behaviour	поведение
behaviour of substances	поведение (свойства) на веществата
behaviour pattern	модел на поведение
behavioural science	наука за поведението
beneficial organism	полезен организъм
benthic division	Бентичен участък ; бентичен участък
benthos	Бентос ; вентос
benzene	Бензол ; бензол
benzopyrene	Бензопирен ; бензопирен
beryllium ; glucinium	Берилий ; берилий
beta radiation	Бета-излъчване ; бета-излъчване
beverage ; drink	Напитка ; напитка
beverage industry	производство на напитки
bibliographic information	Библиографска информация ; библиографска информация
bibliographic information system	Библиографска информационна система ; библиографска информационна система
bibliography	Библиография ; библиография
bicycle ; bike ; cycle	Велосипед ; велосипед
big ; large	голям ; едър
big game	едър дивеч
bilateral convention	двустранна конвенция
bilge oil	трюмно масло
bilge water	трюмна вода
bio-availability	Бионаличност ; бионаличност
bioaccumulation	Бионатрупване ; бионатрупване
bioaccumulative pollutant	Биоакумулиран замърсител ; биоакумулиран замърсител
biochemical method	Биохимичен метод ; биохимичен метод
biochemical oxygen demand	Биологично потребност от кислород (БПК) ; биологично потребност от кислород ; БПК
biochemical process	Биохимичен процес ; биохимичен процес
biochemical substance	Биохимични вещества ; биохимични вещества
biochemistry	Биохимия ; биохимия
biocide	Биоцид ; биоцид
bioclimatology	Биоклиматология ; биоклиматология
biocoenosis	Биоценоза ; биоценоза
bioconcentration factor	коефициент на биоконцентрация
biodegradability	Биоразграждане ; биоразграждане
biodegradable pollutant	Биоразграждащ се замърсител ; биоразграждащ се замърсител
biodegradation	Биоразграждане ; биоразграждане
biodiversity	Биоразнообразие ; биоразнообразие
bioethics	Биоетика ; биоетика
biofiltration	Биофилтрация ; биофилтрация
biofuel	Биогориво ; биогориво
biogas	Биогаз ; биогаз
biogeochemical cycle	Биохимичен цикъл ; биохимичен цикъл
biogeographical region	Биогеографски район ; биогеографски район
biogeography	Биогеография ; биогеография
biological analysis	Биологичен анализ ; биологичен анализ
biological attribute	Биологично свойство ; биологично свойство
biological contamination	Биологично замърсяване ; биологично замърсяване
biological cycle	Биологичен цикъл ; биологичен цикъл
biological development	Биологично развитие ; биологично производство
biological effect	Биологичен ефект ; биологичен ефект
biological effect of pollution	Биологичен ефект от замърсяването ; биологичен ефект от замърсяването
biological engineering	Биологично инженерство ; биологично инженерство
biological heritage	Биологично наследство ; биологично наследство
biological indicator	биологичен индикатор
biological monitoring	Биологичен мониторинг ; биологичен мониторинг
biological pest control	Биологичен контрол над пестицидите ; биологичен контрол над пестицидите
biological pollutant	Биологичен замърсител ; биологичен замърсител
biological pollution	Биологично замърсяване ; биологично замърсяване
biological process	Биологичен процес ; биологичен процес
biological production	Биологично производство ; биологично производство
biological reserve ; wildlife reserve	Биологичен резерват ; биологичен резерват
biological resource	Биологичен ресурс ; биологичен ресурс
biological test	Биологичен тест ; биологичен тест
biological treatment	Биологична обработка ; биологична обработка
biological waste gas purification	Биологично пречистване на отпадни газове ; биологично пречистване на отпадни газове
biological waste treatment	Биологично третиране на отпадъци ; биологично третиране на отпадъци
biological wastewater treatment	Биологично пречистване на отпадни води ; биологично пречистване на отпадни води
biological water balance	Биологичен воден баланс ; биологичен воден баланс
biological weapon	Биологично оръжие ; биологично оръжие
biology ; biological science	Биология ; биология
bioluminescence	Биолуминесценция ; биолуминесценция
biomarker	Биомаркер ; биомаркер
biomass	биомаса ; биомаса
biomass energy	енергия от биомаса
biophysics	Биофизика ; биофизика
bioreactor	Биореактор ; биореактор
biorhythm	Биоритъм ; биоритъм
biosafety	Биологична безопасност (биозащита) ; биологична безопасност ; биозащита
biosphere	Биосфера ; биосфера
biosphere reserve	Биосферен резерват ; биосферен резерват
biosynthesis	Биосинтез ; биосинтез
biotechnological hazard	Биотехнологична опасност/риск ; биотехнологична опасност ; биотехнологична риск
biotechnology	Биотехнология ; биотехнология
biotic factor	Биотичен фактор ; биотичен фактор
biotic index	Биотичен индекс ; биотичен индекс
biotope	Биотоп ; биотоп
biotope network	Биотопна мрежа ; биотопна мрежа
biotope order	статут на биотоп
biotope protection	Биотопна защита ; биотопна защита
bird	Птица ; птица ; птичка
bird of prey	хищна птица
bird sanctuary	резерват за птици
bird species	птичи видове
birth ; birth ; birth ; childbirth ; childbirth ; childbirth ; parturition	раждане
birth control	контрол на раждаемостта
bishop	епископ
bismuth	бисмут
bitumen	Битум ; битум
black coal ; black coal ; black coal ; anthracite coal	Черни въглища ; черни въглища
blackbird	кос
blast furnace	доменна /висока/ пещ
bleaching agent	избелващо вещество
bleaching clay	избелваща глина
bleaching process	избелващ процес
blood	Кръвоносна тъкан ; кръвоносна тъкан ; кръв
blue	син
blue-green alga ; cyanobacteria	синьо-зелени водорасли
boating	каране на лодка
bocage	Бокаж (bocage) ; бокаж
bog	блато ; блато
boiler	котел
boiling point	точка на кипене
bonsai	Бонзай ; бонзай
book	Книга ; книга
bookkeeping	Архив, книговодство, счетоводство ; архив ; книговодство ; счетоводство
border	Граница ; граница
boron	Бор ; бор
botanical conservatory	Ботанически консерватор ; ботанически консерватор
botanical garden	Ботаническа градина ; ботаническа градина
botany	ботаника
botany ; phytology	Ботаника ; ботаника
bottle cap	запушалка
boundary crossing	пресичане на граница
boundary layer	граничен слой
brackish water	Възсолена вода ; възсолена вода
branch of activity	клон (бранш) на дейност
breakfast	закуска
breast milk	кърма
breeding	селекция ; селекция
breeding bird	носеща птица (носачка)
breeding technique	разплодни техники
brick	тухла
bridge	Мост ; мост
broad-leaved tree	широколистно дърво
bromine	Бром ; бром
brooding	мътене
brook	поток, ручей
brushwood	храсталак, шубрак
bryophyte	Бриофит ; бриофит
bubble policy (emissions trading) ; bubble policy	Политика на мехура (търговия с емисии) ; политика на мехура
budget	Бюджет ; бюджет
budget policy	Бюджетна политика ; бюджетна политика
bug ; põrnikas	Бръмбар ; Бръмбар, буболечка ; буболечка ; бръмбар
building	Сграда ; строителство ; сграда
building area	Строителен обект ; строителен обект
building component	строителен компонент
building destruction	разрушаване на сгради
building industry	строителна промишленост
building land	строителен парцел
building material	строителен материал
building materials industry	производство на строителни материали
building permit	разрешително за строеж
building planning	строително планиране
building regulation	строителна регулация
building related illness ; sick building syndrome	синдром на болестотворните сгради
building restoration	реставрация на сгради
building service	строителни услуги
building site	Строителен обект ; строителен обект
building site preparation	подготовка на строителен обект
building technology	строителна технология
building waste	строителни отпадъци
built drainage system	изградена дренажна система
built environment	застроена околна среда
built structure	строителна конструкция
built-up area	Застроен район ; застроен район
bulb cultivation	култивиране на луковици
bulky waste	едри отпадъци
bureaucratisation	Бюрократизация ; бюрократизация
bus ; coach	Автобус ; автобус
bus station	Автобусна спирка ; автобусна спирка
bush clearing	разчистване на храсти
business	Работа ; работа
business activity	Бизнес дейност ; бизнес дейност
business classification	Бизнес класификация ; бизнес класификация
business economics	Бизнес икономика ; бизнес икономика
business organisation	Бизнес организация ; бизнес организация
business policy	Бизнес политика ; бизнес политика
butter	масло
butterfly	пеперуда
button ; clit ; clitoris	клитор
button-cell battery	клетъчна батерия
buy ; purchase	купувам
buy ; purchase	Покупка ; покупка
by-catch	страничен улов
by-product	страничен продукт
cable	кабел
cactus	кактус
cadmium	кадмий
caesium	цезий
caffeine	кофеин
calcium	калций
calcium content	съдържание на калций
calculation	изчисление
calculation method	метод за изчисление
calendar	календар
caliber	калибър
calibration	калибровка
camel	камила
camera	фотоапарат
camouflage	камуфлаж
camp ; military camp ; army camp ; campsite	лагер
camping ; camping ground	къмпинг
camping site	къмпингов терен
canal	канал
canal lock	Шлюз на канал ; шлюз на канал
cancer	рак
cancer risk	риск от раково заболяване
canid	куче
canyon	каньон
car ; automobile	Кола ; кола
car park	Паркинг ; паркинг
car tyre	Автомобилна гума ; автомобилна гума
carbohydrate	въглехидрат
carbon	въглерод
carbon dioxide	Въглероден двуокис ; въглероден двуокис
carbon dioxide tax	такса върху горива
carbon monoxide	въглероден окис
carbonate	карбонат
carcass disposal	трупно сметище
carcinogen	канцерогенно вещество
carcinogenicity	канцерогенност
carcinogenicity test	тест за канцерогенност
cardiology	кардиология
cardiovascular disease	сърдечно-съдово заболяване
cardiovascular system	сърдечно-съдова система
carnivore	месоядно
carry-over effect	преносен ефект
cartography	картография
case ; lawsuit ; trial	Процес ; процес
cash crop	касова култура
castle	замъкIкрепост
cat	котка
catalysis	катализа
catalyst	катализатор
catalytic converter	каталитичен преобразувател каталитичен неутрализатор
catapult	катапулт
catastrophe	катастрофа
catch yield	рандеман, улов
catchment	водохващане
catchment area	водохващащ район
category	категория
category of endangered species	категория застрашени видове
cation	катион
cattle	едър рогат добитък
cauliflower	карфиол
cause-effect relation	връзка причина - ефект (следствие)
cave	пещера
celery	целина
cell ; cell	клетка ; клетка
cell ; electrochemical cell ; energy cell ; Galvanic cell ; στοιχείο	клетка
cellulose	целулоза
cellulose industry	целулозна промишленост
cement	цимент
cement industry	циментова промишленост
cement manufacture	производство на цимент
census survey	преброяване на населението
central government	централно правителство
central park area	централен парков район
centralisation	Централизация ; централизация
centrifugation	центрофугиране
cephalopod	главоного
ceramics	керамика
ceramics industry	керамична промишленост
certification	удостоверяване
cetacean	Китообразно ; китообразно
chair	стол
chalk	Варовик, креда ; варовик ; креда
champagne	шампанско вино
change in value	промяна на стойността
channelling	канализиране
chaos theory	теория на хаоса
characteristic	характеристика
charcoal	дървени въглища
chart	Харта, устав ; харта ; устав
chart ; nautical chart	морска карта
cheers ; thank you ; thanks	благодаря
cheese	сирене
chelicerate	chelicerate
chemical	Химикал ; химикал
chemical addition	Химическа добавка
chemical analysis	химически анализ
chemical composition	химически състав
chemical contamination	химическо замърсяване
chemical corrosivity	химическа корозионност
chemical decontamination	химическо очистване (дезактивация)
chemical element ; element	Химически елемент ; химически елемент
chemical fallout	химическа утайка (фолаут)
chemical fertiliser	химически тор
chemical in the environment	химикал в околната среда
chemical industry	химическа промишленост
chemical installation	химическа инсталация
chemical measurement of pollution	химическо измерване на замърсяването
chemical oxygen demand	химическо търсене на кислород
chemical pest control	химическо регулиране на вредители
chemical plant	химическо предприятие /съоръжение/
chemical policy	химическа политика
chemical pollutant	химически замърсител
chemical pollution	химическо замърсяване
chemical process	химически процес
chemical product	химическо изделие
chemical property	химическо свойство
chemical reaction	химическа реакция
chemical reduction	химическо редуциране
chemical risk	химически риск
chemical structure	химическа структура
chemical treatment	химическа преработка
chemical waste	химически отпадък
chemical weapon	химическо оръжие
chemicals act	действие на химикалите
chemisorption	хемисорбция
chemist ; pharmacist	аптекар
chemistry	Химия ; химия
chestnut	кестен
chicken	пиле
child	Дете ; дете
chimney	Комин ; комин
chimney height	височина на комин
chimpanzee	шимпанзе
chipmunk	бурундук
chiropteran	Чироптеран ; чироптеран
chloride	Хлорид ; хлорид
chlorinated hydrocarbon	хлориран въглеводород
chlorination	хлориране
chlorine	хлор
chlorophenol	хлорофенол
chlorophyll	хлорофил
chlorosis	хлороза
chocolate	шоколад
cholesterol	холестерол
chordate	кордейт
chorology	хорология
chromatographic analysis	хроматографски анализи
chromatography	хроматография
chromium	хром
chrysophyta	Чрисофита ; чрисофита
church	църква ; черква
cigarette	цигара
cinematographic film	кинематографичен филм
circular mail	циркулярно писмо
citizen	гражданин
citizen awareness	гражданско съзнание
citizen initiative	гражданска инициатива
citizen rights	граждански права
city	сити /голям град/
city centre	Градски център ; градски център
civil air traffic	гражданско въздухоплаване
civil engineering	строително инженерство
civil law	гражданско право
civil safety	гражданска безопасност
civilian protection	гражданска защита
claim for restitution	граждански /реституционен/ иск
clarinet	кларинет
classification	класификация
clay	Глина ; глина
clean air area	зона, чиста от вещества разрушаващи озоновия слой
clean air car	екологичен автомобил
clean technology	екологично чиста технология
cleaning up	почистване на околната среда
cleanliness	чистота
cleansing department	служба по чистотата
clearing sludge	изчистване на утайка
cliff	канара
climate	Климат ; климат
climate protection	опазване на климата
climate resource	климатичен ресурс
climate type	вид на климата
climatic alteration	климатични изменения
climatic change ; climate change	промяна на климата
climatic effect	Въздействие на климата ; въздействие на климата
climatic experiment	климатичен експеримент
climatic zone	климатична зона
climatology	климатология
climax	Климакс ; климакс
climbing plant (wall) ; climbing plant	пълзящо растение
clinical symptom	клиничен симптом
cloning	клониране
closing down	прекратяване
closing down of firm	затваряне на предприятие
clothing ; apparel	Облекло ; облекло
clothing industry	Шивашка промишленост ; шивашка промишленост
cloud	облак
co-incineration	комбинирано изгаряне
co-operation	cътрудничество
co-operation policy	политика на сътрудничество
co-operation principle	принцип за съгласуване на действията
co-ordinate system	координатна система
co-ordination	координация
coagulation	коагулация
coal	въглища
coal industry	въгледобивна промишленост
coal liquefaction	втечняване на въглищата
coal mining	въгледобив
coal refining	рафиниране на въглищата
coal technology	въглищна технология
coal-based energy	енергия, на въглищна основа
coal-fired power plant	въглищна енергостанция
coast	крайбрежие
coast protection	крайбрежна защита
coastal area	крайбрежна зона
coastal development	развитие на крайбрежията
coastal ecosystem	крайбрежна екосистема
coastal environment	крайбрежна околна среда
coastal fishing	крайбрежен риболов
coastal pollution	замърсяване на крайбрежията
coastal water	крайбрежни води
coastal zone planning	планиране на крайбрежната зона
coastguard	Брегова охрана ; брегова охрана
coating	Мазилка, покритие ; мазилка ; покритие
cobalt	кобалт
cocaine	кокаин
cockroach	Хлебарка ; хлебарка
code	сборник закони, кодекс
code of practice	Юридически наръчник ; юридически наръчник
codification	кодификация
coelenterate	мешести животни
cogeneration	комбинирано производство на енергия
coke	кокс
cold	Студ ; студ
coliform bacterium	колиформни бактерии (коли бактерии)
colina ; hill ; loma	хълм
collective wastewater treatment	общо (колекторно) пречистване на отпадъчни води
colloid	колоид
colloidal state	колоидно състояние
colonisation	колонизация /заселване/
colour ; colour ; colo(u)r	Цвят ; Цвят ; Цвят ; цвят
colour composition	състав на цвета
colourimetry	Цветометрия ; цветометрия
colubrid	колубрид
combination effect	комбиниран ефект
combined cycle-power station	енергийна централа с комбиниран цикъл на производство
combined sewer system	комбинирана канализационна система
combined transport	комбиниран транспорт
combined waste water	смесени отпадъчни води
combustibility	възпламенимост
combustion engine	двигател с вътрешно горене
combustion gas	горивен газ
combustion residue	горивен остатък
commercial fishery	търговски риболов
commercial law	търговско право
commercial noise	търговски шум
commercial traffic	търговски трафик
commercial transaction	търговска сделка
commercial vehicle	търговско транспортно средство
commercialisation	комерсиализация
common agreement	неписано споразумение
common agricultural policy ; common agricultural policy of the EU	Обща селскостопанска политика
common commercial policy	обща търговска политика
common tariff policy	обща тарифна политика
communications	Съобщения (комуникации) ; съобщения ; комуникации
communications industry	комуникационна промишленост
communications policy	комуникационна политика
communications system	система за комуникации
communism	комунизъм
community facility ; public facility	обществено средство
community-pays principle	принцип на общностно заплащане
commuter traffic	трафик от лица редовно пътуващи с карта
compaction	уплътняване ; уплътняване
company policy	политика на компанията
company structure	структура на компанията
comparative law	сравнително право
comparative test	сравнителна проверка
comparison	сравнение
compensation	обезщетение
compensation for damage	обезщетение за вреди и загуби
compensatory measure	компенсаторна мярка
compensatory tax	компенсаторен данък
competition	конкуренция
competition law	закон за конкуренцията
competitive examination	конкурсно изпитване
competitiveness	конкурентоспособност
complex formation	комплексообразуване
complexing agent	комплексообразуващ агент
composite pollution	комбинирано (композитно) замърсяване
composition of population	състав на населението
compost	смесен тор, компост
compostable waste	отпадъци, поддаващи се на биологично разпадане
composting	получаване на компост
composting by producer	получаване на компост от производителя
compound ; chemical compound	химическо съединение
compression	свиване, компресия ; свиване ; компресия
compressor	компресор
concentration	концентрация
concentration	концентриране
concept of environment	понятие за околна среда
concession	Отстъпка, концесия ; концесия ; отстъпка
concrete	Бетон ; бетон
concrete products industry	промишленост за производство на бетонни продукти
condensation (process) ; condensation	Кондензация (процес) ; кондензация
condom ; prophylactic ; rubber ; safe ; safety	презерватив
conductivity ; electrical conductivity	проводимост
conflict	противоречие, стълкновение, конфликт
conflict of aims	противоречие на целите
conflict of interests	конфликт на интереси
conflicting use	използване на конфликти
congress	конгрес
conifer	иглолистни растения
coniferous forest	Иглолистна гора ; иглолистна гора
coniferous tree	иглолистно дърво
conservation	Консервация, съхранение, пестене ; консервация ; съхранение ; пестене ; консервация
conservation of monuments	Консервация на паметници ; консервация на паметници
conservation policy	консервационна политика
consideration	разглеждане
constitution	конституция
constitutional law	конституционно право
construction equipment	строително оборудване
construction noise	строителен (конструкционен) шум
construction policy	строителна политика
construction technology	строителна технология
construction with recycled material	строителство с вторична употреба на материали
construction work	строителни работи
consultancy	консултантски услуги
consultation	Съветване, консултация ; cъветване ; консултация
consumer behaviour	поведение на потребителя
consumer goods	Стоки за потребление ; стоки за потребление
consumer group	потребителска група
consumer information	Потребителска информация ; потребителска информация
consumer product	потребителски продукт
consumer protection	Защита на потребителя ; защита на потребителя
consumer waste	Потребителски отпадъци ; потребителски отпадъци
consumption	Потребление, консумация ; консумация ; потребление
consumption pattern	Консуматорски модел ; консуматорски модел
container	контейнер ; Съд ; съд
containment (nuclear industry) ; containment	Противоаварийна обвивка на реактор (в ядрената промишленост) ; противоаварийна обвивка на реактор
contaminated soil	Замърсена почва ; замърсена почва
contamination	замърсяване ; замърсяване
continent	Континент ; континент
continental climate	континентален климат
continental shelf	Континентален шелф, плитчина ; континентален шелф ; плитчина
continuing education	продължително образование
continuous load	Непрекъснато натоварващо замърсяване ; непрекъснато натоварващо замърсяване
contour farming	Контурна обработка на земята ; контурна обработка на земята
contract	Договор ; договор
control measure	контролна мярка
controlled burning	контролирано изгаряне
controlled hunting zone	зона за контролиран лов
controlling authority	контролен орган
conurbation	Конурбанизация, градосливане ; конурбанизация ; градосливане
convention	Конвенция ; конвенция
conventional energy	конвенционална енергия
cooling	понижение на радиоактивността
cooling oil	охлаждащо масло
cooling tower	охладителна кула
cooling water	Охлаждаща вода ; охлаждаща вода
copper	Мед ; мед
coppice	Млада гора, храсталак ; млада гора, ; храсталак
coppice with standards	подрязване по стандарт
coral	корал
coral reef	коралов риф
coral reef lagoon	лагуна от коралов риф
core meltdown	стапяне в активната зона на ядрен реактор
cork	корк
corridor	коридор
corrosion	корозия
corrosion inhibitor	инхибитор на корозията
cosmetic industry	козметична промишленост
cosmic radiation	космическа радиация
cosmology	kосмология
cost	Себестойност, цена ; себестойност ; цена
cost increase	увеличаване на цената (себестойността)
cost reduction	намаляване на цената (себестойността)
cost-benefit	Съотношение разход-полза ; съотношение разход-полза
cost-benefit analysis	Анализ на съотношението разход-полза ; анализ на съотношението разход-полза
cotton	памук
country ; nation ; state	държава
country lodge	провинциална къщичка
county	Област ; област
court	съд
court of justice	Апелативен съд ; апелативен съд
cove	Вдлъбнатина в скала ; вдлъбнатина в скала
covering ; roofing	покриване
cow	крава
craft ; arts and crafts	Занаят ; занаят
credit	кредит
credit assistance	кредитна помощ
credit policy	кредитна политика
creek	тясно заливче
crime	Престъпление ; престъпление
criminal law	наказателно право
criminal law procedure	наказателна практика
criminal liability	наказателна отговорност
criminality	Престъпност ; престъпност
crisis management	управление на кризите
critical level	критично ниво
critical load	Критично натоварване ; критично натоварване
crocodile	Крокодил ; крокодил
crop production	добиване на реколта
crop protection	опазване на реколтата
crop rotation	ротация на културите
crop treatment	третиране на посевите
crossing place	Пешеходна пътека ; пешеходна пътека
crossing place for animals	място за пресичане на животни
crude oil	Суров нефт ; суров нефт
cruising	пътуване по море
crustacean	раковидни
cryptogam	Тайно брачно растение ; тайно брачно растение
crystal	кристал
crystallisation	кристализация
crystallography	кристалография
cucumber	краставица
cultivated plant	култивирано растение
cultivation ; tillage	Култивиране ; култивиране
cultivation method	метод на култивация
cultivation of agricultural land	култивация на селскостопанска земя
cultivation system	система за култивация
cultural development	културно развитие
cultural facility	културен дом
cultural heritage	културно наследство
cultural indicator	Културен показател
cultural policy	културна политика
culture	култура
curium	кюрий
currency	валута
curriculum	Учебен план ; учебен план
customs	мита
customs regulation	митническа наредба
customs tariff	митническа тарифа
cutting	сеч
cutting ; cutting (vegetative propagation)	Рязане (в растениевъдството) ; рязане
cyanate	цианат
cyanide	цианид
cycle path	велосипедна пътека
cyclone	Циклон ; циклон
cytology	цитология
cytotoxicity	Цитотоксичност ; цитотоксичност
dairy farm	мандра
dairy industry	млечна промишленост
dairy product	млечен продукт
dam	Язовир ; язовир
dam draining	източване на язовир
damage	Щета ; щета ; повреда
damage assessment	оценка на щетите
damage from military manoeuvres	Щети от военни маневри ; щети от военни маневри
damage insurance	застраховка щети
damage prevention	предпазване от щети
dandelion	глухарче
danger analysis	Анализ на опасността ; анализ на опасността
dangerous goods	опасни стоки
dangerous goods law	закон за опасните стоки
dangerous goods regulation	наредба за опасните стоки
dangerous installation	опасна инсталация
dangerous materials transport	транспорт на опасни материали
data acquisition	събиране на данни
data analysis	Анализ на данни ; анализ на данни
data carrier	носител на данни.
data centre	център за данни
data exchange	Обмен на данни ; обмен на данни
data on the state of the environment	данни за състоянието на околната среда
data processing	обработка на данни
data processing law	закон за работа с данни
data processing system	система за обработка на данни
data protection	опазване на данните
data recording technique	методи за запис на данни
database	база данни
dating	Датиране ; датиране
daughter	дъщеря
de-inking	обезмастиляване
deaf	глух
debit	задължавам
debt	дълг
debt service	обслужване на дълга
decay product	продукт на разпадане
decentralisation	децентрализация
dechlorination	дехлориране
decibel	децибел
deciduous forest ; deciduous wood	Широколистна гора ; широколистна гора
deciduous tree	широколистно дърво ; широколистно дърво
decision	Решение ; решение
decision making support	подпомагане при вземане на решения
decision process	процес на решаване
decision-support system	система за подпомагане при вземане на решения
declaration of public utility	отчуждаване
decomposition	Разлагане ; разлагане
decontamination	обеззаразяване
decree	Постановление ; постановление
deep sea	открито море
deep sea fishing	риболов в дълбоки води
deep sea mining	дълбоководно извличане на природни ресурси
deep-sea disposal	изхвърляне в дълбоки води
deer	Елен ; елен
defence	защита
defoliation	обезлистяване
deforestation	обезлесяване
degradability	възможност за разграждане
degradation	Разпадане ; разпадане
degradation of natural resources	упадък на природните ресурси
degradation of the environment	влошаване на околната среда
degradation product	продукт на разграждане
degreasing	обезмасляване
dehydrated sludge	обезводнена утайка
delegated management	делегирано управление
deliver	раждам
delta	Делта ; делта
demand	Търсене ; търсене
demesnial water	вода национална собственост
democracy	Демокрация ; демокрация
demographic development	демографско развитие
demographic evolution	демографска еволюция
demography	демография
demolition business	работи по събаряне
demolition waste	отпадъци при събаряне
demonstrability	възможност за показване
dendrochronology ; tree-ring dating	дендрохронология
dendrometry	дендрометрия
dengue fever	денга
denitrification	деазотиране, обедняване откъм азот
denitrification of waste gas	деазотиране на отходни газове
density	плътност
dentist	зъболекар
deposition	отлагане
deregulation	дерегулиране
dermatology	дерматология
desalination	обезсоляване
desalination plant	инсталация за обезсоляване
desert	Пустиня ; пустиня
desert climate	пустинен климат
desert locust	пустинен прелетен скакалец
desertification	превръщане в пустиня, опустошаване
desertification control	контрол над опустошаването
design (project) ; design ; project design	Чертеж (проект) ; чертеж (проект)
desk study	кабинетно проучване
desorption	Десорбция ; десорбция
destination of transport	местоназначение при транспортиране
desulphurisation	Отстраняване на сярата ; отстраняване на сярата
desulphurisation of fuel	отстраняване на сярата от горивото
detection	Разкриване ; разкриване
detector	детектор
detergent	миещо средство, детергент ; миещо средство ; детергент
determination method	метод за определяне
deterrence	превенция
deterrent	превантивна
detoxification	Детоксикация, обезвреждане ; детоксикация ; обезвреждане
developed country	развита страна
developing country	Развиваща се страна ; развиваща се страна
development aid	помощ за развитие
development area	развиваща се област
development co-operation	сътрудничество за развитие
development model	модел на развитие
development pattern	образец на развитие
development plan	план за развитие
devolution	прехвърляне на власт
dialysis	диализ
diary	дневник
diatom	диатомея
dice ; die ; die ; die	зар
dictionary	речник ; речник
didactics	дидактика
diesel engine	дизелов двигател
diesel fuel ; diesel	Дизелово гориво ; дизелово гориво
differentiation	диференциация
difficult	труден
diffuse pollution	дифузно замърсяване
diffuse source	дифузен източник
diffusion	дифузия
digested sludge	Бактериално усвоена утайка ; бактериално усвоена утайка
digester	метан танк
digestion	бактериално усвояване
digital image processing technique	методика за обработка на цифров образ
digital land model	цифров модел на земна повърхност
digitising	преобразуване в цифров код
diluted acid	разредена киселина
dioxin	диоксин
dipteran	диптеран
direct discharger	пряко заустващ замърсител
directive	директива
disabled person	сакат човек
disaster	Бедствие ; бедствие
disaster cleanup operation	операция за справяне с бедствие
disaster contingency plan	план за справяне с бедствия
disaster control service	служба за контрол на бедствията
disaster preparedness	готовност за посрещане на бедствия
disaster prevention	предотвратяване на бедствие
disaster relief	помощ при бедствие
disaster zone	зона на бедствие
discharge regime	режим на заустване
discrimination	дискриминация
disease ; illness ; affliction	заболяване
disease cause	причина за болестта
disinfectant	дезинфекционно средство
disinfection	дезинфекция
dispatch note	Бързо съобщение, депеша ; бързо съобщение ; бързо депеша
dispersion	дисперсия
dispersion calculation	дисперсионни изчисления
displaced person	преселник
disposal of the dead	премахване на мъртвите
disposal of warfare materials	премахване на материали от войната
dissolution	разтваряне
dissolved organic carbon	разтворен органичен въглерод
dissolved oxygen	разтворен кислород
distillation	дестилация
distortion of competition	изкривяване на конкуренцията
distribution	разпространение
distribution area	област на разпространение
distributive trade	разпространяваща търговия
district heating	централно отопление
district heating plant	топлоцентрала
disused military site	изоставен военен обект
ditch	Канавка ; канавка
division	деление
divorce	развод
doctrine	доктрина
document	документ
document lending	заемане на документи
document type	вид документ
documentary film	документален филм
documentary system	документационна система
documentation	документиране
documentation centre	документационен център
dog	куче ; куче ; пес ; псе
dolphin	делфин
domestic appliance	домакински прибор
domestic fuel	гориво за отопление
domestic fuel oil	нафта
domestic noise	домакински шум
domestic pollution	Битово замърсяване ; битово замърсяване
domestic trade	вътрешна търговия
domestic waste	Битови отпадъци ; битови отпадъци
domestic waste landfill	сметище за битови отпадъци
domestic waste water	Битова отпадна вода ; битова отпадна вода
domesticated animal	опитомено животно
donation	дарение
donation	подаряване
door	врата
dosage	дозировка
dose	доза
dose-effect relationship	съотношение доза-въздействие
draft legislation	проектозаконодателство
dragonfly	водно конче
drainage	отводняване
drainage system	отводнителна система
drainage water	отточна вода
draining	пресушаване
draught animal	впрегатно животно
dredged material	изгребан материал
dredging	драгиране, изгребване
drift net fishing	риболов с плаващи мрежи
drilling	Пускане на сонда ; пускане на сонда
drilling for oil	пускане на сонда за нефт
drilling installation	инсталация за сондиране
drinking water	Питейна вода ; питейна вода
drinking water protection area	водоохранителна зона
drinking water supply	Снабдяване с питейна вода ; снабдяване с питейна вода
drinking water treatment	пречистване на вода за пиене
drought	Суша ; cуша
drought control	контрол над сушата
drug	Лекарство (медикамент) ; лекарство
drum kit	барабани
dry cleaning	химическо чистене
dry deposition	сухо отлагане
dry farming	сухо земеделие
dry lawn	суха поляна
drying	изсушаване
drying out	изсъхване
dual economy	двойна икономика
dual waste management	система за двойно събиране на отпадъците
dubnium	дубний
duck	патица
dumping	изхвърляне на отпадъци
dune	Дюна ; дюна
durable goods	трайни стоки
duration of sunshine	Продължителност на слънчевото греене ; продължителност на слънчевото греене
dust	Прах ; прах
dust removal	Обезпрашаване ; обезпрашаване
dwelling	жилище
dye	Боя ; боя
dyke	дига
dyke reinforcement	засилване на дига
ear	ухо
early	ранен
early warning system	система за ранно предупреждение
earth ; Earth ; the world ; Blue Planet	Земя
earth science	наука за земята
earth's crust ; crust ; Earth's crust	земна кора
earthquake	земетресение
earthworm	земен червей
earwig	Щипалка ; щипалка
easement	сервитутно право
echinoderm	Ехинодерм ; ехинодерм
eco-paediatrics	еко-педиатрия
ecocatastrophe	екокатастрофа
ecodevelopment	екоразвитие
ecolabel	еко-етикет
ecolabelling	поставяне на еко-етикети
ecological abundance	екологично изобилие
ecological adaptation	екологично приспособяване
ecological assessment	екологична оценка
ecological balance	екологичен баланс
ecological bookkeeping	екологично счетоводство
ecological carrying capacity	екологично носещ капацитет
ecological community	екологична общност
ecological factor	Екологичен фактор ; екологичен фактор
ecological inequality	екологично неравенство
ecological niche	екологична ниша
ecological parameter	екологичен параметър
ecological stocktaking	екологичен преглед на постигнатото
ecologically sensitive area	екологично чувствителна област
ecologist movement	Екологично движение ; екологично движение
ecology	Екология ; екология
ecomarketing	екомаркетинг
ecomuseum	екомузей
economic activity	икономическа дейност
economic analysis	Икономически анализ ; икономически анализ
economic competition	икономическо съревнование
economic concentration	икономическа концентрация
economic data	икономически данни
economic development	икономическо развитие
economic forecasting	икономическо предвиждане
economic geography	икономическа география
economic growth	икономически растеж
economic incentive	икономически стимул
economic instrument	икономически инструмент
economic management instrument	инструмент на икономическото управление
economic plan	икономически план
economic planning	икономическо планиране
economic policy	икономическа политика
economic region	икономическа област
economic rights	икономически права
economic science ; economics	икономика ; Икономикс
economic sector	икономически сектор
economic situation	Икономическо положение ; икономическо положение
economic structure	икономическа структура
economic support	икономическа подкрепа
economic system	икономическа система
economic theory	Икономическа теория ; икономическа теория
economic trend	Икономическа тенденция ; икономическа тенденция
economic viability	Икономическа жизнеспособност ; икономическа жизнеспособност
economical-ecological efficiency	икономическо-екологична ефективност
economy	икономика
ecophysiology	екофизиология
ecosystem	екосистема
ecosystem analysis	екосистемен анализ
ecosystem degradation	деградация на екосистемата
ecosystem research	изследване на екосистема
ecosystem type	тип екосистема
ecotourism	екотуризъм
ecotoxicity	екотоксичност
ecotoxicological evaluation	екотоксикологична оценка
ecotoxicology	екотоксикология
ecotype	екотип
ecozone	екологична зона
edaphology	едафология
edible	ядивен
edible fat	едлива мазнина
education	Образование ; образование
education policy	образователна политика
educational institution	образователна институция
educational path	образователна пътека
educational planning	образователно планиране
educational system	образователна система
effect	Последствие, ефект ; Последствие ; ефект ; последствие
effect on health	последствия за здравето
effect on man	последствия за човека
effect on the environment ; environmental consequence	последствие за околната среда ; екологично последствие
efficiency criterion	критерий за ефективност
efficiency level	ниво на ефективност
effluent	Отпадна течност ; отпадна течност
effort ; exertion	усилие
egg	Яйце ; яйце
einsteinium	айнштайний
elasticity	еластичност
elbow	лакът
elder ; elderberry	бъз
elderly person	застаряващ човек
electric battery	Електрическа батерия ; електрическа батерия
electric line ; power line	електрична линия
electric power	електрична мощност
electric power plant	електроцентрала
electric power supply	източник на електрична енергия
electric vehicle	електрично превозно средство
electrical engineering	електроинженерство
electrical goods industry	електропромишленост
electrical industry	електроенергетика
electricity	електричество
electricity company	електрическа компания
electricity consumption	консумация на електроенергия
electricity generation	получаване на електроенергия
electricity generation cost	цена на електроенергията
electricity supply industry	електроснабдяване
electrokinetics	електрокинетика
electrolysis	електролиза
electronic information network	електронно-информационна мрежа
electronic mail ; email ; e-mail	Електронна поща ; електронна поща
electronic material	електронен материал
electronic scrap	отпадък от електронната промишленост
electronic scrap regulation	наредба за отпадъците от електронната промишленост
electronics	електроника
electrosmog	електромагнитни смущения
electrotechnical equipment	електротехническо оборудване
electrotechnical industry	електротехническа промишленост
element of group 0 ; noble gas	елемент от нулевата група
element of group II (alkaline earth metals) ; alkaline earth metal ; element of group II	Елементи от втора група (алкалоземни) ; елементи от втора група ; алкалоземни
element of group III	елементи от трета група
element of group IV	елементи от четвърта група
element of group V	елементи от пета група
element of group VI	елементи от шеста група
element of group VII ; halogen	елементи от седма група
emancipation	еманципация
embryo	Ембрио ; ембрио
embryogenesis	ембриогенез
emergency	спешна ситуация
emergency law	закон за извънредните ситуации
emergency plan	план за извънредните ситуации
emergency relief	помощ при извънредни ситуации
emergency shelter	подслон при извънредни ситуации
emission	емисия
emission control	контрол на емисиите
emission data	данни за емисиите
emission factor	емисионен коефициент
emission forecast	емисионна прогноза
emission reduction	намаляване на емисиите
emission reduction banking	Банки за намаляване на емисиите ; банки за намаляване на емисиите
emission register	емисионен регистър
emission situation	емисионна ситуация
emission source	източник на емисии
emission standard	емисионна норма
emission to water	емисии във вода
employment	заетост
employment ; employment ; job ; job ; occupation ; work ; work	Заемане; временно ползване; обитаване Работа; занимание; занимавка Професия; занятие ; заемане ; временно ползване ; обитаване работа ; занимание ; занимавка професия ; занятие ; професия
employment and environment	заетост и околна среда
employment level effect	влияние на нивото на заетостта
employment structure	структура на заетостта
empty	празен
emulsification	емулгиране
emulsion	емулсия
encapsulation	капсулиране
encyclopaedia	енциклопедия
end-of-pipe technology	технология на края на тръбата
endangered animal species	застрашени животински видове
endangered plant species	застрашени растителни видове
endemic species	ендемични видове
endocrine system	ендокринна система
endocrinology	ендокринология
enemy	враг
energy	Енергия ; енергия
energy balance	енергетичен баланс
energy consumption	потребление на енергията
energy conversion	превръщане на енергията
energy demand	енергетични нужди
energy dissipation	разсейване на енергията
energy distribution system	система за разпределение на енергията
energy economics	икономика на енергетиката
energy efficiency	производителност на енергията
energy industry	енергетична промишленост
energy legislation	законодателство за енергетиката
energy management	управление на енергетиката
energy market	пазар на енергията
energy policy	енергийна политика
energy process	енергетичен процес
energy production	производство на енергия
energy resource	енергийни ресурси
energy saving	пестене на енергия
energy source	енергиен източник
energy source material	материал от енергиен източник
energy storage	енергийни запаси
energy supply	снабдяване с енергия
energy technology	енергийни технологии
energy type	вид енергия
energy utilisation ; energy use	използване на енергията
enforcement	изпълнение
engine	двигател
engineering	Инженерство ; инженерство
engineering work	инженерна работа
enjoy your meal ; have a nice meal	добър апетит
enlargement policy	политика на разширението
enlargement programme	програма на разширението
enriched uranium	обогатен уран
enrichment	обогатяване
enterovirus	ентеровирус
entrepreneur	предприемач
environment	околна среда
environment friendly	приятелски към околната среда
environment market	пазар на околна среда
environmental accident	екологична катастрофа
environmental accounting	екологично счетоводство
environmental administration institution	Административна институция по околната среда ; административна институция по околната среда
environmental analysis	Анализ на околната среда ; анализ на околната среда
environmental anxiety	загриженост за околната среда
environmental aspect of human settlements	екологични аспекти на човешките селища
environmental assessment	оценка на околната среда
environmental assessment criterion	критерий за оценка на околната среда
environmental auditing	одит на околната среда
environmental awareness	екологична осведоменост
environmental change	промени в околната среда
environmental chemicals legislation	екологично химическо законодателство
environmental chemistry	химия на околната среда
environmental citizenship	екологично гражданство
environmental compatibility	екологично съответствие
environmental consequence	Екологично последствие
environmental conservation	консервация на околната среда
environmental contingency planning	екологично планиране на борбата с непредвидените случаи
environmental control	контрол върху околната среда
environmental cost	екологична цена
environmental crime	престъпление спрямо околната среда
environmental criminal law	екологичен наказателен закон
environmental criminality	екологична престъпност
environmental criterion	екологичен критерий
environmental culture	екологична култура
environmental damage	Щета на околната среда ; щета на околната среда
environmental data	екологични данни
environmental development	екологично развитие
environmental economic valuation	екологична икономическа оценка
environmental economics	икономика на околната среда
environmental economics of firms	екологична икономика на фирмите
environmental economy issue	въпрос на екологичната икономика
environmental education	екологично образование
environmental engineering	екологично инженерство
environmental enterprise	екологично предприятие
environmental ethics	екологична етика
environmental friendly procurement	приятелски-екологично придобиване
environmental fund	екологичен фонд
environmental hazard	екологична опасност
environmental health	екологично здраве
environmental health hazard	опасност за екологичното здраве
environmental health impact assessment	оценка за въздействието върху екологичното здраве
environmental health protection	опазване на екологичното здраве
environmental history	история на околната среда
environmental impact	екологично въздействие
environmental impact of agriculture	Въздействие на селското стопанство върху околната среда ; въздействие на селското стопанство върху околната среда
environmental impact of aquaculture	Въздействие на водното стопанство върху околната среда ; въздействие на водното стопанство върху околната среда
environmental impact of energy	Въздействие на енергията върху околната среда ; въздействие на енергията върху околната среда
environmental impact of fishing	Въздействие на риболова върху околната среда ; въздействие на риболова върху околната среда
environmental impact of forestry	Въздействие на горското стопанство върху околната среда ; въздействие на горското стопанство върху околната среда
environmental impact of households	Въздействие на домакинствата върху околната среда ; въздействие на домакинствата върху околната среда
environmental impact of industry	Въздействие на промишлеността върху околната среда ; въздействие на промишлеността върху околната среда
environmental impact of recreation	Въздействие на почивното дело върху околната среда ; въздействие на почивното дело върху околната среда
environmental impact of tourism	Въздействие на туризма върху околната среда ; въздействие на туризма върху околната среда
environmental impact of transport	Въздействие на транспорта върху околната среда ; въздействие на транспорта върху околната среда
environmental impact statement	доклад за въздействието върху околната среда
environmental impact study	изследване на въздействието върху околната среда
environmental incentive	екологична инициатива
environmental index	екологичен индекс
environmental indicator	екологичен индикатор
environmental industry	екологична промишленост
environmental informatics	екологична информатика
environmental information	екологична информация
environmental information network	екологична информационна мрежа
environmental information system	екологична информационна система
environmental investment	инвестиция в околна среда
environmental law	екологично право
environmental law enforcement	изпълнение на екологичното право
environmental legislation	екологично законодателство
environmental legislation on agriculture	екологично законодателство за селското стопанство
environmental legislative process	екологичен законодателен процес
environmental liability	екологична отговорност
environmental licence	екологичен лиценз
environmental management	управление на околната среда
environmental medicine	екологична медицина
environmental misconduct	лошо поведение към околната среда
environmental monitoring	екологичен мониторинг
environmental noise	екологичен шум
environmental occupation	екологична професия
environmental perception	екологично разбиране
environmental plan	екологичен план
environmental planning	екологично планиране
environmental policy	екологическа политика ; екологична политика
environmental policy instrument	инструмент на екологичната политика
environmental pollution	замърсяване на околната среда
environmental priority	екологичен приоритет
environmental problem solving	решаване на екологични проблеми
environmental programme	екологична програма
environmental protection	опазване на околната среда
environmental protection agency	Агенция за опазване на околната среда ; агенция за опазване на околната среда
environmental protection association	Асоциация за опазване на околната среда ; асоциация за опазване на околната среда
environmental protection cost	цена за опазване на околната среда
environmental protection in the enterprise	опазване на околната среда в предприятието
environmental protection order	заповед за опазване на околната среда
environmental protection organisation	организация за защита на околната среда
environmental protection regulation	наредба за опазване на околната среда
environmental protection technology	технология за опазване на околната среда
environmental psychology	екологична психология
environmental quality	качество на околната среда
environmental quality criterion	критерий за качество на околната среда
environmental quality objective	цел за качество на околната среда
environmental quality standard	стандарт за качество на околната среда
environmental report	доклад за околната среда
environmental research	изследване на околната среда
environmental risk	Екологичен риск ; екологичен риск
environmental risk assessment	оценка на екологичния риск
environmental science	наука за околната среда
environmental security	екологична безопасност
environmental specimen bank	Банка за екологични образци ; банка за екологични образци
environmental statement (eco-audit) ; environmental statement ; eco-audit	доклад за околната среда ; доклад за околната среда (еко-одит) ; еко-одит
environmental statistics	екологична статистика
environmental stock exchange	екологична фондова борса
environmental study	екологично проучване
environmental subsidy	екологична субсидия
environmental sustainable architecture	екологично устойчива архитектура
environmental tax	екологична такса
environmental teaching	екологично преподаване
environmental technology	екологична технология
environmental terminology	екологична терминология
environmental training	екологично обучение
environmental warfare	екологично воюване
environmentalism	енвиронментализъм
environmentally dangerous substance	вещество опасно за околната среда
environmentally friendly management	управление приятелско за околната среда
environmentally friendly product	продукт приятелски за околната среда
environmentally related disease	Болест свързана с околната среда ; болест свързана с околната среда
environmentally responsible behaviour	екологично отговорно поведение
environmentally unfriendly firm	фирма неприятелска за околната среда
enzyme	ензим
epicentre	епицентър
epidemic	епидемия
epidemiology	епидемиология
equator	екватор
equatorial climate	екваториален климат
equine	еднокопитни, коне
equipment	оборудване
equivalent dose	еквивалентна доза
ergonomics	ергономика
erosion	ерозия
erosion control	контрол върху ерозията
estate rental	даване под наем на имот
estimate	оценка
estuarine biology	Биология на речното устие ; биология на речното устие
estuarine conservation area	област на консервация край устие
estuary	устие
estuary pollution	замърсяване на устието
etching	ецване
etching substance	ецващо вещество
ethanol	етанол
ether	етер
ethics	Етика ; етика
ethnology	етнология
ethology	етология
europium	европий
eutrophication	еутрофикация
evaluation	оценка
evaluation criterion	критерий за оценка
evaluation method	метод за оценка
evaluation of technology	технология за оценка
evaporation	изпарение
evapotranspiration	изпарение от земята
evolution	еволюция
exact science	Точна наука ; точна наука
excavated hole	Изкоп ; изкоп
excavation (process) ; excavation ; earthworks ; digging	изкопни работи (процес) ; изкопни работи
excavation heap	екскаваторна купчина
excavation side	страна на изкоп
excavation site	изкопна работна площадка
exceptional tax	извънреден данък
excessive height of chimney stacks	извънредна височина на група комини
exchange policy	политика на размяна
executive order	Изпълнителна заповед ; изпълнителна заповед
exhaust device	изпускателно устройство
exhaust gas	изгорели газове
exhibit	изложба
existing chemical	съществуващ химикал
exotic species	екзотичен вид
expenditure	разноска ; разноска
experiment	експеримент
experimental study	експериментално изследване
expert system	експертна система
exploitation of underground water	използване на подпочвена вода
exploration	проучване
explosion	Експлозия ; експлозия
explosive	експлозив
export	експорт
export licence	лиценз за експорт
export of hazardous wastes	експорт на опасни отпадъци
exposure	излагане
expropriation	експроприиране
extensive cattle farming	екстензивно едро животновъдство
externality	външно обстоятелство
extinct species	изчезнал вид
extinction (ecological) ; extinction	изчезване (екологично)
extraction	екстракция
extractive industry	екстракционна промишленост
eye	око
fabric	тъкан
face	лице
factor market	факторен пазар
factory farming	фабрично селско стопанство
faecal bacterium	фекални бактерии
fallout	падане на частици
fallow area	угарна площ
family	семейство
family law	семейно право
family planning	Семейно планиране ; семейно планиране
famine	Глад ; глад
farm	Ферма ; ферма
farm animal	селскостопанско животно
farm building	фермерско здание
farm price	фермерска цена
farming technique	фермерска техника
fascism	фашизъм
fast reactor	Бърз ядрен реактор ; бърз ядрен реактор
fast traffic	Бърз транспорт (трафик) ; бърз транспорт ; бърз трафик
father	баща ; родител ; родител ; татко ; татко ; тате
fault	Разлом ; разлом
fauna	фауна
fauna restoration	възстановяване на фауната
feather	перо
federal authority	правителствена (федерална) власт
federal government	върховно (федерално) правителство
federal law	правителствено (федерално) право
fee	Такса ; такса
feeding of animals	хранене на животни
feeling for nature	Чувство (усет) за природата ; чувство за природата
felid	животно от семейство котки
female ; woman	жена
fen	блатиста местност ; мочурище ; тресавище
fermentation	ферментация
fern	Папрат ; папрат
ferry	ферибот
fertilisation ; fecundation	опложданеIосеменяване
fertiliser	тор
fertiliser law	закон за торовете
fibre	влакно
fibreglass	стъклени влакна
field ; land ; land ; acre ; patch	поле ; поле
field damage	увреждане на полето
field experiment	полеви експеримент
field study	полево изследване
filling material	запълващ материал
filling station	Бензиностанция ; бензиностанция
film	филм ; филм
film	филм
filter	Филтър ; филтър
filter cake	филтърна утайка
filtration	филтрация
final storage	окончателно съхранение
finances	финанси
financial aid	финансова помощ
financial assistance	финансово съдействие
financial compensation	финансова компенсация
financial contribution	финансова контрибуция (вноска, принос)
financial fund	финансов фонд ; финансов фонд
financial instrument	финансов инструмент
financial law	финансово право
financial management	финансов мениджмънт (финансово управление)
financial market	финансов пазар
financing	финансиране
fine	Глоба ; глоба
fine dust	фин прах
finger	пръст
fire	Огън ; огън
fire precaution	предпазване от огън
fire protection	защита от огън (огнезащита)
fire safety requirement	изискване за противопожарна охрана
fire service	пожарна служба
fireproofing agent	огнезащитно средство (вещество)
firing	изпичане
firm ; corporation ; enterprise ; company ; venture	фирма
fish	Риба ; риба
fish disease	Болест по рибата ; болест по рибата
fish farming	рибовъдство
fish kill	рибен убиец
fish stock	рибен запас
fish toxicity	рибна токсичност
fisheries management	мениджмънт (управление) на рибовъдството
fisheries structure	структура на рибовъдството
fishery	рибарство ; рибовъдство
fishery economics	икономика на рибовъдството
fishery policy	политика на рибовъдството
fishery resource	ресурс на рибовъдството
fishing	улов на риба
fishing ground	рибно поле
fishing industry	рибна промишленост
fishing law	рибно право
fishing licence	разрешително за риболов
fishing preserve	рибен резерват
fishing vessel	рибарски съд
fitting (plumbing) ; fitting ; plumbing equipment ; plumbing fixtures	водопроводна инсталация
five	пет ; петима
flag of convenience	Флаг за облагодетелстване
flammable product	възпламеним продукт
flaring	Ярко запалване ; ярко запалване
flavouring	есенция
flea	Бълха ; бълха
flexible approach to environmental protection	гъвкав подход при опазване на околната среда
flocculant	флокулант
flocculation	флокулация
flood	Наводнение ; наводнение
flood control	контрол на наводненията
flood forecast	предсказване на наводнения
flood protection	предпазване от наводнения
flood runoff	отток на наводнение
flooding	наводняване
flora (biology) ; flora	Флора (биология) ; флора
flora (document) ; flora	Флора (документ) ; флора
flora restoration	възстановяване на флората (растителния живот)
flotation	флотация
flow	течение
flow field	поле на течение
flower ; bloom ; blossom	Цвят ; цвят
flowering plant	цъфтящо растение
flowing water	течаща вода
flue gas	димен газ
fluidics	флуидика
fluidisation	флуидизация
fluidised bed	кипящ слой
fluoridation	флуоридизация
fluorine	флуор ; флуор
flushing	Промиване ; промиване
flute	улейта ; флейта
fluvial resource	речен (флувиален) ресурс
fly ash	пепел от тец
foaming agent	пенообразуващ агент
fodder ; provender ; forage	фураж
fodder plant	фуражно растение
fog	мъгла
foliage	Листак ; листак
folk tradition	фолклорна традиция
folklore	Фолклор ; фолклор
food	храна
food additive	добавка към храната
food chain	хранителна верига
food commerce	търговия с храни
food contamination	замърсяване на храната
food hygiene	хигиена на храненето
food industry	хранителна промишленост
food irradiation	облъчване на храната
food pollutant	замърсител на храна
food preservation	опазване на храна
food processing industry	хранително-преработваща промишленост
food production (agriculture) ; food production	Производство на храна (селско стопанство) ; производство на храна
food quality	качество на храната
food requirement	необходимост от храна
food science	наука за храненето
food storage	съхранение на храните (държавен резерв?)
food technology	технологии за производство на храни
food transport	транспорт на храни
foodstuff	хранителен продукт
foot	ходило ; стъпало ; крак
footpath	Тротоар ; тротоар
forage contamination	замърсяване на фураж
forage crop	фуражни посеви
forage law	закон за фуражите
forecast	прогноза
foreclosure	възбрана
foreign economic relations	външно-икономически отношения
foreign policy	външна политика
foreign trade	външна търговия
forest	Гора ; гора ; лес
forest biological reserve	горски биологичен резерват
forest cover destruction	разрушаване на горските площи
forest damage	увреждане на горите
forest deterioration	влошаване състоянието на горите
forest ecology	горска екология
forest ecosystem	горска екосистема
forest exploitation	експлоатация на горите
forest fire	горски пожар
forest industry	горска промишленост
forest management	управление на горите
forest pest	горски вредители
forest policy	горска политика
forest product	горски продукт
forest production	горска продукция ; лесовъдство
forest protection	опазване на горите
forest reserve	горски резерват
forest resource	горски ресурс
forestry	горско стопанство
forestry economics	икономика на горското стопанство
forestry law	горско право
forestry legislation	горско законодателство
forestry practice	горско-стопанска практика
forestry unit	горска единица
form of government	форма на управление
forwarding agent	спедитор
fossil	фосил
fossil fuel	фосилно гориво
fouling growth	обрастване на дъното на кораби
fountain	фонтан
four	четири
four	четири ; четирима
four stroke engine	Четиритактов двигател ; четиритактов двигател
framework legislation	рамково законодателство
free movement of capital	свободно движение на капитали
free trade	свободна търговия
freedom	Свобода ; свобода
freedom ; liberty	свобода
freight transport	товарен транспорт
freon	фреон
freshwater	Прясна вода ; прясна вода
freshwater degradation	влошаване качествата на пресните води
freshwater ecosystem	сладководна екосистема
freshwater organism	сладководен организъм
freshwater pollution	замърсяване на пресни (сладки) води
freshwater resource	сладководни ресурси
frog	жаба
frost	Скреж ; скреж
fruit	плод
fruit cultivation	отглеждане на плодове
fruit tree	плодно дърво ; плодно дърво
fuel	гориво
fuel additive	добавка към горивото
fuel alcohol	Алкохолно гориво ; алкохолно гориво
fuel cell	горивна клетка
fuel composition	състав на горивото
fuel consumption	разход на гориво
fuel oil	мазут
fuel tank installation	инсталация с цистерни за гориво
fuel wood	дървесно гориво
full	препълненIпълен
fume	Дим ; дим
fumigation	Опушване, дезинфекция ; опушване ; дезинфекция
functional substance	функционално вещество
funeral	погребение
fungicide	фунгицид
fungus	гъба, плесен
fur	козина
fur animal	животно с козина
furan	фуран
furnace	пещ
furniture	мебели
furniture industry	мебелна промишленост
furriery	кожухарство
gadolinium	гадолиний
gallinacean	кокошки
gallium	галий
galvanisation	галванизация
game	Игра ; игра
game	дивеч (животни)
gamma radiation	гама излъчване
gangrene	гангрена
garage	гараж
garden	Градина ; градина
garden waste	градински отпадъци
gardener	градинар
gas	Газ ; газ
gas chromatography	газова хроматография
gas company	газова компания
gas engine	газов двигател
gas liquefaction	втечняване на газ
gas mixture	газова смес
gas network	газова мрежа
gas pipeline	газопровод
gas powered plant	газова електрическа централа
gas purification	пречистване на газове
gas reservoir	газов резервоар
gas supply	доставка на газ
gaseous air pollutant	газообразен замърсител на въздуха
gaseous state	газообразно състояние
gasification	превръщане в газ, газификация
gasohol	газохол
gasoline engine	Бензинов двигател ; бензинов двигател
gastropod	коремоного
gaswork	газова площадка
gene	ген
general	общи
general administrative order	общ административен ред
general chemistry	Обща химия ; обща химия
general education	общо образование
genetic diversity	генетично разнообразие
genetic effect	генетичен ефект
genetic engineering	генно инженерство
genetic engineering legislation	законодателство за генното инженерство
genetic information	генетична информация
genetic modification	генна модификация
genetic pool ; gene pool	генетичен басейн
genetic resource	генетичен ресурс
genetic variation	генна вариация
genetically modified organism	генетично променен организъм
genetics	Генетика ; генетика
genotoxicity	генотоксичност
genotype	генотип
geo-referenced data	гео-привързани данни
geo-referenced information	гео-привързана информация
geodesy	геодезия
geogenic factor	геогенен фактор
geographic information system	географска информационна система
geographical distribution of population	географско разпределение на населението
geographical projection	географска проекция
geography	География ; география
geological disaster	геоложки бедствия
geological process	геоложки процес
geology	Геология ; геология
geometric correction	геометрична корекция
geometry	геометрия
geomorphic process	геоморфен процес
geomorphology	геоморфология
geophysical environment	геофизична околна среда
geophysics	геофизика
geotechnics	геотехника
geotechnology	геотехнология
geothermal energy	геотермална енергия
germ	микроб  зародиш
germ plasm	зародишна плазма
germination	покълване
girl	free ; девойка
glacier	ледник
glaciology	глациология
glass	Стъкло ; cтъкло
glass industry	стъкларска промишленост
glasses ; spectacles	oчила
glaze	Ледена кора ; ледена кора
global aspect	глобален аспект
global convention	глобална конвенция
global model	глобален модел
global warming	глобално затопляне
glossary	речник
glue	туткал
glycolysis	глюкоза
goal of individual economic business	цел на индивидуален икономически бизнес
gold	злато
golf	голф
gonorrhea	гонорея
good management	добър мениджмънт (управление)
goods	Стоки ; стоки
goods and services	стоки и услуги
goose	гъска
gorilla	горила
government (cabinet)	правителство (кабинет)
government advisory body	съветници към правителството
government building	правителствена сграда
government liability	задължения на правителството
government policy	правителствена политика
grain	Зърнени храни ; зърнени храни ; зърнени храни
graminaceous plant	житно (тревисто) растение
grammer ; grammar	граматика
grandchild	eurodict ; внучка ; внук
grandson	внук
granite	гранит
granulometry	гранулометрия (зърнометрия)
grass	Трева ; трева
grass fire	тревен пожар
grasshopper	скакалец
grassland	пасище
gravel	Чакъл ; чакъл
gravel extraction	добиване на чакъл
gravel pit	кариера за чакъл
grazing	Паша ; паша
green building	Зелена сграда
green corridor	Зелен коридор
green manure	зелен тор
green revolution	Зелена революция
green space	Зелено пространство
green tide	Зелен прилив
green vegetable	зелен зеленчук
greenhouse cultivation	парниково отглеждане
greenhouse effect	парников ефект
greenhouse gas	парников газ
gridding	координатна мрежа
grinding	Смилане ; смилане
gross national product	Брутен национален продукт ; брутен национален продукт
groundwater	подпочвени води
groundwater endangering	заплаха за подпочвените води
groundwater extraction	извличане на подпочвена вода
groundwater pollution	замърсяване на подпочвените води
groundwater protection	опазване на подпочвените води
groundwater quality	качество на подпочвените води
group behaviour	групово поведение
guillotine ; guillotine ; guillotine	гилотина ; гилотина ; гилотина
guitar	китара
gulf	залив
gull	чайка
gymnosperm	голосеменно растение
gypsum	гипс
habitat	Ареал, местообитание ; ареал ; местообитание
habitat destruction	разрушаване на ареала
haematology	хематология
haemorrhage ; bleeding	кръвоизлив
hafnium	хафний
hail	Градушка ; градушка
hair	козина ; коса
hairdresser ; barber	фризьор ; бръснар
half-life	период на полуразпад
haloform	халоформ
halogenated biphenyl	халогениран дифенил
halogenated compound	халогенирано съединение
halogenated hydrocarbon	халогениран въглеводород
halogenated phenol	халогениран фенол
halogenated pollutant	халогениран замърсител
handicraft	Занаят ; занаят
handicraft business	занаятчийство
handkerchief	носна кърпа
harbour	пристанище
hard-to-dispose-of waste	труден за депониране отпадък
hardness	твърдост
harem	харем
harmonisation of law	хармонизация на законодателството
harvest	реколта
hazard	опасно вещество
hazard area	застрашена област
hazard of pollutants	опасност от замърсители
hazardous chemical export	опасен химически износ
hazardous substance	опасно вещество
hazardous substances legislation	законодателство за опасните вещества
hazardous waste	опасни отпадъци
hazardous waste dump	сметище за опасни отпадъци
hazardous working material	опасен за работа материал
haze	лека мъгла
he	той
head	глава
headland	синур
health	здраве
health care	грижа за здравето
health care profession	Професия в здравеопазването ; професия в здравеопазването
health effect of noise	ефект от шума върху здравето
health facility	здравно заведение
health hazard	опасност за здравето
health legislation	здравно законодателство
health regulation	здравни наредби
health service	здравна служба
health-environment relationship	отношение здраве - околна среда
health-related biotechnology	свързана със здравето биотехнология
hearing	cлух
hearing acuity	Чувствителност на слуха ; чувствителност на слуха
hearing impairment	отслабване на слуха
hearing procedure	процедура по изслушване
hearing protection	защита на слуха
hearing system	слухова система
heart	сърце
heat	топлина
heat and power station	топлоелектрическа централа
heat pump	топлинна помпа
heat storage	съхранение на топлина
heat supply	топлоснабдяване
heater	нагревател
heathland	пустош
heating	отопление
heating plant	топлоцентрала
heaven ; sky	небе
heavy	тежък
heavy goods vehicle traffic	моторен транспорт на тежки стоки
heavy metal	тежък метал
heavy metal load	натоварване с тежки метали
hedge	жив плет
hegemony	хегемония
helium	хелий
hello ; hey ; hi ; howdy	здравей ; здравейте
herbicide	хербицид
herbivore ; plant eater	тревопасно
here	тук ; тука
heroin	х ероин
heron	чапла
heterocyclic compound	хетероциклично съединение
high mountain	висока планина
high tide water	приливна вода
high voltage line	високоволтова линия
high-rise building	високо здание
high-speed railway	високоскоростна ж.п. линия
high-speed train	високоскоростен влак
higher education	висше образование
highway	Шосе ; шосе
hiking trail	туристическа пътека
historic centre	исторически център
historical evolution	историческа еволюция
historical monument	исторически паметник
historical research	историческо изследване
historical site	историческо място
history	история
holiday ; opor-garai	празник
holiday camp	празничен лагер
home ; home ; house	къща
home garden	домашна градина
homeostasis	хомеостаза
homepage	собствена страница
homologation	утвърждение
homonym	oмоним ; омоним
honey	мед
horizon	хоризонт
hormone	хормон
horse	кон
horticulture	градинарство
hospital ; clinic	Болница ; болница
hospital waste	Болнични отпадъци ; болнични отпадъци
hot water	гореща вода
hotel industry	хотелска промишленост
hour	час
household	домакинство
household chemical	домакински химикал
household expenditure	домакински разходи
household goods	домакински стоки
housing	жилища
housing density	гъстота на жилищата
housing improvement	жилищно подобрение
housing legislation	жилищно законодателство
housing programme	жилищна програма
housing quality standard	стандарт за качеството на жилищата
huckleberry ; blueberry	боровинка
human body	Човешко тяло ; човешко тяло
human disease	Болести на човека ; болести на човека
human ecology	екология на човека
human habitat	местообитание на човека
human health	здраве на човека ; човешко здраве
human migration	миграция на човека
human physiology	физиология на човека
human population	население (на хора)
human rights	права на човека
human science	Науки за човека ; науки за човека
human settlement	селища на човека
human settlement management	управление на селищата на човека
human-made disaster	Бедствия причинени от човека ; бедствия причинени от човека
humanitarian aid	хуманитарна помощ
humus	хумус
hundred	сто
hunting	лов
hunting licence	разрешително за лов
hunting reserve	ловен резерват
hurricane	ураган
husband ; spouse	мъж ; съпруг
hybridisation	хибридизация
hydraulic construction	хидравлична конструкция
hydraulic engineering	хидравлично инженерство
hydraulics	хидравлика
hydrobiology	хидробиология
hydrocarbon	въглеводород
hydrocarbon storage tank	цистерна за съхранение на въглеводороди
hydrochloric acid ; muriatic acid	солна киселина
hydroculture	хидрокултура
hydroelectric energy	хидроелектрическа енергия
hydroelectric power plant	водноелектрическа централа
hydrogen	Водород ; водород
hydrogen sulphide	водороден сулфид
hydrogeology	хидрогеология
hydrographic basin	хидрографски басейн
hydrographic network	хидрографска мрежа
hydrography	хидрография
hydrologic balance	хидроложки баланс
hydrologic cycle	хидроложки цикъл (кръговрат)
hydrologic disaster	хидроложко бедствие
hydrologic flow	хидроложко течение
hydrology	хидрология
hydrolysis	хидролиза
hydrometeorology	хидрометеорология
hydrometry	хидрометрия
hydrosphere	хидросфера
hyena	хиена
hygiene	Хигиена ; хигиена
hymenopteran	ципокрили
hypertext	хипертекст
ice	Лед ; лед
ice pack	ледени буци
iceberg	Айсберг ; айсберг
ideology	идеология
image classification	класификация на изображенията
image enhancement	усилване на образа
image filtering	филтриране на образа
image processing digital system	цифрова система за обработка на изображения
image registration	регистриране на изображения
immission	имисия (въвеждане)
immission control	контрол над имисията
immission control law	закон за контрола над имисията
immission damage	вреди от имисията
immission forecast	предсказване на имисията
immission limit	граница на имисия
immission load	товар на имисия
immune system	имунна система
immunity	имунитет
immunoassay	имунна оценка
immunological disease	имунологична болест
immunology	имунология
impact assessment	оценка на въздействието
impact minimisation	минимизиране на въздействието
impact prevention	предотвратяване на въздействието
impact reversal	обратно въздействие
impact source	източник на въздействие
impactor	impactor
implementation law	закон за внедряване
import	импорт (внос)
import licence	разрешително за внос
impoverishment	обедняване
impregnating agent	импрегниращ агент
impregnation	импрегниране (материали)
improvement of efficiency	подобряване на ефективността
impulsive noise	импулсен шум
in situ	In situ (лат.), на място ; in situ (лат.) ; на място
in vitro assay	оценка in vitro
in vivo assay	оценка in vivo
incentive fund	стимулиращ фонд
incentive tax	данък за стимулиране
incidental pollution	случайно замърсяване
incineration	изгаряне
incineration of waste	изгаряне на отпадъци
incineration residue	остатък от изгаряне
incinerator	пещ за изгаряне на смет, крематориум
income	доход
income tax	данък върху дохода
incorporation	Обединяване, съединяване ; oбединяване ; съединяване
indefinite legal concept	неопределено законово понятие
indemnity	обезщетение ; обезщетение
independence	независимост
index	Индекс, показалец ; показалец ; Индекс ; индекс
indexing of documentation	индексиране на документация
indicator	индикатор, указател
indicator of environmental quality	указател за качество на околната среда
indigenous knowledge	местни познания
indigenous technology	местна технология
indirect discharger	индиректен замърсител
indium	индий
individual wastewater treatment	индивидуално пречистване на отпадни води
indoor air pollution	замърсяване на въздуха в закрити помещения
indoor environment	Околна среда в закрити помещения ; околна среда в закрити помещения
industrial activity	промишлена дейност
industrial area	промишлена площ
industrial association	промишлена асоциация
industrial building	промишлена сграда
industrial crop	промишлена култура
industrial development	промишлено развитие
industrial dumping	промишлени отвали
industrial economics	икономика на промишлеността
industrial effluent	промишлен приток
industrial emission	промишлена емисия
industrial environment	промишлена околна среда
industrial environmental policy	промишлена политика по околната среда
industrial equipment	промишлено оборудване
industrial installation	промишлена инсталация
industrial legislation	промишлено законодателство
industrial manufacturing	промишлено производство
industrial material	промишлен материал
industrial medicine	промишлена медицина
industrial noise	промишлен шум
industrial planning	промишлено планиране
industrial plant (building) ; industrial plant	Промишлено предприятие (сграда) ; промишлено предприятие
industrial plant (organism) ; industrial plant	промишлено растение (организъм)
industrial policy	промишлена политика
industrial pollution	промишлено замърсяване
industrial process	промишлен процес
industrial product	промишлен продукт
industrial production	промишлено производство
industrial production statistics	статистика на промишленото производство
industrial property right	право на промишлена собственост
industrial safety	промишлена безопасност
industrial site	промишлена площадка
industrial sludge	промишлена утайка
industrial society	промишлено (индустриално) общество
industrial structure	промишлена структура
industrial waste	промишлени отпадъци
industrial waste gas	промишлен отпаден газ
industrial waste water	промишлени отпадни води
industrial wasteland	промишлени пустеещи земи
industrial zoning	промишлено райониране
industrialisation	индустриализация
industry	промишленост ; промишленост
inert waste	инертен отпадък
inertisation	инертизация
infant	Дете ; дете
infant mortality	детска смътност
infection	инфекция
infectious disease	инфекциозна болест
infestation of crops	поразяване на културите
infestation of food	заразяване на храната
infiltration	инфилтрация
inflammable substance	лесно възпламеняемо вещество
inflow	приток
influenza ; flu	инфлуенца
info ; information	Информация ; информация
informal negotiation	неформални преговори
informatics ; computer science ; information science	Информатика ; информатика
information centre	информационен център
information clearing-house	информационна централа
information exchange	обмен на информация
information infrastructure	информационна инфраструктура
information kit	информационно гнездо
information network	информационна мрежа
information processing	обработка на информация
information service	информационна служба
information source	информационен източник
information system	информационна система
information technology ; IT	информационна технология
information technology industry	промишленост за информационни технологии
information transfer	пренасяне на информация
infraction	Нарушение ; нарушение
infrared radiation	инфрачервена радиация
infrasound	ултразвук
infrastructure	инфраструктура
inhabitant	жител
initial training	първоначално обучение
injury	Нараняване ; нараняване
ink	мастило
inland fishery	сладководен риболов
inland navigation	воден транспорт в хинтерланда
inland water	вътрешна вода на сушата
inland waterways transport	вътрешен воден транспорт
innovation	Изобретение ; изобретение
inorganic chemistry	неорганична химия
inorganic fertiliser	неорганичен тор
inorganic pollutant	неорганичен замърсител
inorganic substance	Неорганично вещество ; неорганично вещество
insect	насекомо
insecticide	инсектицид
insectivore	насекомоядно
insoluble substance	неразтворимо вещество
inspection	Инспекция ; инспекция
inspection of records	инспекция на документите
inspection service	инспекционна служба
installation optimisation	оптимизация на инсталациите
installation requiring approval	инсталация нуждаеща се от одобрение
installation restoration	възстановяване на инсталация
institutional activity	институционална дейност
institutional structure	институционална структура
institutionalisation	институционализация
instrument ; musical instrument	музикален инструмент
instrument manufacture	инструментално производство
instrumentation	контролно измервателни уреди
insulation	изолация
insurance	застраховка
insurance business	застрахователен бизнес
insurance coverage	застрахователно покритие
integral natural reserve	цялостен природен резерват
integrated environmental protection technology	интегрирана технология за опазване на околната среда
integrated management	интегрирано управление (мениджмънт)
integrated pest control	интегриран контрол над вредителите
integrated pollution control	интегриран контрол над замърсяването
intensive animal husbandry	интензивно животновъдство
intensive farming	интензивно земеделие
inter-library loan	междубиблиотечен заем
interaction of pesticides	взаимодействие на пестицидите
interchange of electronic data	обмен на електронни данни
interdisciplinary research	интердисциплинарни изследвания
interest	лихва
interest group	група по интереси
interim decision	временно решение
interlaboratory comparison	междулабораторно сравнение
intermediate goods	междинни стоки
intermittent noise	прекъсващ шум
internal European market	вътрешен европейски пазар
internal migration	вътрешна миграция
internalisation of external costs	интернационализация на външните цени
international agreement	международно споразумение
international assistance	международна помощ
international balance	международно равновесие
international co-operation	международно сътрудничество
international competitiveness	международна конкурентоспособност
international conflict	международен конфликт
international convention	международна конвенция
international distribution	международно разпространение
international division of labour	международно разделение на труда
international economic law	международно икономическо право
international environmental relations	международни връзки по околната среда
international harmonisation	международна хармонизация
international law	международно право
international organisation	международна организация
international politics	международна политика
international relations	международни връзки
international safety	международна сигурност
international standardisation	международна стандартизация ; международна стандартизация
international trade	международна търговия
international transaction	международни сделки
international watercourse	международни водни течения
internationally important ecosystem	екосистема с международно значение
internet search service	услуга за търсене в интернет
internet service provider ; ISP ; Internet access provider ; Internet service provider	доставчик на интернет услуги
interpolation	интерполация
interpretation method	метод за интерпретация
intertidal zone	приливно-отливна зона
intervention fund	фонд за интервенция
intervention in nature and landscape	интервенция в природата и ландшафта
intervention on land	Интервенция върху земята
intoxication	интоксикация
introduction of animal species	въвеждане на животински видове
introduction of plant species	въвеждане на растителни видове
inventory	опис
inventory of forest damage	опис на вредите върху гората
inversion	инверсия
inversion layer	инверсионен слой
invertebrate	Безгръбначно ; безгръбначно
investment	инвестиция
iodine	Йод ; йод
ion	Йон ; йон
ion exchange	Йонообмен ; йонообмен
ion exchanger	Йонообменник ; йонообменник
ionising radiation	Йонизираща радиация ; йонизираща радиация
ionosphere	Йоносфера ; йоносфера
iridium	иридий
iron	Желязо ; желязо
iron and steel industry	желязо- и стоманодобивна промишленост
iron industry	железодобивна промишленост
iron scrap	железен скрап
ironwork industry	промишленост за железни предмети
irradiation	ирадиация (облъчване)
irreversibility of the phenomenon	необратимост на явлението
irrigation	напояване
irrigation farming	напоително земеделие
irrigation system	напоителна система
island ; isle	Остров ; остров
island ecosystem	островна екосистема
isomer	измер
isotope	изотоп
ivory	Слонова кост ; cлонова кост
jaguar	ягуар
jazz	джаз
joint debtor	съвместен длъжник
joint implementation	съвместно осъществяване
journalist	журналист
judgement (sentence) ; sentence ; judgement	присъда ; решение (присъда) ; решение
judicial assistance	Юридическа помощ ; юридическа помощ
judicial body	Юридическо тяло ; юридическо тяло
judicial system	Юридическа система ; юридическа система
judiciary rule	Юридическо правило (закон) ; юридическо правило
judo	джудо
juridical act	юридически акт
jurisdiction	Правосъдие ; правосъдие
jurisprudence	Юриспруденция (правна наука) ; юриспруденция
justice	Справедливост ; справедливост
karate	карате
karst	карст
kerosene	керосин, петрол
kidney	bubreg ; бъбрек
kilogram	килограм
knife	нож
knight ; knight	кон
krypton	криптон
labelling	означаване с надписи
laboratory	лаборатория
laboratory experiment	лабораторен експеримент
laboratory research	лабораторно изследване
laboratory technique ; laboratory techniques	лабораторна техника
laboratory test	лабораторен опит
laboratory waste	лабораторни отпадъци
labour	Труд ; труд
labour force	работна сила
labour law	трудово право
labour market	пазар на труда
labour relations	трудови взаимоотношения
lacquer	Лак ; лак
lagoon	лагуна
lagooning	лагунно пречистване
lake	Езеро ; езеро
lake basin	езерен басейн
lake pollution	замърсяване на езерата
lamp ; light	Лампа ; лампа
land	Земя ; земя
land allotment	парцелиране на земята
land clearing	освобождаване на земя (клиринг)
land conservation	консервация на земята
land consolidation	консолидация на земята
land cover	земна покривка
land development	развитие на земята
land disposal	Депониране върху земята ; депониране върху земята
land ecology	екология на земята
land forming	образуване (формиране) на земята
land mammal	сухоземен бозайник
land management and planning	управление и планиране на земята
land occupation	влизане във владение на земята
land planning	планиране на земята
land pollution	замърсяване на земята
land reclamation	възстановяване на земята
land register	регистър на земята
land restoration	Възстановяване (подновяване) на земята ; възстановяване на земята
land restoration in mountain areas	възстановяване (подновяване) на земята в планински райони
land setup	устройство на земята
land tax	поземлен данък
land transportation	сухоземен транспорт
land use	земеползване
land use classification	класификация на земеползването
land use plan	план за земеползване
land use planning	планиране на земеползването
land use regime	режим на земеползване
land value	стойност на земята
land-based activity	дейност върху земята
land-based marine pollution	морско замърсяване идващо от земята
land-management intervention area	област на интервенция по управление на земите
landfill	Сметище ; сметище
landfill base sealing	запечатване основата на сметището
landfill covering	покриване на сметище
landfill degasification	дегазация на сметище
landfill gas	сметищен газ
landfill leachate	сметищно просмукване
landform	земна форма
landscape	ландшафт
landscape after mining	ландшафт след миниране
landscape alteration	Вариации на ландшафта ; вариации на ландшафта
landscape architecture	Архитектура на ландшафта ; архитектура на ландшафта
landscape component	Компонент на ландшафта ; компонент на ландшафта
landscape conservation	консервация на ландшафта
landscape conservation policy	политика за консервация на ландшафта
landscape consumption	консумация на ландшафта
landscape ecology	екология на ландшафта
landscape management	управление на ландшафта
landscape planning	планиране на ландшафта
landscape protection	опазване на ландшафта
landscape protection area	област на опазване на ландшафта
landscape utilisation	утилизация на ландшафта
landslide	свлачище
language	език
lantern	фенер
large combustion plant	голяма горивна инсталация
laser ; Light Amplification by Stimulated Emission of Radiation	лазер
latitude	географска ширина
laundering	пране
lavender ; lavander	лавандула
law	Закон (отделен) ; закон
law	Право (сбор от норми) ; право
law ; law (science)	Право (наука) ; право
law amendment	изменение на закон
law branch	правен отрасъл
law draft	законопроект
law enforcement	налагане на правото
law relating to prisons	закони, касаещи затворите
lawyer	адвокат
leaching	Процеждане, просмукване, филтриране ; процеждане ; просмукване ; филтриране
lead	Олово ; олово
lead compound	оловно съединение
lead level in blood	ниво на оловото в кръвта
lead-in-petrol law	Закон за съдържанието на олово в бензина (за безоловните бензини) ; закон за съдържанието на олово в бензина
leaf	Листо ; листо ; лист
leakage	Теч ; теч
learn	уча ; научавам ; науча
lease	Наем, Лизинг ; наем ; лизинг
leather	кожа
leather industry	кожна промишленост
leg	крак
legal basis	правно основание
legal form of organisations	правен статут на организациите
legal procedure	Правен процес ; правен процес
legal profession	Юридическа професия (гилдия) ; юридическа професия
legal regulation	правно регулиране
legal remedy	правно средство
legal system	правна система
legal text	правен текст
legally protected right	право, защитено от закона
legislation	Законодателство ; законодателство
legislation on pollution	законодателство по замърсяването
legislative authority	законодателна власт
legislative competence	Юридическа компетентност ; юридическа компетентност
legislative information	Юридическа информация ; юридическа информация
legislative procedure	процедура по законотворчество
legislature	законодателен орган
leisure activity	почивно дело
leisure centre	спортен център
leisure time	Свободно време ; cвободно време
lens	леща
lentil	леща
lepidopteran	ципокрили
less developed country	слабо развита страна
letter	буква
leukaemia	левкемия
level of education	ниво на обучение
levy	Облагане ; облагане
lexicon	лексикон
liability	Отговорност ; отговорност
liability legislation	законодателство, касаещо отговорностите
liberalism	либерализъм
library	Библиотека ; библиотека
library service	Библиотечни услуги ; библиотечни услуги
licencing procedure	процедура по лицензиране
lichen	лишей
life cycle	жизнен цикъл
life science	Наука за живота ; наука за живота
life-cycle management	управление на жизнения цикъл
lifeguard	спасител
lifestyle	начин на живот
light	Светлина ; cветлина
lighting	осветление
lignite	лигнит
lignite mining	добив на лигнитни въглища
lime	Вар ; вар
limestone	Варовик ; варовик
limit value	ограничение, пределно допустима норма
limnology	лимнология
line	линия
line source	линеен източник
linear source of sound	линеен източник на звук
liner material	втулка, облицовка
linguistics	езикознание
lion	лъв
lip	устна
lipid	липиди
lipophilic substance	липофили
liquefied gas	втечнен газ
liquid manure	течен тор
liquid state	течно състояние
liquid waste	течни отпадъци
literature	Литература ; литература
literature data bank	литературна банка данни
literature evaluation	литературна оценка
literature study	литературно проучване
lithium	литий
lithography	литография
lithosphere	литосфера
litigation	Съдебен процес ; cъдебен процес
litter	отпадъци ; Сламена постеля ; сламена постеля
littoral	Крайбрежен, литорален ; крайбрежен ; литорален
livestock	Добитък ; добитък
livestock breeding	животновъдство ; развъждане на добитък
livestock farming	животновъдство
living condition	условия на живот
living environment	жизнена околна среда
living space	жизнено пространство
living standard	стандарт на живот
lizard	гущер
load bearing capacity	капацитет на натоварване
local afforestation	местно залесяване
local authority	местна власт
local development	местно развитие
local finance	местни финанси
local government	местно управление
local government policy	политика на местното управление
local heat supply	местно топлоснабдяване
local passenger service	местно транспортно обслужване
local recreation	местна рекреация
local resource utilisation	местна утилизация на ресурсите
local traffic	местен трафик
location of industries	промишлена зона
locomotive	Локомотив ; локомотив
lodging	квартирни услуги
long	висок ; дълъг
long-distance traffic	трафик на далечни разстояния
long-distance transport	транспортиране на далечни разстояния
long-term effect	дългосрочен ефект
long-term experiment	дългосрочен експеримент
longitude	географска дължина
lorry	камион
loss	загуби
loss of biotope	загуби на биотопи
lottery	лотария
loudness	гръмкост, сила на звука
love	любов
low flow	слаб поток
low-cost housing	евтино строителство
low-level flight	нисък полет
low-level technology	слабо развита технология
lubricant	смазка
luminosity	Блясък ; блясък
lunch ; lunch ; lunch ; lunch ; luncheon	обяд ; обяд ; обяд ; обяд ; обяд
lux	лукс
lye	луга
lymphatic system	лимфна система
lysimetry	лизиметрия
machine gun	картечница
machine manufacture	производство на машини
machinery ; mechanism	Машини, оборудване ; машини ; оборудване
macroeconomic goal	макроикономическа цел
macroeconomics	макроикономика
macrophyte	макрофит
macroscopic	макроскопично
magnesium	магнезий
magnetic tape	магнитна лента
magnetism	магнетизъм
maintenance (technical) ; maintenance	Поддръжка (техническа) ; поддръжка
maintenance of environment	поддръжка на околната среда
major accident	голяма авария
major risk	голям риск
major risk installation	рискови инсталации
malaria	Малария ; малария
male ; man	мъж
malformation	малформация
malnutrition	недохранване
mammal	Бозайник ; бозайник
man	Човек ; човек
man-made climate change	Антропогенни климатични промени ; антропогенни климатични промени
management	управление, ръководство, управляване
management accounting	управленско счетоводство
management contract	управленски договор
management of natural resources	управление на природните ресурси
management plan	план за управление
management technique	управленска техника
mandarin ; Mandarin ; Standard Mandarin	мандарин
mandate	мандат
manganese	манган
mangrove	ризофора, мангрово дърво
manpower	Човешка сила ; човешка сила
manufacturing activity	производствена дейност
manufacturing trade	производствена търговия
manure	Естествен тор ; естествен тор
manure production	производство на тор
map	Карта ; карта
map chart	картова схема
mapping	картиране
mapping of lichens	картиране на лишеи
maquis	маки
marble	Мрамор ; мрамор
marginal land	маргинална земя
mariculture	моревъдство
marina	марина
marine biology	морска биология
marine ecology	морска екология
marine ecosystem	морска екосистема
marine engineering	морски инженеринг
marine environment	морска околна среда
marine fauna	морска фауна
marine fishery	морски риболов
marine geology	морска геология
marine mammal	морски бозайник
marine monitoring	морски мониторинг
marine organism	морски организъм
marine park	морски парк
marine pollution	морско замърсяване
marine reserve	морски резерват
marital status	семейно положение
maritime law	морско право
maritime navigation	морска навигация
maritime transport	морски транспорт
marker	маркер
market ; marketplace	Пазар ; пазар
market economy	пазарна икономика
market form	пазарна форма
market gardening	пазарно градинарство
market price	пазарна цена
market research	пазарно проучване
market study	пазарно изследване
marketing	маркетинг
marsh	блато
marsupial	двуутробен
masonry	зидария
mass media	Мас медия ; мас медия
mass recreation	масова рекреация
mass transport	придвижване на маса
material ; materials	материал ; материали
material life cycle	жизнен цикъл на материала
materials science	материалознание
mathematical analysis	математически анализ
mathematical method	математически метод
mathematics	математика
mausoleum	мавзолей
maximum admissible concentration	максимално допустими концентрации
maximum immission concentration	максимална концентрация на имисии
mayonnaise	майонеза
mayor	кмет
meadow	ливада
means of agricultural production	средства за селскостопанско производство
means of communication	средства за комуникация
measuring	измерване
measuring instrument	Измервателен инструмент ; измервателен инструмент
measuring method	метод на измерване
measuring programme	програма за измерване
meat	Месо ; месо
mechanical equipment	машинно оборудване
mechanical industry	машинна индустрия
mechanical vibration	механични вибрации
medical science	медицинска наука
medicinal plant	медицинско растение
medicine ; medicine (practice)	Медицина (практика) ; медицина
meitnerium	метерий
melting	топене
membrane	мембрана
mendelevium	менделевий
merchant	търговец
merchant shipping	търговско корабоплаване
mercury	живак
metabolism	метаболизъм
metabolite	метаболит
metainformation	метаинформация
metal	метал
metal oxide	метален оксид
metal product	метален продукт
metal products industry	металопроизводство
metal waste	метални отпадъци
metallic mineral	металосъдържащи минерали, метални руди
metallurgical industry	металургична промишленост
metallurgy	mеталургия
metaphysics	метафизика
meteor ; meteor ; meteor ; meteor ; meteor ; shooting star ; falling star	метеор ; метеор ; метеор ; метеор ; метеор
meteorite	метеорит
meteorological disaster	метеорологично бедствие
meteorological parameter	метеорологичен параметър
meteorological phenomenon	метеорологичен феномен, явление
meteorological research	метеорологично проучване
meteorology	метеорология
methane ; marsh gas ; methyl hydride	Метан ; метан
methanisation	метанизация
methanol	метанол
method	метод
methodology	методология
metrology	метрология
metropolis	метрополис
micro-organism	микроорганизъм
microbiological analysis	микробиологичен анализ
microbiology	микробиология
microclimate	микроклимат
microclimatology	микроклиматология
microcomputer	микрокомпютър
microecosystem	микроекосистема
microelectronics ; microminiaturization ; microsystem electronics	микроелектроника
microfiltration	микрофилтрация
microphone	микрофон
micropollutant	микрозамърсител
microscopy	микроскопия
microwave	микровълни
migrant labour	мигрираща работна ръка
migratory bird	мигриращи птици
migratory fish	мигриращи риби
military activities	военни дейности
military air traffic	военно-въздушно движение
military aspects	Военни аспекти ; военни аспекти
military equipment	военно оборудване
military zone	военна зона
milk	Мляко ; мляко
mill	мелница
mine	мина
mine filling	запълване на мини (рекултивация) ; запълване на мини
mineral	минерал
mineral conditioner	минерален подобрител
mineral deposit	минерални депа
mineral extraction	извличане (добив) на минерали
mineral fibre	минерални влакна
mineral industry	минерална промишленост
mineral matter	минерални вещества
mineral oil	минерално масло
mineral pollution	минерално замърсяване
mineral resource	минерални ресурси
mineral waste	минерални отпадъци
mineral water	минерална вода
mineralisation	минерализация
mineralogy	минералогия
minimal cost planning	планиране на минимална себестойност
minimisation of damage	минимизиране на щетите
mining district	минна област
mining industry	минна промишленост
mining law	минно право
mining product	минен продукт
mining regulation	минни разпоредби
mining site restoration ; mine reclamation	рекултивация на стари мини
mining waste	минни отпадъци
ministerial decree	министерско постановление
ministry	министерство
ministry ; ministry building	министерство ; министерство (сградата)
minority	малцинство
minute	минута
miscellaneous product	смесени, разнообразни, разнородни продукти
miscibility	смесимост
mist	лека мъгла ; пека мъгла
mite	Червей ; червей
mitigation measure	смекчаваща мярка
mixed farming	смесено фермерство/селско стопанство
mixed forest	смесена гора
mixed use area	област със смесена употреба
mixing	смесване
mobile home	мобилен дом
mode of transportation	начин/метод/способ на придвижване/транспортиране
model	Модел ; модел
model	модел
modelling	моделиране
moisture	влага
molar ; tooth	зъб
molecular biology	молекулярна биология
mollusc	мекотело
molybdenum	молибден
monetary assessment	монетарна оценка
monetary economics	монетарен икономикс
monetary relations	парични отношения
money market	паричен пазар
monitoring	мониторинг
monitoring criterion	мониторингов критерий
monitoring data	мониторингови данни
monitoring equipment	мониторингово оборудване
monitoring network	мрежа за мониторинг
monitoring station	пункт за мониторинг
monitoring technique	техника на мониторинг
monopoly	монопол
monument	монумент
morphine	морфин
morphology	Прахова емисия ; прахова емисия
mortality	смъртност
mosaic	мозайка
moss	мъх
mother	майка
mother-in-law ; mother in law	баба ; тъща
motor fuel	моторно гориво
motor vehicle	моторно превозно средство
motor vehicle exhaust gas	отработени газове от моторни превозни средства
motor vehicle industry	Автомобилна, мотоциклетна (МПС) промишленост ; автомобилна ; мотоциклетна промишленост ; МПС
motor vehicle pollution	замърсяване от моторни превозни средства
motorcycle ; motorbike	мотоциклет
motorway ; pike ; expressway ; freeway ; state highway ; superhighway ; throughway ; thruway	магистрала
mountain	Планина ; планина
mountain climate	планински климат
mountain forest	планински гори
mountain management	планински мениджмънт
mountain protection	опазване на планините
mountain range	планинска верига
mountain resort	планински курорт
mountainous area	планинска област
mouse	мишка
mowing	косене
mud	Кал (седимент) ; кал
mud flat	кална равнина
mulch	тор, слама (около розсадени разстения и овошки)
mule	муле
multilateral agreement	многостранен договор
multimedia technology	мултимедийна технология
multinational firm	многонационална компания
multispectral scanner	многоспектърен скенер
municipal cleansing service	общински дейности по чистотата
municipal dumping	общинско сметище/бунище
municipal environment plan	общински екологичен план
municipal environmental policy	общинска екологична политика
municipal law	общинско право
municipal level	общинско ниво
municipal waste	общински отпадъци
municipal water distribution system	общинска водоразпределителна система
municipal water management	управление на общинските води
municipality	община
muscular system	мускулна система
museum	музей ; музей
mushroom	гъби
music	музика
musical	мюзикъл
musician	музикант
mussel farming	мидовъдство
mustelid	невестулкови
mutagen	мутаген
mutagenicity	мутагенност
mutagenicity testing	тест за мутагенност
mutant	мутант
mutated micro-organisms release	изпускане на мутирали микро-организми
mutation	мутация
mycete	мицет
mycology	микология
mycorrhiza	микориза
mysterious	таинствен
myth	Мит ; мит
name ; proper name ; proper noun	име
napkin	салфетка
nappy	пелена
national accounting	национално счетоводство
national boundary	национална граница
national economy	национално стопонство
national environmental accounting	национално екологично счетоводство
national fishing reserve	национален рибен резерват
national legislation	национално законодателство
national park	национален парк
national planning	национално планиране
nationalisation	национализация
natural area	природна област
natural areas protection	опазване на природните области
natural disaster	природно бедствие
natural environment	природна околна среда
natural fertiliser	Естествен тор ; естествен тор
natural fibre	естествени влакна
natural forest	природни гори
natural gas	природен газ
natural gas exploration	проучване/сондиране за природен газ
natural gas extraction	извличане на природен газ
natural hazard	природна опасност
natural heritage	природно наследство
natural heritage assessment	оценка на природното наследство
natural material	естествен материал
natural monument	природна забележителност
natural park	природен парк
natural radioactivity	природна радиоактивност
natural regeneration	естествено възстановяване
natural resource	природен ресурс
natural resource conservation	консервация на природните ресурси
natural risk	природен риск
natural risk analysis	Анализ на природния риск ; анализ на природния риск
natural risks prevention	опазване от природни рискове
natural scenery	природен пейзаж
natural science	естествени науки/естествознание
natural stone	самороден камък
natural value	природна/естествена/реална стойност
nature conservation	опазване на природата
nature conservation legislation	законодателство по опазване на природата
nature conservation organisation	природозащитна организация
nature conservation programme	програма за опазване на природата
nature protection	защита на природата
nature reserve	природен резерват
nausea	повдигане, гадене, повръщане; морска болест; отвращение, погнуса
navigation	навигация
navigational hazard	навигационна опасност
necrosis	Некроза ; некроза
need	нужда, необходимост
neighbourhood noise	Шум от околността ; шум от околността
nematode	нематод, кръгъл червей
neodymium	неодим
neologism	Неологизъм ; неологизъм
neon	неон
neoplasm ; tumour	тумор
neptunium	нептуний
nervous system	нервна система
nesting	гнездене
nesting area	област на гнездене
netting policy (emissions trading) ; netting policy	мрежова политика (търговия на емисии)
neurology	неврология
neurotoxicity	нервотоксичност
neutralisation	неутрализация
new community	нова общност
new installation	нова инсталация
new material	нов материал
new technology	нова технология
newsgroup	дискусионна група ; дискусионна група
newsletter	Бюлетин ; бюлетин
nickel	никел
niobium	ниобий
nitrate	нитрат
nitrification	нитрификация
nitro compound	нитро-съдържимо
nitrogen	Азот ; азот
nitrogen cycle	Азотен цикъл ; азотен цикъл
nitrogen dioxide	Азотен диоксид ; азотен диоксид
nitrogen fixation	Процес на усвояване на азота ; процес на усвояване на азота
nitrogen monoxide	Азотен моноксид ; азотен моноксид
nitrogen oxide	Азотен оксид ; азотен оксид
nitrogen oxides	Азотни оксиди ; азотни оксиди
nitrogenous fertiliser	Азотен тор ; зотен тор ; азотен тор
nitrosamine	нитросамин
nobelium	нобелий
noise	Шум ; шум
noise ; noise, vibrations ; racket	шум ; шум, вибрации
noise abatement	Борба с шума/ Намаляване на шума ; борба с шума ; намаляване на шума
noise analysis	Шумов анализ ; шумов анализ
noise barrier	Шумова бариера ; шумова бариера
noise control	контрол на шума
noise disturbance ; noise pollution	Шумово смущение/безпокойство/обезпокояване ; шумово смущение ; безпокойство ; обезпокояване
noise emission	Шумова емисия ; шмова емисия
noise emission levy	облагане на шумовите емисии
noise exposure plan	план за излагане на шум
noise immission	Шумови имисии ; шумови имисии
noise legislation	Шумово законодателство ; шумово законодателство
noise level	ниво на шума
noise measurement	измерване на шума
noise pollutant	Шумов замърсител ; шумов замърсител
noise pollution	Шумово замърсяване ; шумово замърсяване
noise protection	защита от шум
noise reduction	намаляване на шума
noise spectrum	Шумов спектър ; шумов спектър
noise-free technology	Безшумна технология ; безшумна технология
nomad	Номад ; номад
nomenclature	Номенклатура ; номенклатура
non-biodegradable pollutant	не-биоразтворим замърсител
non-built-up area	незастроена област
non-conventional energy	неконвенционална енергия
non-demesnial water	недържавни води
non-durable goods	малотрайни стоки
non-ferrous metal	цветни метали
non-ferrous metal industry	цветна металопромишленост
non-governmental organisation	неправителствена организация (нпо)
non-ionising radiation	нейонизираща радиация
non-metal	неметал
non-metallic mineral	неметални минерали
non-polluting energy source	незамърсяващ източник на енергия
non-polluting fuel	незамърсяващо гориво
non-renewable energy resource	невъзстановим енергиен ресурс
non-renewable resource	невъзстановим ресурс
non-residential building	обществена сграда
non-returnable container	невръщаем контейнер
non-target organism	нецелеви организъм
non-volatile substance	нелетливо вещество
norm	Норма ; норма
nose	нос
nosotros ; we	ние
not	не
nothing	нищо
notice	известие ; предупреждение ; съобщение
notification	нотификация
noun ; substantive	съществително име
nuclear accident	Ядрен инцидент ; ядрен инцидент
nuclear debate	Ядрен дебат ; ядрен дебат
nuclear energy	Атомна енергия ; атомна енергия
nuclear energy legislation	законодателство, свързано с използване на атомната енергия
nuclear energy use	използване на атомната енергия
nuclear explosion (accident) ; nuclear explosion	Ядрена експлозия ; ядрена експлозия
nuclear facility	Ядрено съоръжение ; ядрено съоръжение
nuclear fission	деление, разпад на атома
nuclear fuel	Ядрено гориво ; ядрено гориво
nuclear fuel element	елемент на ядреното гориво
nuclear fusion	Ядрено горене ; ядрено горене
nuclear hazard	Ядрена опасност ; ядрена опасност
nuclear physics	ядрена физика ; ядрена физика
nuclear power plant	Атомна централа ; атомна централа
nuclear reaction	Ядрена реакция ; ядрена реакция
nuclear reactor	Ядрен реактор ; ядрен реактор
nuclear research centre	център за ядрени проучвания
nuclear risk	Ядрен риск ; ядрен риск
nuclear safety	Ядрена безопасност ; ядрена безопасност
nuclear test	Ядрен тест ; ядрен тест
nuclear weapon	Ядрено оръжие ; ядрено оръжие
nucleic acid	нуклеинова киселина
nursery (plant breeding) ; nursery ; plant nursery	разсадник
nutrient	хранително вещество
nutrient balance	хранителен баланс
nutrient content	хранително съдържание
nutrient cycle	хранителен цикъл
nutrient medium	хранителна среда
nutrient removal	отстраняване на хранителни вещества
nutrition	Хранене ; хранене
nutritive value of food	хранителна стойност на храната
oak	Дъб ; дъб
obesity	затлъстяване
objection	възражение
obligation to inform	задължение за предоставяне на информация
obligation to label	задължение за етикетиране
observation	наблюдение ; обсервация
observation satellite	наблюдаващ сателит
obstacle ; obstruction	пречка
occupational disease	професионално заболяване
occupational health	професионално здраве
occupational health care	грижа за професионалното здраве
occupational medicine	професионална медицина
occupational safety	професионална безопасност
occupational safety regulation	разпоредби за професионална безопасност
occupational status	професионален статус
ocean ; sea ; body of water ; bounding main	Океан ; океан
ocean circulation	циркулация на океана
ocean current	океански поток
ocean dumping	дъмпинг в океана
ocean exploitation	експлоатация на океана
ocean temperature	океанска температура
ocean-air interface	взаимодействие океан-въздух
oceanic climate	океански климат
oceanography	океанография
octave	октава
octopus	октопод
odour	мирис
off-peak travelling	пътуване с обществен транспорт извън натоварените часове
off-site	извън обекта
offence against the environment	простъпкасрещу околната среда
office	офис (канцелария) ; офис
official duty	служебни задължения
official hearing	официално изслушване
official language	официален език
offset policy (emissions trading)	компенсационна политика (търговия с емисии)
offshore mining	крайбрежно/ оф-шорно минно дело
ohm	ом
oil and fat industry	маслодобивна промишленост
oil binding agent	маслено-свързващ агент
oil boom	маслен плаващ бараж
oil disaster	замърсяване с петрол
oil exploration	проучване нанефтени находища
oil extraction	извличане на петрол
oil pipeline	петролопровод
oil pollution	замърсяване с петрол
oil pollution abatement	намаляване на замърсяването с петрол
oil production (chain)	производство на петрол (верига)
oil recovery vessel	съд за отстраняване на петролни разливи
oil refinery	петролна рафинерия
oil residue recuperation	регенериране на остатъчен петрол
oil slick	петролно петно
oil spill	изпускане на петрол
oil tanker	Петролен танкер ; петролен танкер
oil-based energy	петролно-производна енергия
old hazardous site	стар опасен обект
old landfill site	старо сметище
olfactory pollution	олфакторно замърсяване
oligopoly	олигопол
olive oil mill wastewater	отпадъчни води от зехтинодобивно предприятие
omega	омега
on-line service	он-лайн услуги
on-site wastewater treatment	пречистване на отпадъчните води в обекта
oncology	онкология
one	едно
onion	лук
ontogenesis ; ontogenesis ; ontogeny	онтогенеза ; онтогенеза
ontology	онтология
open lawn	Тревна площ ; тревна площ
open sea	открито море
open sea fishing	риболов в открито море
opencast mining ; open-pit mining	открити рудници
opera	опера
operating data	оперативни данни
ophthalmology	офталмология
opinion ; stance	Мнение ; мнение
opinion survey	проучване на мнения
optics	oптика
oral sex	орален секс
orchestra	оркестър
orchid	орхидея
order	заповед ; заповед'
order	Заповед ; заповед
ordinance	наредба, разпоредба
ore	руда
organ	орган
organic carbon	органичен въглерод
organic chemistry	органична химия
organic farming	органично земеделие
organic matter	органичен материал
organic nitrogen	органичен азот
organic pollutant	органичен замърсител
organic pollution	органично замърсяване
organic solvent	органичен разтворител
organic substance	Органично вещество ; органично вещество
organic waste	органични отпадъци
organisation (law)	Организация (юр.) ; oрганизация
organisation of teaching	учителска организация; сдружение на преподаватели/учители
organisation of the legal system	организация на правната система
organism	организъм
organochlorine compound	органохлорни съединения
organohalogen compound	органохалогенни съединения
organoleptic property	органолептични качества
organometallic compound	органометални съединения
organonitrogen compound	органонитрогенни съединения
organooxygen compound	органокислородни съединения
organophosphorous compound	органофосфорни съединения
organosulphur compound	органосерни съединения
ornithology	омитология
orography	орография
orphan	сирак
orthography	правопис
orthopteran	правокрили
osmium	oсмий
osmosis	Осмоза ; осмоза
ostrich	щраус
outer space (allocation plan) ; outer space	външно пространство (строителен план) ; външно пространство
ovary	яйчник
oven	фурна
overburden	повърхностен пласт/слой
overexploitation	свръх-експлоатация
overfertilisation	преторяване
overfishing	свръх-риболов
overflow (outlet)	изпускателен отвор; извод; изход; изходна тръба/канал изтичане, изпускане, отвеждане
overgrazing	свръх-паша
overhead power line	въздушен кабел
overpopulation	свръхнаселеност
overturn (limnology)	преобръщане, циркулация на водата (термин от лимнологията)
overwintering	презимуване
ovine	овчи; овцеподобен вид
owner	собственик
ownership	собственост
oxidation	окисляване, окисление, оксидиране
oxidation-reduction	окисляване (оксидиране)-редукция
oxide	окис (оксид) ; оксид
oxidisable material	окисляем материал
oxidising agent	окисляващ/ оксидиращ агент
oxygen	кислород
oxygen content	съдържание на кислород
oxygenation	оксидиране; окисляване; насищане с кислород
oyster farming	отглеждане на стриди
ozone	озон
ozone depletion potential	озоноразрушаващ потенциал
ozone layer	озонов слой
ozone layer depletion	разрушаване на озоновия слой
ozonisation	озониране
packaging	опаковки
packaging waste	отпадъци от опаковки
packing industry	опаковъчна промишленост
paediatrician	педиатър
paint	Боя ; боя
paint room	Бояджийска работилница ; бояджийска работилница
paint shop	магазин за бои
painting business	Бояджийство ; бояджийство
palaeoclimatology	палеоклиматология
palaeoecology	палеоекология
palaeontology	палеонтология
palindrome	палиндром
palladium	паладий
pancreas	панкреас
pandemic	пандемия
paper	хартия
paper industry	хартиена промишленост
parachute	парашут
parameter	параметър
parasite	паразит
parasitology	паразитология
parking provision	осигурен паркинг
parliamentary debate	парламентарен дебат
parliamentary report	парламентарен доклад
part of speech ; lexical category	част на речта
partially halogenated chlorofluorohydrocarbon	частично халогенизирани хлорфлуорохидровъглероди ; частично халогенизирани хлорфлуорохидровъглероди
participation	участие
particle	Частица ; частица
particle separator	разделител на частици
party ; political party	политическа партия
passenger transport	пътнически транспорт
paste-like waste	пастообразни отпадъци
pasture	пасище
patent	патент
path	пътека
pathogen	патоген
pathogenic organism	патогенен организъм
pathologic effect	патологичен ефект
pathology	Патология ; патология
patrimonial management	патримониално управление
pattern recognition	разпознаване на модели
pay policy	разплащателна политика
peacekeeping	мироопазване
pear	круша
peat	торф
peat extraction	извличане на торф
pedagogy	педагогика
pedestrian zone ; pedestrian area ; car-free zone ; auto-free zone ; pedestrianised zone	пешеходна зона
pedosphere	педосфера
penalty	Глоба ; глоба
penalty for environmental damage	Глоба за екологични щети ; глоба за екологични щети
pencil	молив
penguin	пингвин
peninsula	полуостров
pentachlorophenol	пентахлорфенол
people	xopa
per capita data	данни на глава от населението
percolating water	процеждаща се/ проникваща/ филтрираща се вода
peripheral park area	периферна паркова зона
periphyton	перифитон
periurban space	крайградско пространство
permeability	пропускливост
permissible exposure limit	граница на допустимо излагане (на влиянието на )
permission	разрешение
peroxyacetylnitrate	пероксиацетилнитрат
persistant organic pollutant	устойчив органичен замърсител
persistence	устойчивост
persistence of pesticides	устойчивост на пестицидите
person	човек
personal responsibility	лична отговорност
pest	вредител
pest control	контрол на вредителите
pest infestation	нашествие на вредители
pesticide	пестицид
pesticide control standard	стандарт за контрол на пестицидите
pet	домашен любимец
petition	петиция
petition right	право на петиция
petrochemical	петрохимикал
petrochemical industry	нефтохимична промишленост
petrol	Бензин ; бензин
petroleum	суров петрол/ нефт
petroleum consumption	консумация на петрол
petroleum industry	петролна промишленост
phanerogam ; spermatophyte	фанерогами, явнобрачни
pharmaceutical industry	фармацевтична промишленост
pharmaceutical waste	фармацевтични отпадъци
pharmacokinetics	фармакокинетика
pharmacology	фармакология
pheasant	фазан
phenol	фенол
pheromone	феромон
philology	филология
philosophy	Философия ; философия
phone ; telephone	телефон
phonetics	Фонетика
phosphate	фосфат
phosphate removal	отстраняване на фосфати
phosphate substitute	заместител на фосфата
phosphatic fertiliser	фосфатен тор
phosphorus	фосфор
photo ; photograph	Фотография, фотографско изображение, снимка ; фотография ; фотографско ; снимка ; фотографско изображение
photochemical agent	фотохимичен агент
photochemical oxidant	фотохимичен окислител (оксидант)
photochemical pollution	фотохимично замърсяване
photochemical product	фотохимичен продукт
photochemical reaction	фотохимична реакция
photochemical smog	фотохимичен смог
photodegradation	фотодеградация
photogrammetry	фотограметрия
photography	фотограия (процес) ; фотограия
photosynthesis	фотосинтеза
physical alteration	физически промени
physical chemistry	физикохимия
physical conditions	физически условия
physical geography	физическа география
physical measurement of pollution	физическо измерване на замърсяването
physical planning	физическо планиране
physical pollutant	физически замърсител
physical pollution	физическо замърсяване
physical process	физически процес
physical property	Физическо качество ; физическо качество
physical science	физична наука
physical treatment	физическо третиране
physicochemical analysis	физикохимичен анализ
physicochemical process	физикохимичен процес
physicochemical purification	физикохимично пречистване
physicochemical treatment	физикохимично третиране
physics	Физика ; физика
physiology	физиология
phytomass	фитомаса
phytopathology	фитопатология
phytoplankton	фитопланктон
phytosanitary treatment	фитосанитарно третиране
phytosociology	фитосоциология
phytotoxicity	фитотоксичност
piano ; pianoforte	пианото ; пиано
pickling plant	завод за ецване
pigeon ; dove	гълъб
piggery	свинарник
pike ; spear	копие
pilot plant	пилотен (експериментален) завод
pilot project	пилотен проект
pilotage	пилотаж
pinniped	перконог
pino ; pine	бор
pipe	тръба
pipeline	тръбопровод
pituitary gland	хипофиза
pixel	пиксел
place ; location	място
plain	равнина
plan	план
plane source	неясен източник
planet	планета
plankton	планктон
planning	планиране
planning law	закон за планирането
planning measure	планиращи мерки
planning permission	разрешение за планиране
plant	Растение ; растение
plant biology	растителна биология
plant breeding	растениевъдство
plant community	растителна общност
plant component	растителен компонент
plant disease	Болест по растенията ; болест по растенията
plant ecology	растителна екология
plant equipment	заводско оборудване
plant heritage	растително наследство
plant physiology	растителна физиология
plant population	растителна популация
plant production	заводска продукция
plant protection	опазване на растенията
plant protection product	препарат за растителна защита
plant reproduction	растителна репродукция
plant resource	растителен ресурс
plant selection	растителна селекция
plant species	растителни видове
plant species reintroduction	реинтродукция (завръщане) на растителни видове
plant textile fibre	растителни текстилни влакна
plant trade	търговия с растения
planting	садене; залесяване; озеленяване
plasma technology	плазмена технология
plastic	пластмаса
plastic waste	пластмасови отпадъци
platinum	платина
platitude ; cliche ; cliché	клише
pleasure cruising	пътуване по вода за удоволствие
plutonium ; plutonium ; plutonium	плутоний ; плутоний ; плутоний
point	точка
point source	точков източник
poison	отрова
poisoning	отравяне
polar bear	бяла мечка
polar region	полярен регион
polder	полдер
police	полиция
police law	полицейско право
police power	полицейски правомощия
policy	Политика ; политика
policy guideline	насоки за изпълнението на определена политика
policy instrument	инструмент на политиката
policy integration	интеграция на политики
policy planning	политическо планиране
political counselling	политическо съвещание; обсъждане; разискване
political doctrine	политическа доктрина
political ecology	политическа екология
political geography	политическа география
political ideology	политическа идеология
political organisation	политическа организация
political power	политическа власт
politics	Политика ; политика
pollen	полен
pollutant	замърсител
pollutant absorption	абсорбция на замърсители ; абсорбция на замърсители
pollutant accumulation	Акумулация/ натрупване на замърсители ; акумулация на замърсители ; натрупване на замърсители
pollutant analysis	Анализ на замърсители ; анализ на замърсители
pollutant assessment	определяне (количествено и качествено) на замърсител
pollutant concentration	концентрация на замърсители
pollutant degradation	деградация на замърсители
pollutant deposition	отлагане, утаяване на замърсители
pollutant dispersion	дисперсия на замърсители
pollutant distribution	разпределение на замърсители
pollutant elimination	елиминиране на замърсители
pollutant emission	емисии от замърсители
pollutant evolution	еволюция на замърсители
pollutant exposure	излагане на замърсители
pollutant flow	поток на замърсители
pollutant formation	образуване на замърсители
pollutant immission	имисии от замърсители
pollutant immobilisation	имобилизация на замърсители
pollutant migration	миграция на замърсители
pollutant monitoring	мониторинг на замърсители
pollutant pathway	пътека на замърсителите
pollutant reduction	редукция на замърсителите
pollutant remobilisation	реактивиране на замърсители
polluted matter	замърсен материал
polluted site	замърсено място
polluter-pays principle	принцип "замърсителят плаща"
pollution	замърсяване ; замърсяване
pollution abatement	намаляване на замърсяването
pollution abatement equipment	оборудване за намаляване на замърсяването
pollution abatement waste	отпадъци от борбата със замърсяването
pollution control	контрол на замърсяването
pollution control equipment	оборудване за контрол на замърсяването
pollution control investment	инвестиции в контрола на замърсяването
pollution control measure	мерки по контрола на замърсямването
pollution control technology	технология за контрол на замърсяването
pollution cost	цена на замърсяването
pollution effect	Въздействие на замърсяването ; въздействие на замърсяването
pollution indicator	индикатор на замърсяване
pollution insurance	осигуровка срещу замърсяване
pollution liability	отговорност за замърсяване
pollution load	натоварване от замърсяване
pollution measurement	измерване на замърсяването
pollution monitoring	мониторинг на замърсяването
pollution norm	норма на зъмърсяване
pollution prevention	предпазване от замърсяване
pollution risk	риск от замърсяване
pollution type	вид на замърсяването
polonium	полоний
polybrominated biphenyl	полибромирани бифенили
polychlordibenzo-p-dioxin	полихлордибензо-п-диоксин
polychlorinated biphenyl	полихлорирани бифенили
polychlorinated dibenzofuran	полихлориран дибензофуран
polychlorinated terphenyl	полихлориран терфенил
polycyclic aromatic hydrocarbon	полицикличен ароматен хидровъглерод
polycyclic hydrocarbon	полицикличен хидровъглерод
polyethylene terephtalate	полиетиленов терефталат
polygon	полигон
polymer	полимер
polymerisation	полимеризация
polyvinyl chloride	поливинил хлорид
pomegranate	нар
pond	езерце, водоем
pool ; puddle ; puddle	Басейн ; басейн
population	популация
population density	гъстота на населението
population dynamics	динамика на населението
population ecology	екология на популациите
population growth	ръст на населението
population movement	движение на населението
population structure	структура на населението
population trend	тенденции, свързани с броя на населението
poriferan	пориферан
posidonia ; neptunegrass	Посидония
post-treatment	последващо третиране
posterity	потомци
postman	пощаджия
potash	калий, калиев карбонат
potassium	калий
potassium fertiliser	калиев тор
potato ; patato	картофи
poultry	домашни птици
poultry farming	птицевъдство
poverty	Бедност ; бедност
power company	енергийна компания
power station	електроцентрала
power station derating	спиране на електроцентрала
power-heat relation	Отношение мощност-топлина
praseodymium	празеодим
pre-emption	право на преимуществено откупуване/ изкупуване
pre-emption zone	зона на преимуществено изкупуване
precautionary principle	принцип на превенция
precipitation ; precipitation (chemical)	Утаяване (хим.) ; утаяване
precipitation enhancement	увеличаване на валежите
precision engineering	прецизно инженерство
predator	хищник
prefabricated building	сграда от готови сглобяеми части
pregnancy	бременност
prelate	прелат
preliminary proceedings	предварително съдопроизводство
premium	Премия ; премия
preparation for market	подготовка на стоки за пазара
preposition	предлог
prescription	Право на давност ; право на давност
preservation of evidence	съхранение на доказателства
preservative	консервант
preserve	запазвам; опазвам; закрилям; спазвам; тача
president	президент
press	печат; печатни издания; преса ; печат ; преса ; печатни издания; преса ; печатни издания
pressing	пресиране
pressure	налягане
pressure equipment	съоръжение за налягане
pressure group	група за (политически) натиск
prevention measure	превантивни мерки
prevention of forest fires	превантивни мерки за предпазване от горски пожари
preventive health measure	превантивни мярки за опазване на здравето
preventive information	превантивна информация
price	цена
prices policy	ценова политика
pricing policy of resources	ценова политика за ресурсите
primary education	основно образование
primary energy consumption	първоначална консумация на енергия
primary forest	първична гора
primary sector	първичен сектор
primary treatment	първично третиране
primate	Примат ; примат
prime number ; prime	просто число
prince	принц
principle of sustainability	принцип на устойчивостта
printing work	печатна работа
private car	Частна кола ; частна кола
private domain	Частна собственост ; частна собственост
private forest	Частна гора ; частна гора
private household	Частно домакинство ; частно домакинство
private international law	международно частно право
private law	Частно право ; частно право
private sector	Частен сектор ; частен сектор
private transport	Частен транспорт ; частен транспорт
privatisation	приватизация
problem	проблем
proboscidean	хоботни
procaryote	прокариоти
procedural law	процесуално право
process analysis	Процесен анализ ; процесен анализ
process technology	технология на процес
process water	отработена вода
processed agricultural produce	преработена селскостопанска продукция
processed foodstuff	преработени храни
processing	преработване; преработка
producer liability	отговорност на производителя
product	продукт
product advertising	Реклама на продукти
product comparison	сравнение на продукти
product evaluation	оценка на продукт
product identification	идентифициране на продукти
product information	информация за продукт
product liability	отговорност за продукт
product life cycle	жизнен цикъл на продукта
product standard	стандарт на продукта
production policy	производствена политика
productivity	производителност
productivity trend	производствена тенденция
profit	Печалба ; печалба
prognostic data	прогнозни  данни
programme	програма
progress line	диаграма на развитието (отн. воден поток)
prohibition	забрана
project	проект
promethium	преметий
promotion of trade and industry	промоция в промишлеността и търговията
propagation process	процес на разпространяване (предаване)
propellant	Аерозолен газ ; аерозолен газ
properties of materials	качества на материалите
property protection	опазване на собствеността
propulsion technique	техника на тласкане
prosecution	Гонене, преследване ; Гонене ; преследване ; гонене
prosperity	Просперитет ; просперитет
prostate	простата
prostitution	проституция
protactinium	протактиний
protected area	защитена област
protected landscape	защитен ландшафт
protected marine zone	защитена морска зона
protected species	защитени видове
protection from neighbours	защита от съседи
protection of animals	опазване на животни
protection of birds	опазване на птици
protection of species	опазване на видовете
protection system	система на защита
protective measure	предпазна мярка
protein ; poly peptide	Протеин ; протеин
protein product	протеинов продукт
protocol	протокол
protozoan	едноклетъчни животни
province	Област ; област
provincial/regional authority (D) ; regional authority ; provincial authority	провинциални/регионални/местни правомощия
provincial/regional law (D) ; regional legislation	провинициално/регионално/местно законодателство
pruning	кастрене
psychiatrist	психиатър
psychic effect	психичен ефект
psychological effect	психологически ефект
psychological stress	психологически стрес
psychology	Психология ; психология
psychosomatic effect	психосоматичен ефект
psychosomatic illness	психосоматично заболяване
public	Общественост ; общественост
public access to land	обществен достъп до земя
public action	обществено действие
public aid	обществена помощ
public attendance	публично присъствие
public awareness campaign	кампания за повишаване на общественото съзнание
public bath	обществена баня
public benefit inquiry	изследване на ползите за обществото
public building	обществена сграда
public contract	обществен договор
public debt	национален  дълг
public discussion	обществена дискусия
public domain	обществено владение
public expenditure	обществени разходи
public finance	обществени финанси
public financing	обществено финансиране
public function	обществена функци
public health	обществено здраве
public hearing	обществено изслушване
public information	обществена информация
public inquiry	обществено проучване
public institution	обществена институция
public institution of administrative nature	обществена институция по административни въпроси
public institution of industrial and commercial nature	обществена институция по промишлени и търговски въпроси
public international law	международно публично право
public law	публично право
public maritime domain	обществено морско владение
public opinion	обществено мнение
public opinion polling	изследване на общественото мнение
public park	обществен парк
public participation	обществено участие
public procurement	обществено снабдяване
public prosecutor's office	офис на прокурора
public relations	Обществени отношения ; обществени отношения
public sector	публичен (обществен) сектор
public transport	обществен транспорт
public transport vehicle	превозно средство от общесвения транспорт
public utility	обществено предприятие
public waterways domain	обществено (държавно)владение на водните пътища
public works	обществена инфраструктура
public-private partnership	дружество със смесено участие; смесено предприятие
pulmonary disease	Белодробно (пулмонарно) заболяване ; белодробно заболяване ; пулмонарно заболяване
pump	помпа
pumping	помпане, изпомпване
purification	пречистване
purification facility	устройство, инсталация за пречистване
purification plant	пречиствателна станция
purification through the soil	пречистване  през почвите
purifying power	способност (потенциал) за пречистване
purin	пурини
pyralene	пирален
pyrolysis	пиролиза
quadrilateral	четириъгълник
quality assurance	осигуряване на качество; удостоверяване на качество
quality certification	сертифициране за качество
quality control	контрол на качеството
quality objective	качествена цел
quality of life	качество на живота
quality standard	стандарт за качество
quarry	кариера
quarrying	добив от кариери
quartering	Разчленяване ; разчленяване
rabbi	равин ; рави
rabbit	заек
race relations	расови отношения
racking	изсушаване, изтощаване (за почви); източване
radar	радар
radiation ; radiations	излъчване ; радиация ; Радиация; излъчване; лъчеизпускане ; лъчеизпускане
radiation damage	радиационни щети
radiation dose	радиационна доза
radiation effect	Радиационен ефект; въздействие на радиацията ; въздействие на радиацията ; радиационен ефект
radiation exposure	излагане на радиация
radiation physics	ядрена физика
radiation protection	радиационна защита
radiation protection law	закон за радиационната защита
radiation sickness	лъчева болест
radio	радио
radio programme	радио програма
radioactive contamination	радиоактивно замърсяване
radioactive decontamination	пречистване на радиоактивни замърсявания
radioactive dumping	радиактивен дъмпинг
radioactive emission	радиоактивни емисии
radioactive fallout	радиоактивни остатъци
radioactive pollutant	радиоактивен замърсител
radioactive substance	Радиоактивно вещество ; радиоактивно вещество
radioactive tracer	радиоактивен индикатор
radioactive waste ; nuclear waste	радиоактивни отпадъци
radioactivity ; radioactive decay	радиоактивност
radioelement	радиоелемент
radiology	радиология
radionuclide	Радионуклид ; радионуклид
radium	радий
radon	радон
rag	Парцал ; парцал
rail traffic	релсов трафик
rail transport	релсов транспорт
railroad vehicle ; carriage ; wagon	релсово превозно средство
railway	релсов път
railway network	железопътна мрежа
railway station	железопътна гара
rain	Дъжд ; дъжд
rain forest	джунгла, тропическа гора
rain water	дъждовна вода
rain water sewer system	канализация за дъждовни води
rainbow	дъга
rainout	Валеж ; валеж
raising a site	повдигане на терен
random test	произволен тест
rape	рапица
rapid test	Бързи, спешни изследвания ; бързи изследвания ; спешни изследвания
rapid transit train	експресен влак
rare species	редки видове
raster	растер
raster to vector	растер към вектор
rate	Норма ; Норма, мярка, ставка ; мярка ; ставка ; норма
raw material	Суровина ; cуровина
raw material consumption	консумация на суровини
raw material securing	осигуряване на суровини
raw water	сурова вода
reaction kinetics	кинетика на реакциите
reactor	реактор
reactor safety	Безопасност на реактора ; безопасност на реактора
reality	реалност
reasonableness	благоразумие ; търпимост ; умереност
recipe	рецепта
reclamation industry	регенерираща промишленост
recombinant DNA technology	рекомбинантна днк технология
recommendation	препоръка
recording of substances	запис на вещества
recovery of landscape	възстановяване на ландшафта
recovery plan	план за възстановяване
recreation	Рекреация ; рекреация
recreational area	област за рекреация
recyclability	рециклируемост
recyclable plastic	рециклируема пластмаса
recycled material	рециклиран материал
recycled paper	рециклирана хартия
recycling	рециклиране
recycling management and waste law	законодателство по управление на рециклирането и отпадъците
recycling potential	потенциал за рециклиране
recycling ratio	коефициент на рециклиране
red tide	Червен прилив ; червен прилив
redress	компенсация
reed	тръстика
reef	риф
reference service	референтна услуга; справки
referendum ; plebiscite	референдум
referral information	референтна информация; справка
referral information system	референтна информационна система
refinery	рафинерия
refining	рафиниране
reflection	отражение
reflectometry	рефлектометрия
reforestation	Залесяване
refrigerant	охладител
refrigeration	охлаждане
refrigeration industry	хладилна промишленост
refrigerator	Хладилник ; xладилник
refuge	Подслон, убежище, естествен резерват ; Подслон ; убежище ; естествен резерват ; подслон
refugee	Бежанец ; бежанец
refuse collection vehicle	кола за събиране на отпадъци, сметовоз
refuse derived fuel	гориво от отпадъци
refuse shredder	раздробител на отпадъци
refuse-sludge compost	отпадъчен, утаечен компост
regeneration	регенерация, регенериране
region	регион
regional authority	регионални органи
regional convention	регионална конференция, конгрес
regional development	регионално развитие
regional law	регионално законодателство
regional natural park	регионален природен парк
regional plan	регионален план
regional planning	регионално планиране
regional regulation	регионални разпоредби
regional statistics	регионална статистика
regional structure	регионална структура
registered site	регистриран обект
registration	регистрация
registration obligation	задължение за регистрация
registration proceeding	процедури по регистрация
regulation	регулиране, регулация; правило, наредба; постановление
regulation of agricultural production	регулиране на селскостопанската продукция
regulation on maximum permissible limits	регулиране в максимално разрешени граници
regulative law	регулаторен закон
rehousing	настаняване в ново жилище
reintroduction	нововъвеждане
relational database	релационна база данни
release of organisms	изпускане на организми
relief (land)	релеф
religion	Религия ; религия
remote sensing	дистанционно проучване
remote sensing centre	център за дистанционни проучвания
removal	отстраняване
renaturation	ренатурация
renewable energy source	Възстановим енергиен източник ; възстановим енергиен източник
renewable raw material	Възстановима суровина ; възстановима суровина
renewable resource	Възстановим ресурс ; възстановим ресурс
repair business	поправки; ремонтна дейност
replacement	замяна; заместване, връщане, възстановяване (хим.)
replacement cost	цена на замяната
report on the state of the environment	доклад за състоянието на околната среда
report to the minister	доклад до министър
reporting process	докладване
representation	представителство
repression	репресия; ограничаване, подтискане
reprocessing	повторно преработване
reproduction	репродукция, размножаване (биол.)
reproductive manipulation	репродуктивна манипулация
reptile ; reptile ; reptile	Влечуги ; влечуги ; влечуги ; влечуги
rescue service	спасителна служба
rescue system	система за спасяване
research	изследване ; проучване
research centre	изследователски център
research of the effects	проучване на въздействието
research policy	изследователска политика
research project	изследователки проект
reserve	резерват
reservoir	резервоар
residential area	жилищен район
residential area with traffic calmings	жилищен район с ограничение скоростта на превозните средства.
residential building	жилищна сграда
residual amount of water	остатъчно ниво на водите
residual pesticide	остатъчен пестицид
residual risk	остатъчен риск
residual waste	остатъчни отпадъци
residual waste sludge	остатъчна отпадъчна утайка
residue analysis	Анализ на остатъци ; анализ на остатъци
residue of grinding	остатъци от смилане
residue recycling	рециклиране на остатъци
resin	смола, каучук
resinous plant	каучуково дърво
resistance (biological) ; resistance	устойчивост (биол.)
resolution	Резолюция ; резолюция
resolution ; resolution (parameter)	Резолюция, разделителна способност (параметър) ; резолюция ; разделителна способност
resorption	резорбция
resource ; resources	ресурс ; ресурси
resource appraisal	оценка на ресурсите
resource conservation	консервация на ресурсите
resource exploitation	експлоатация на ресурсите
resource reserve	ресурсен резерват
resource utilisation	използване на ресурсите
resources management	управление на ресурсите
respiration	дишане
respiratory air	дихателен обем
respiratory disease	Респираторно заболяване (заболяване на дихателните пътища) ; респираторно заболяване
respiratory system	дихателна система
retaining reservoir	водохранилище, язовир
reverse osmosis	обратна осмоза
rhenium	рений
rhino ; rhinoceros	носорог
rhodium	родий
rhombus ; rhomb	ромб
rice	ориз
rising sea level	вдигане на морското ниво
risk communication	комуникация за риск
river	Река ; река
river bed	речно легло
river water	речни води
road	път
road network	пътна мрежа
road salt	пътна сол
rock	Скала ; скала
rodent	гризач
rolling noise	тътнещ шум (шум от движението на гуми)
roof ; roof ; roof	покрив ; покрив ; покрив ; покрив ; покрив ; покрив ; покрив
root	Корен ; корен
rotary furnace	ротационна пещ
route	Маршрут, път, курс ; маршрут ; път ; курс
rubber	Каучук;гума ; каучук ; гума
rubidium	рубидий
ruby	рубин
rural area	селски район
ruthenium	рутений
rutherfordium	ръдърфордий
safety ; security	Безопасност ; безопасност
safety measure	мярка за безопасност
sahara	cахара ; cахара
salamander	саламандър
salt	сол
salt water	Солени води ; cолени води
samarium	самарий
sand	пясък
sand dune	пясъчни дюни
sanitary fitting	санитария
sapphire	сапфир
sardine	сардина
satellite	Сателит (спътник) ; сателит ; спътник
sawdust	стърготини
saxophone	саксофон
say	казвам ; кажа
scandium	скандий
school	училище
science	Наука ; наука
scientific co-operation	научно сътрудничество
scientific dispute	научен спор
scientific research	научни изследвания
scientist	учен
screw	винт
screwdriver	отвертка
sculptor	скулптор
sea	Море ; Море ; море
sea level	морско равнище
sea water	морска вода
seashore	морски бряг
season	Сезон ; сезон
secondary education	средно образование
secret	таен
sediment	Седимент ; cедимент
sedimentation (geology) ; sedimentation	Седиментация (геол.) ; cедиментация
sedimentology	седиментология
see	виждам ; видя
seed	cеме
seismic activity	сеизмична дейност
seismic sea wave ; tsunami	цунами
selenium	селен
semi-metal	металоид
semiconductor	полупроводник
semiotics ; semiology	семиотика
separator	сепаратор
sewage farm	депо за канализационни отпадъци
sex ; gender	пол
sextant	секстант
shark	акула
sheep	овца
shellfish ; shellfish	Животно с черупка; черупково ; животно с черупка ; черупково
shepherd	овчар
ship	кораб
shop	магазин
shopping centre	търговски център
short ; small	малък ; мъничък
shrub	храст
side effect	страничен ефект
siemens	сименс
silicon	силиций
silk	коприна
silt	Тиня, утайка, нанос ; тиня ; утайка ; нанос
silver	Сребро ; сребро
simulation	симулация
ski run	ски писта
skiing	Каране на ски
skin	кожа
skull	череп
slag	Шлака, сгурия ; Шлака ; сгурия ; шлака
slaughterhouse ; slaughter-house ; abattoir ; butchery ; shambles	кланица
sleep	сън
sleep disturbance	смущения в съня
slipper	пантоф
slope	наклон
sludge	Утайка; мътилка, шлам ; утайка ; мътилка ; шлам
smallpox	вариола
smile	усмивка
smog	смог
smog warning	предупреждение за смог
smoke	Дим ; дим
smoking	пушене
snake	Змия ; змия
snow	Сняг ; cняг
snowslide	свличане на сняг
soaking	накисване
soap	Сапун ; сапун
social behaviour	социално поведение
social group	социална група
social protection	социална защита
social psychology	социална психология
social science	Социална наука ; социална наука
social survey	социално проучване
social welfare	социално благосъстояние
society	общество
socioeconomic aspect of human settlements	социоикономически аспект на човешките поселища
sociolinguistics ; sociology of language	социолингвистиката
sociology	Социология ; социология
sock	чорап
sodium	натрий
software	Софтуер ; софтуер
software development	разработване на софтуер
soil	почва ; почва
soil fertilisation	торене на почвите
soil fertility	плодородност на почвите
soil science	наука за почвите
solar cell	слънчева батерия (клетка)
solar collector	слънчев колектор
solar energy	слънчева енергия
solar energy technology	технологии за слънчева енергия
solar power station	слънчева електростанция
solar radiation	слънчева радиация
solubility	разтворимост
solvent	разтворител
songbird	пойна птичка
soot	сажди
sorption	сорбиране, сорбция ; сорбиране ; сорбция
sound	Звук ; звук
sound measurement	измерване на звука
space ; space ; space (interplanetary) ; interplanetary space	космос ; Космос (междупланетарен)
space travel	пътуване в космоса
spasmodic croup	спазматичен круп
species	Видове ; видове
speech	реч
speed	Бързина, скорост ; бързина ; скорост
sphinx	сфинкс
spider	Паяк ; паяк
spinach	спанак
sport	Спорт ; cпорт
spring	пролет
spring ; spring (hydrology, land)	извор
spring water	изворна вода
square	площад
stage	сцена
standard	Стандарт ; стандарт
staple food	основна храна
star	звезда
starch	скорбяла
station	Станция, гара ; станция ; гара
statistics	Статистика ; статистика
steam generator	парен генератор
steel	стомана
sterilisation	стерилзация
steroid	стероид
stocking	запасяване
stone	Камък ; камък
stork	щъркел
storm ; tempest	Буря ; буря
stove	Печка ; печка
strange ; odd	странен ; странен ; странен
stress	Стрес ; стрес
strontium	стронций
subject ; topic	Предмет ; предмет
submarine	Подводница ; подводница
subsidence	слягане
subsidy	Субсидия ; субсидия
suburb	предградие
sugar	захар
sulphur	сяра
sulphur concentration	концентрация на сярата
sulphur dioxide	серен диоксид
supermarket	супермаркет
supply	предлагане
supply and demand	търсене и предлагане
surface tension	повърхностно напрежение
swans, geese and ducks	лебеди, гъски и патици
sweet	сладък
sweetener	подсладител
sword	меч
symbiosis	симбиоза
synagogue	синагога
synecology	синекология
syntax	синтаксис
syphilis	сифилис
table	маса
tanker	цистерна (камион)
tanker ; tanker (ship)	Танкер (кораб) ; танкер
tannin	Танин ; танин
tantalum	тантал
target group	целева група
tax	такса, данък
taxonomy	таксономика
tea	чай
teaching	обучаване
technetium	технеций
technology	Технология ; технология
technology transfer	трансфер на технологии
telecommunications ; telecommunication	телекомуникации
telemetry	телеметрия
television	телевизор
television	Телевизия ; телевизия
television programme	телевизионна програма
tellurium	телур
temperature	Температура ; температура
tennis	тенис
teratogen	тератоген
terbium	тербий
terminology	Терминология ; терминология
termite	термит
territory	територия
terrorism	тероризъм
terrorist	терорист
tertiary sector	третичен сектор
test	тест
textile industry	текстилна промишленост
textile plant	текстилен завод
thallium	талий
thank you	благодарност
theocracy	теокрация
theology	теология
therapy	терапия
thermal equipment	термално оборудване
thermal power plant	термална електроцентрала
thermodynamics	термодинамика
thesis	теза, тезис
thorium	торий
three	три ; трима
thumb	палец
thunder	гръм
thunderstorm	гръмотевична буря
tidal power station	приливна електростанция
tidal water	приливни води
tiger	тигър
timber forest	дърводобивна гора
time	Време (астрон.) ; в ; време
timezone	часова зона
tin	калай
tissue	тъкан
titanium	титан
titanium dioxide	титаниев диоксид
toad	сухоземна жаба
tobacco	Тютюн ; тютюн
tomorrow	утре
tongue	език
topology	топология
tornado	торнадо
tortoise	костенурка
tourism	туризъм ; туризъм
toxic metal	токсичен метал
toxic substance	токсично вещество
toxicity	токсичност
toxicology	токсикология
toxin	токсин
trace element	следови елемент
tracheophyte ; vascular plant	трахеофит
trade	търговия
trade and consumption	търговия и потребление
trades union	синдикат
traffic	Трафик ; трафик
traffic noise	Шум от трафик ; шум от трафик
train	Влак ; влак
training	обучение
training centre	образователен център
trajectory	траектория
transition element ; transition metal	преходен елемент
translate ; interpret	превеждам
translation	troidigezh
transpiration	изпаряване
transport	транспорт
transport ; transportation	Транспортиране ; транспортиране
travel	пътуване
treaty	Договор ; договор
tree	Дърво ; дърво
triangle	триъгълник
trigonometry	тригонометрия
tritium	Тритий ; тритий
trolley bus ; trolleybus	тролейбус
trophic level	трофично ниво
tropical forest	тропична гора
tropical plant	тропическо растение
tropical rain forest	тропическа дъждовна гора
tropics ; torrid zone	тропици
truth	правда
tundra	Тундра ; тундра
tungsten	тунгстен
tunnel	Тунел ; тунел
turbidity	мътност
turbine	турбина
turkey	пуйка
twin	близнак
two	две
two	две ; два ; двама
typhoon	тайфун
tyre	Автомобилна гума ; автомобилна гума
ultraviolet radiation	ултравиолетова радиация
underground railway	подземна железница
underground train	Подземен влак ; подземен влак
unemployment	Безработица ; безработица
ungulate	копитно животно
upbringing	възпитание
uranium	уран
urbanisation	урбанизация
ursid	мечкови
useful	полезен
usurp	узурпирам
vacuum cleaner	прахосмукачка
valley	долина
vanadium	Ванадий ; ванадий
vandalism	Вандализъм ; вандализъм
vapour pressure	парово налягане
vector	Вектор ; вектор
vegetable	зеленчук
vegetable oil	зеленчуково масло
vehicle	превозно средство
ventilation	вентилация
verb	глагол
vertebrate	гръбначно животно
veteran	ветеран
village	село
vinasse	дистилационен отпадък
vinegar	оцет
vineyard	лозе
virology	вирусология
virus	вирус
viscosity	вискозитет
vitamin	витамин
vocabulary	речник
volatile substance	летливо вещество
volatility	летливост
volcanic eruption	вулканично изригване
volcanism	вулканизъм
volcano	Вулкан ; вулкан
volleyball	волейбол
voting	гласуване
vulcanisation	вулканизация
wall	Стена ; стена
walrus	моржови
war	Война ; война
warm-blooded animal	топлокръвно животно
waste	Отпадък ; отпадъци ; брак ; боклук
waste bin	Кошче за отпадъци ; кошче за отпадъци
waste disposal act	закон за обезвреждане на отпадъци
waste dump	Място за изхвърляне на отпадъци/бунище ; място за изхвърляне на отпадъци ; бунище
waste paper	отпадъчна хартия
waste water	отпадъчни води
waste water purification	пречистване на отпадъчните води
water	вода ; води
water ; body of water	вода
water aeration	водна аерация
water cost	цена на водата
water desalination	обезсоляване на водите
water flea	водна бълха
water level	ниво на водите
water mill	воденица
water polo	водна топка
water protection legislation	законодателство по опазване на водите
water pump	водна помпа
water reservoir	воден резервоар
water resource	воден ресурс
water salination	осоляване на водите
water supply	доставка на вода
water treatment	пречистване на вода
water well	воден сондаж
waterfall	водопад
waterfowl	водни птици
watershed	вододел
weapon	оръжие
weather	Време (клим.) ; време
weed	Бурен ; бурен
weight	тегло
welding	заваряване
well	кладенец
whale	кит
whaling	Лов на китове ; лов на китове
wheat	пшеница
whey	суроватка
white	бял
wife ; spouse	жена ; съпруга
wild animal	диво животно
wild fauna ; wildlife ; wild animals	дива фауна
wild plant	диво растение
wildlife ; 野生生物	див живот
willow	върба
wind	вятър
wind power	ветрова енергия
windmill	вятърна мелница
window	прозорец
wine	вино
witch	вещица ; вещица ; магьосница ; вълшебница ; чародейка
witness	свидетел
wizard ; sorcerer ; magician	магьосник ; вълшебник ; чародей ; чародеец
wolf	вълк
wood	Гора ; гора
wood product	дървен продукт
wool	вълна
word	дума
work accident	работен инцидент
workplace	работно място
world	свят
world heritage site	обект от световното наследство
world war	световна война
write	пиша
wrongful act	погрешно действие
xenon	kсенон
xylophone	ксилофон
y'all ; you ; you lot ; yous	вие
yacht	яхта
yak	як
year ; solar year	година
yeast	мая
yield	добив
yield	добив ; продукция ; производство
young	Млад ; млад
ytterbium	итербий
yttrium	итрий
zebra	зебра
zero ; null	нула
zinc	цинк
zirconium	цирконий
zoological garden	зоологическа градина
zoology	зоология
återställande ; rehabilitation	рехабилитация
