Latin	English
Mare Hadriaticum	Adriatic Sea
Mare Aegaeum	Aegean Sea
lingua Arabica	Arabic ; Standard Arabic
augustus ; Augustus	August
Mare Caribaeum	Caribbean Sea
lingua Sinica	Chinese
lingua Anglica	English
lingua Francogallica	French ; French
lingua Germana	German
India	India ; Republic of India
lingua Italica	Italian ; Italian
Ianuarius	January
Iunius	June
lingua Latina	Latin ; Latin
lingua Luxemburgica	Luxembourgish ; Luxemburgish ; Luxembourgian
Malaesia	Malaysia
Mauretania	Mauritania ; Islamic Republic of Mauritania
Mare Mediterraneum ; Mare Nostrum	Mediterranean Sea
Neapolis	Naples
lingua Lusitana	Portuguese ; Portuguese
Cataria	Qatar
Roma	Rome
Togum	Togo
Zambia	Zambia ; Republic of Zambia
actinium	actinium
agoraphobia	agoraphobia ; agoraphobia ; agoraphobia ; agoraphobia
aluminium	aluminium
americium	americium
an√≠sum	anise
stibium	antimony
arcarius	archer ; archer
axilla	armpit
arsenicum	arsenic
incendarius	arsonist
asparagus	asparagus
astatinum	astatine
autumnus	autumn
barium	barium
umbilicus	belly button ; bellybutton ; navel ; omphalos ; omphalus ; umbilicus
berkelium	berkelium
beryllium	beryllium ; glucinium
birota	bicycle ; bike ; cycle
bisemutum	bismuth
bohrium	bohrium
borium	boron
bromum	bromine
cadmium	cadmium
caesium	caesium
calcium	calcium
californium	californium
carbonium	carbon
cerium	cerium
chromium	chromium
cobaltum	cobalt
colonia	colony
consonans	consonant
lingua artificiosa	constructed language ; artificial language
cuprum	copper
curium	curium
darmstadtium	darmstadtium
dubnium	dubnium
dysprosium	dysprosium
einsteinium	einsteinium
encephalitis	encephalitis
erbium	erbium
europium	europium
fermium	fermium
fluor	fluorine
francium	francium
gadolinium	gadolinium
vesica fellea	gallbladder
gallium	gallium
tractus digestivus ; apparatus digestorius	gastrointestinal tract ; alimentary canal
germanium	germanium
giraffa	giraffe
aurum	gold
hafnium	hafnium
sudarium	handkerchief
hassium	hassium
Helium ; helium	helium
hydrogenium	hydrogen
glacies	ice
ideologia	ideology
indium	indium
infectio	infection
iodium	iodine
iridium	iridium
ferrum	iron
carate	karate
krypton	krypton
lanthanum	lanthanum
lawrencium	lawrencium
plumbum	lead
lithium	lithium
amor	love
amare	love
lutetium	lutetium
manganum	manganese
meitnerium	meitnerium
mendelelevium	mendelevium
hydrargyrus	mercury
linteum	nappy
neodymium	neodymium
neptunium	neptunium
niccolum	nickel
niobium	niobium
nitrogenium	nitrogen
nobelium	nobelium
osmium	osmium
oxygenium	oxygen
palladium	palladium
paeninsula	peninsula
philosophia	philosophy
phosphorus	phosphorus
placenta	placenta
platinum	platinum
aratrum	plough
plutonium	plutonium ; plutonium ; plutonium
polonium	polonium
kalium	potassium
praseodymium	praseodymium
prometium	promethium
protactinium	protactinium
radium	radium
radon	radon
rhenium	rhenium
rhodium	rhodium
roentgenium	roentgenium
rubidium	rubidium
ruthenium	ruthenium
rutherfordium	rutherfordium
navis actuaria	sailing ship
sal	salt
seaborgium	seaborgium
seleni	selenium
silicium	silicon
argentum	silver
calva	skull
natrium	sodium
strontium	strontium
sulphur	sulphur
tantalium	tantalum
technetium	technetium
tellurium	tellurium
terbium	terbium
thallium	thallium
theologia	theology
thorium	thorium
stannum	tin
titanium	titanium
arbor	tree
wolframium	tungsten
ununbium	ununbium
ununhexium	ununhexium
ununoctium	ununoctium
ununpentium	ununpentium
ununquadium	ununquadium
ununseptium	ununseptium
ununtrium	ununtrium
uranium	uranium
vanadium	vanadium
aqua	water
xenon	xenon
flavus	yellow
ytterbium	ytterbium
Yttrium	yttrium
zincum	zinc
zirconium	zirconium
