Nepali	English
अफ्रिकाली	Afrikaans
अरबी	Arabic ; Standard Arabic
अष्ट्रीया	Austria ; Republic of Austria
भुटान	Bhutan ; Kingdom of Bhutan
बुल्गेरिया	Bulgaria ; Republic of Bulgaria
बुल्गेरियाली	Bulgarian ; Bulgarian
स्प्यानिश	Castilian ; Spanish ; Spanish
क्याटालन	Catalan ; Catalan
क्रोएसियाली	Croatian ; Croation
ड्यानिश	Danish
डेनमार्क	Denmark ; Kingdom of Denmark
अँग्रेजी	English
एस्पेरान्तो	Esperanto ; Esperanto
एस्तोनियाली	Estonian
फारोइज	Faroese ; Faeroese
फिनल्याण्ड	Finland ; Republic of Finland
फिनिश	Finnish
फ्रान्स	France
फ्रांसिसी	French ; French
फ्रिजीयन	Frisian ; Western Frisian
गलिसियाली	Galician ; Galician
ग्रीस	Greece ; Hellenic Republic
ग्रीक	Greek ; Greek
गुजराती	Gujarati ; Gujarati
हिब्रु	Hebrew
हिन्दी	Hindi ; Hindi
हंग्रीयाली	Hungarian
हंगेरी	Hungary ; Republic of Hungary
आइसल्यान्डिक	Icelandic
भारत	India ; Republic of India
इन्डोनेसियाली	Indonesian
आयरल्याण्ड	Ireland ; Republic of Ireland
इटालियन	Italian ; Italian
इटाली	Italian Republic ; Italy
कोरियाली	Korean ; Korean
लात्भिया	Latvia ; Republic of Latvia
लात्भियाल	Latvian ; Latvian
म्यासेडोनिया	Macedonia ; Republic of Macedonia
म्यासेडोनियन	Macedonian ; Macedonian
माल्टा	Malta ; Republic of Malta
मोल्दोवा	Moldova
मोनाको	Monaco
मुम्बई	Mumbai ; Bombay
नेपाली	Nepali ; Nepali
नर्वे	Norway ; Kingdom of Norway
पर्सियन	Persian ; Western Farsi ; Farsi
पोलिश	Polish ; Polish
पोर्चुगल	Portugal
पोर्तुगाली	Portuguese ; Portuguese
रोमानिया	Romania
रोमानियाली	Romanian ; Romanaian
रसियाली	Russian ; Russian
सर्बिया	Serbia
स्लोभाकियाली	Slovak ; Slovak
स्लोभाकिया	Slovakia
स्लोभेनियाली	Slovene ; Slovenian ; Slovenian
स्वाहिली	Swahili
स्विडिश	Swedish
स्वीट्जरल्याण्ड	Switzerland
तामिल	Tamil ; Tamil
तेलुगु	Telugu ; Telugu
थाई	Thai ; Thai
तुर्की	Turkish ; Turkish
युक्रेनी	Ukrainian ; Ukrainian
भेटिकन सिटी	Vatican City ; The Holy See ; State of the Vatican City
भियतनामी	Vietnamese ; Vietnamese
वेल्श	Welsh ; Welsh
ज्योतिष	astronomy
चर्मशास्त्र	dermatology
ग्रन्थिशास्त्र	endocrinology
रेडियोलोजी	radiology
इन्द्रेनी	rainbow
